player_id,season,I_F_xGoals,I_F_flurryScoreVenueAdjustedxGoals,I_F_primaryAssists,I_F_secondaryAssists,I_F_shotsOnGoal,I_F_missedShots,I_F_blockedShotAttempts,I_F_shotAttempts,I_F_points,I_F_goals,I_F_rebounds,I_F_savedShotsOnGoal,I_F_faceOffsWon,I_F_hits,I_F_takeaways
8465009,2021,3.06,2.94,8,4,81,33,58,172,14,2,5,79,0,125,14
8466138,2021,4,3.88,3,2,26,9,9,44,10,5,4,21,77,21,18
8469455,2021,11.07,9.75,9,4,97,34,44,175,25,12,7,85,305,31,32
8470281,2021,3.11,3.04,10,10,79,33,63,175,21,1,5,78,0,22,36
8470600,2021,6.86,6.22,6,19,118,65,82,265,32,7,12,111,0,46,19
8470604,2021,22.52,20.81,15,11,200,45,70,315,45,19,18,181,648,99,33
8470606,2021,14.71,13.71,9,10,146,50,42,238,28,9,10,137,2,88,13
8470610,2021,16.98,16.94,15,5,138,42,23,203,35,15,12,123,28,60,27
8470612,2021,8.4,8.1,20,14,104,44,44,192,37,3,7,101,546,89,35
8470613,2021,9.2,8.9,25,19,203,90,153,446,54,10,18,193,0,55,68
8470619,2021,8.03,7.81,5,5,87,22,13,122,21,11,6,76,165,95,20
8470621,2021,25.11,23.83,17,4,153,53,36,242,40,19,15,134,2,73,19
8470626,2021,7.24,6.88,8,8,81,23,18,122,19,3,8,78,20,17,22
8470638,2021,31.5,29.87,19,21,293,76,58,427,65,25,25,268,991,78,37
8470755,2021,3.49,3.37,2,2,31,17,21,69,8,4,2,27,139,59,7
8470775,2021,3.07,3.04,2,0,23,12,6,41,3,1,2,22,160,49,8
8470794,2021,30.73,29.66,30,24,216,96,62,374,81,27,19,189,394,104,35
8470966,2021,5.76,5.47,15,12,151,70,127,348,35,8,10,143,0,75,19
8471214,2021,36.37,34.36,23,17,334,134,174,642,90,50,18,284,4,155,32
8471215,2021,14.65,13.64,10,12,129,29,45,203,42,20,13,109,164,21,41
8471217,2021,8.46,8.21,2,3,57,23,27,107,12,7,5,50,7,68,17
8471218,2021,21.04,20.53,24,19,167,43,53,263,60,17,11,150,4,62,32
8471228,2021,14.47,13.56,13,5,92,56,41,189,22,4,10,88,10,43,30
8471260,2021,0.14,0.14,0,0,2,0,3,5,1,1,0,1,1,13,1
8471274,2021,3.56,3.38,11,17,80,28,65,173,30,2,7,78,0,56,6
8471284,2021,0.83,0.84,1,2,26,9,18,53,4,1,2,25,0,15,3
8471303,2021,2.48,2.26,7,9,54,26,39,119,19,3,5,51,0,56,9
8471669,2021,21.94,21.51,14,10,141,31,24,196,45,21,9,120,267,27,38
8471675,2021,26.02,24.99,31,22,208,64,62,334,84,31,20,177,760,50,34
8471677,2021,2.58,2.51,5,7,67,30,52,149,14,2,5,65,0,108,12
8471685,2021,20.76,19.93,29,19,210,70,73,353,67,19,15,191,858,72,48
8471686,2021,3.84,3.63,6,7,76,28,37,141,16,3,6,73,0,94,13
8471698,2021,11.66,10.6,6,8,77,36,25,138,25,11,8,66,72,86,19
8471699,2021,7.49,7.37,7,5,75,29,24,128,16,4,4,71,8,104,29
8471707,2021,2.46,2.4,0,2,31,6,8,45,4,2,2,29,0,17,2
8471709,2021,2.38,2.36,5,6,63,36,46,145,14,3,6,60,0,54,17
8471724,2021,9.69,9.54,34,24,214,58,131,403,68,10,15,204,0,171,59
8471729,2021,1.4,1.37,3,4,34,11,21,66,9,2,1,32,0,33,3
8471735,2021,4.27,4.06,5,13,105,43,85,233,19,1,8,104,0,29,11
8471794,2021,9.37,9.21,5,3,93,22,31,146,15,7,1,86,103,114,25
8471817,2021,4.66,4.64,3,5,44,15,14,73,13,5,5,39,5,279,11
8471873,2021,4.21,3.99,7,8,95,26,60,181,23,8,7,87,0,99,32
8471887,2021,16.54,15.38,9,8,165,39,36,240,28,11,26,154,8,112,24
8472382,2021,1.83,1.78,5,3,52,34,40,126,10,2,2,50,0,39,14
8473415,2021,0.03,0.02,0,0,2,1,1,4,0,0,0,2,0,5,0
8473419,2021,26.52,25.76,29,19,242,64,91,397,80,32,23,210,14,78,40
8473422,2021,7.34,6.97,7,4,99,29,21,149,13,2,6,97,22,164,22
8473446,2021,5.62,5.59,4,9,129,30,77,236,20,7,9,122,0,148,33
8473449,2021,13.52,13.29,8,16,174,67,63,304,45,21,8,153,92,59,24
8473453,2021,9.78,9.68,3,7,108,45,27,180,16,6,6,102,77,176,11
8473463,2021,0,0,0,0,0,0,0,0,0,0,0,0,1,3,0
8473473,2021,11.68,11.34,7,4,95,44,32,171,21,10,8,85,19,209,20
8473504,2021,6.97,6.89,1,8,74,21,18,113,15,6,2,68,11,229,21
8473507,2021,4.57,4.32,9,12,124,36,106,266,27,6,7,118,0,140,12
8473512,2021,17.46,17.09,19,25,205,63,71,339,65,21,17,184,733,68,28
8473533,2021,22.38,21.56,10,9,146,61,27,234,36,17,17,129,736,212,34
8473544,2021,6.25,6.02,7,4,62,8,21,91,19,8,4,54,169,82,10
8473548,2021,16.11,15.4,24,20,175,55,80,310,52,8,20,167,4,6,39
8473563,2021,7.4,6.66,12,13,68,30,23,121,31,6,3,62,301,16,25
8473604,2021,13.12,12.25,15,10,125,33,30,188,37,12,9,113,788,25,48
8473618,2021,3.63,3.46,3,2,27,8,11,46,9,4,0,23,36,35,10
8473986,2021,23.13,22.44,19,15,164,60,49,273,59,25,9,139,2,88,42
8473994,2021,23.58,20.95,14,14,182,68,67,317,46,18,19,164,492,143,37
8474009,2021,13.86,13.2,5,5,137,44,30,211,26,16,15,121,475,34,50
8474013,2021,2.78,2.74,6,11,77,44,59,180,19,2,8,75,0,110,29
8474027,2021,2.43,2.33,5,7,73,32,55,160,18,6,4,67,0,87,16
8474031,2021,7.01,6.84,13,14,163,51,81,295,35,8,7,155,0,73,38
8474034,2021,12.86,12.49,7,9,102,35,19,156,27,11,9,91,15,160,16
8474037,2021,28,24.7,8,6,187,58,40,285,38,24,24,163,10,34,30
8474038,2021,3.55,3.4,1,2,33,4,6,43,7,4,5,29,33,66,9
8474040,2021,11.59,11.06,13,5,132,26,27,185,31,13,11,119,142,21,24
8474053,2021,23.25,22.09,21,12,199,61,54,314,56,23,16,176,621,92,62
8474056,2021,4.41,4.18,8,9,114,58,92,264,22,5,7,109,0,69,23
8474062,2021,4.48,4.34,3,1,36,20,8,64,4,0,3,36,207,46,18
8474066,2021,0,0,0,0,0,0,1,1,0,0,0,0,0,2,1
8474068,2021,1.55,1.57,0,3,21,8,14,43,4,1,0,20,28,13,9
8474089,2021,0.68,0.69,1,0,7,2,2,11,2,1,1,6,13,22,0
8474090,2021,2.86,2.82,2,2,63,23,42,128,8,4,5,59,0,73,12
8474098,2021,3.07,3.07,2,1,38,15,7,60,5,2,2,36,29,41,9
8474102,2021,18.36,17.99,10,20,177,54,88,319,57,27,17,150,1,80,37
8474141,2021,21.26,20.92,46,20,287,84,143,514,92,26,6,261,4,11,42
8474145,2021,2.59,2.52,2,3,47,21,19,87,6,1,3,46,0,135,8
8474149,2021,18.6,17.85,17,6,177,55,68,300,43,20,16,157,1,65,17
8474150,2021,18.8,18.54,18,9,214,74,67,355,39,12,19,202,621,62,55
8474151,2021,5.51,5.44,9,13,85,46,49,180,26,4,5,81,0,96,26
8474157,2021,15.06,14.58,9,9,148,56,58,262,37,19,9,129,2,30,15
8474161,2021,11.89,11.38,40,16,147,43,63,253,62,6,9,141,5,27,44
8474162,2021,2.54,2.48,5,6,75,29,62,166,14,3,3,72,0,105,12
8474166,2021,1.13,1.11,1,4,32,13,24,69,8,3,1,29,0,26,8
8474176,2021,7.39,7.14,5,6,71,25,21,117,14,3,4,68,4,32,14
8474189,2021,10.79,10.77,15,3,116,54,43,213,31,13,9,103,510,95,37
8474190,2021,10.32,10.04,5,6,79,25,29,133,16,5,2,74,3,148,15
8474207,2021,3.5,3.29,9,5,75,43,51,169,19,5,7,70,0,115,16
8474291,2021,2.38,2.26,1,0,24,5,11,40,2,1,2,23,265,50,9
8474563,2021,5.94,5.62,10,14,99,28,56,183,31,7,9,92,0,60,9
8474564,2021,26.74,25.92,43,21,241,82,78,401,106,42,12,199,545,93,30
8474565,2021,12.68,12.39,17,14,227,84,145,456,44,13,16,214,0,66,93
8474567,2021,2.26,2.23,2,3,60,16,32,108,8,3,3,57,0,114,7
8474568,2021,3.47,2.95,7,5,78,23,62,163,17,5,3,73,0,273,7
8474573,2021,10.39,9.6,18,12,87,28,41,156,44,14,8,73,43,19,31
8474574,2021,5.84,5.65,8,9,128,45,84,257,18,1,5,127,0,145,32
8474578,2021,5.58,5.48,13,12,117,53,78,248,35,10,4,107,0,18,52
8474584,2021,0.98,0.95,4,6,35,16,30,81,13,3,2,32,0,42,5
8474586,2021,20.41,19.81,13,10,164,75,71,310,44,21,6,143,6,48,50
8474589,2021,7.86,7.69,11,5,89,35,33,157,24,8,5,81,20,70,19
8474590,2021,11.71,11.15,25,29,195,83,110,388,71,17,14,178,0,73,42
8474600,2021,18.23,17.22,36,37,281,104,178,563,96,23,22,258,0,66,48
8474602,2021,5.11,4.96,12,7,92,45,68,205,23,4,10,88,0,40,13
8474610,2021,0,0,0,0,0,0,0,0,0,0,0,0,1,2,0
8474612,2021,3.08,2.94,2,4,82,27,62,171,10,4,2,78,0,73,6
8474613,2021,10.65,10.5,6,4,96,28,21,145,19,9,10,87,248,29,22
8474618,2021,3.61,3.58,5,6,76,29,37,142,14,3,5,73,0,106,18
8474628,2021,1.09,1.08,1,3,24,10,25,59,6,2,0,22,0,26,1
8474641,2021,19.56,18.75,15,8,141,53,39,233,42,19,16,122,276,22,18
8474673,2021,3.26,3.16,11,13,68,29,61,158,28,4,4,64,0,53,30
8474679,2021,17.41,17.05,24,11,122,47,39,208,53,18,13,104,14,41,46
8474683,2021,13.94,13.45,9,5,117,38,38,193,29,15,6,102,204,69,21
8474688,2021,0.51,0.51,1,0,16,5,2,23,2,1,2,15,0,18,0
8474697,2021,1.69,1.65,2,2,45,22,24,91,4,0,1,45,0,196,7
8474709,2021,7.17,7.05,3,1,66,20,20,106,7,3,3,63,8,235,11
8474715,2021,24.76,23.86,20,7,215,58,58,331,50,23,26,192,5,20,37
8474716,2021,5.8,5.59,16,14,116,41,77,234,40,10,8,106,0,44,13
8474722,2021,0,0,0,0,0,0,0,0,0,0,0,0,0,1,0
8474818,2021,1.36,1.37,4,3,37,17,23,77,8,1,2,36,0,51,6
8474849,2021,6.95,6.58,4,0,59,26,18,103,8,4,7,55,17,74,9
8474870,2021,3.24,3.05,2,3,32,13,11,56,8,3,3,29,59,66,7
8474884,2021,14.98,14.07,11,9,154,53,78,285,35,15,19,139,12,27,32
8475098,2021,3.71,3.66,4,5,46,10,17,73,12,3,2,43,175,20,20
8475149,2021,12.87,11.94,13,7,111,34,38,183,29,9,18,102,41,31,26
8475151,2021,18.03,17.51,8,10,156,59,52,267,33,15,11,141,15,77,16
8475158,2021,23.2,22.49,24,13,168,47,37,252,58,21,11,147,900,20,50
8475160,2021,2.12,2.13,1,2,29,7,8,44,4,1,2,28,3,50,5
8475163,2021,13.4,12.72,7,2,98,19,23,140,22,13,10,85,10,68,7
8475164,2021,8.12,7.9,7,9,120,34,29,183,21,5,12,115,8,16,30
8475166,2021,33.38,31.74,21,28,237,110,82,429,76,27,27,210,813,90,40
8475167,2021,14.75,14.38,34,31,219,112,131,462,85,20,19,199,0,93,52
8475168,2021,34.82,33.51,24,19,229,89,65,383,86,43,14,186,119,31,31
8475169,2021,18.53,18.28,9,8,152,54,54,260,39,22,13,130,9,135,16
8475170,2021,17.92,17.01,27,7,111,41,45,197,58,24,10,87,284,119,42
8475171,2021,6.45,6.16,14,10,168,66,118,352,29,5,16,163,0,105,26
8475172,2021,29.41,28.19,35,24,247,92,100,439,87,28,24,219,585,52,36
8475176,2021,0.2,0.2,1,3,6,2,5,13,5,1,0,5,0,1,2
8475177,2021,3.8,3.76,2,2,107,45,73,225,8,4,4,103,0,146,18
8475178,2021,7.31,7.27,10,3,58,26,19,103,19,6,5,52,3,154,13
8475179,2021,5.01,4.98,11,6,74,38,56,168,24,7,5,67,0,100,16
8475181,2021,2.71,2.63,6,15,71,33,34,138,24,3,4,68,0,37,30
8475184,2021,38.9,36.18,12,13,258,85,69,412,77,52,22,206,67,141,27
8475186,2021,0.23,0.23,1,0,7,3,5,15,1,0,1,7,0,9,2
8475188,2021,3.61,3.56,5,10,85,48,62,195,18,3,6,82,0,154,37
8475191,2021,18.73,17.79,13,9,150,49,51,250,38,16,11,134,4,55,29
8475193,2021,16.53,15.81,8,7,132,59,53,244,30,15,8,117,19,75,27
8475197,2021,6.11,5.88,17,17,149,51,97,297,41,7,9,142,0,27,14
8475200,2021,7.39,7.3,14,9,127,47,64,238,35,12,11,115,0,124,37
8475208,2021,3.9,3.66,4,11,91,44,50,185,18,3,7,88,0,88,34
8475209,2021,0.67,0.61,1,0,4,4,2,10,1,0,0,4,1,9,1
8475218,2021,9.22,9.03,12,13,145,68,98,311,31,6,13,139,0,79,29
8475220,2021,17.67,17.38,15,4,99,35,29,163,42,23,9,76,12,238,28
8475225,2021,15.73,15.36,14,6,187,61,70,318,36,16,21,171,4,95,21
8475227,2021,2.72,2.5,12,11,76,24,48,148,27,4,3,72,0,44,13
8475231,2021,9.78,9.71,4,2,91,37,19,147,16,10,8,81,534,138,33
8475233,2021,4.69,4.45,5,9,66,22,39,127,17,3,8,63,0,134,7
8475235,2021,9.9,9.91,3,2,90,33,35,158,13,8,9,82,1,263,7
8475236,2021,5.38,5.14,2,6,74,20,23,117,12,4,4,70,482,33,22
8475246,2021,1.44,1.42,1,1,30,9,28,67,3,1,2,29,0,74,6
8475279,2021,6.13,5.73,11,6,143,34,91,268,26,9,12,134,0,157,20
8475287,2021,16.08,15.7,14,12,141,43,33,217,44,18,6,123,434,129,25
8475314,2021,24.07,22.2,11,7,159,69,38,266,46,28,22,131,65,94,16
8475324,2021,3.97,3.84,7,9,88,53,63,204,21,5,3,83,0,135,23
8475343,2021,9.61,9.37,11,3,90,23,22,135,24,10,8,80,506,139,28
8475413,2021,2.11,2.15,2,0,17,5,6,28,4,2,2,15,21,10,4
8475455,2021,4.18,4.12,5,12,85,45,73,203,20,3,5,82,0,212,16
8475461,2021,0.03,0.02,0,0,1,0,0,1,0,0,0,1,1,4,0
8475462,2021,4.09,4.09,7,6,100,44,78,222,16,3,6,97,0,355,28
8475625,2021,0.64,0.64,0,3,29,7,13,49,4,1,2,28,0,36,2
8475690,2021,3.21,3.15,11,11,88,41,51,180,28,6,8,82,0,52,29
8475692,2021,14.81,14.22,37,18,159,44,65,268,79,24,10,135,21,36,48
8475714,2021,11.72,11.19,7,11,101,41,33,175,30,12,8,89,239,38,27
8475718,2021,3.46,3.27,6,14,64,26,38,128,23,3,3,61,0,129,18
8475722,2021,9.93,9.7,5,4,102,25,19,146,17,8,10,94,4,66,15
8475726,2021,20.81,19.72,17,12,195,63,71,329,49,20,8,175,18,81,27
8475728,2021,4.86,4.84,5,9,44,21,23,88,21,7,0,37,195,70,13
8475735,2021,3.16,3.06,2,1,25,6,7,38,5,2,0,23,72,50,14
8475744,2021,23.03,22.56,34,20,208,81,56,345,78,24,11,184,507,42,54
8475745,2021,18.73,15.99,16,12,131,54,29,214,44,16,18,115,540,84,39
8475747,2021,2.4,2.34,4,1,52,26,36,114,7,2,2,50,0,115,11
8475750,2021,2.2,2.15,7,9,59,24,35,118,20,4,2,55,0,46,6
8475752,2021,4.34,4.19,2,2,38,19,23,80,5,1,6,37,5,70,14
8475753,2021,9.99,9.81,8,23,167,52,99,318,47,16,10,151,0,149,37
8475754,2021,19.8,19.42,14,8,171,40,68,279,59,37,14,134,476,31,49
8475760,2021,10.12,9.89,2,4,82,25,23,130,13,7,11,75,141,99,18
8475762,2021,2,1.99,3,7,64,26,42,132,14,4,5,60,0,133,15
8475763,2021,9.34,9.11,13,8,126,34,49,209,31,10,9,116,260,36,30
8475764,2021,9.21,9.01,16,17,124,46,130,300,42,9,8,115,0,37,31
8475765,2021,25.26,25.03,27,21,230,75,77,382,82,34,13,196,4,83,17
8475766,2021,8.85,8.58,5,1,88,31,29,148,16,10,11,78,7,213,15
8475768,2021,8.92,8.63,10,5,101,39,28,168,23,8,5,93,17,42,28
8475772,2021,6.54,6.43,8,5,69,20,20,109,17,4,4,65,263,16,18
8475780,2021,0.17,0.17,0,0,2,1,0,3,0,0,0,2,0,11,0
8475784,2021,29.39,28.13,23,7,262,69,75,406,63,33,17,229,91,29,51
8475786,2021,34.26,32.66,18,9,213,80,60,353,54,27,25,186,41,74,29
8475790,2021,3.61,3.6,5,6,129,52,87,268,17,6,8,123,0,145,20
8475791,2021,20.58,19.88,27,14,217,44,61,322,61,20,13,197,18,55,33
8475792,2021,0.6,0.61,1,0,6,3,4,13,1,0,0,6,0,7,2
8475793,2021,16.3,15.54,14,23,118,35,29,182,63,26,8,92,691,72,39
8475794,2021,22.88,22.2,17,8,218,62,65,345,49,24,10,194,464,96,26
8475796,2021,3.25,3.18,3,6,64,35,27,126,12,3,2,61,0,41,21
8475797,2021,0.16,0.16,0,0,5,4,6,15,1,1,0,4,0,17,0
8475798,2021,14.63,14.07,27,26,117,48,54,219,64,11,12,106,569,92,57
8475799,2021,23.55,22.45,11,9,144,62,37,243,44,24,25,120,19,119,21
8475810,2021,25.45,23.72,22,12,180,72,50,302,58,24,14,156,1,43,22
8475820,2021,10.19,9.95,7,13,89,35,31,155,22,2,2,87,5,36,24
8475825,2021,2.63,2.32,3,5,68,31,59,158,12,4,5,64,0,248,9
8475842,2021,8.32,8,2,6,80,34,25,139,19,11,4,69,204,122,14
8475848,2021,17.66,16.89,12,5,142,52,56,250,24,7,14,135,13,54,17
8475855,2021,15.65,15.12,15,5,97,45,29,171,34,14,6,83,12,109,17
8475906,2021,6.98,6.68,24,17,139,70,152,361,47,6,14,133,0,57,16
8475913,2021,11.04,10.79,15,6,71,23,24,118,30,9,6,62,13,19,56
8475958,2021,1.78,1.71,2,0,11,2,1,14,4,2,1,9,41,7,1
8475968,2021,0.62,0.62,0,0,13,1,5,19,0,0,0,13,8,17,3
8476278,2021,7.71,7.36,4,6,77,19,30,126,20,10,6,67,83,91,18
8476285,2021,0.13,0.12,0,1,3,1,4,8,1,0,0,3,5,3,0
8476288,2021,3.86,3.67,3,0,32,13,13,58,8,5,3,27,65,20,13
8476292,2021,18.39,18.17,18,13,143,54,51,248,49,18,9,125,2,123,30
8476312,2021,4.67,4.56,4,6,92,30,50,172,16,6,5,86,0,179,38
8476323,2021,0.69,0.69,0,0,8,5,2,15,0,0,1,8,2,11,2
8476326,2021,0.31,0.29,1,0,4,2,3,9,1,0,0,4,2,27,3
8476329,2021,12.95,12.32,11,7,88,43,24,155,35,17,6,71,420,71,20
8476331,2021,3.48,3.27,6,6,78,20,43,141,13,1,7,77,0,113,17
8476345,2021,2.89,2.79,2,3,33,3,15,51,7,2,1,31,0,23,7
8476346,2021,27.93,27.61,52,23,262,86,115,463,115,40,19,222,1,10,50
8476368,2021,0.1,0.1,0,0,4,3,4,11,0,0,1,4,0,12,1
8476372,2021,1.21,1.17,0,2,32,16,19,67,3,1,1,31,0,75,4
8476374,2021,14.2,13.4,3,13,121,40,29,190,30,14,5,107,628,240,35
8476389,2021,25.09,24.16,16,14,168,86,46,300,51,21,14,147,680,185,50
8476390,2021,0.07,0.07,0,1,1,0,0,1,1,0,0,1,0,1,1
8476391,2021,0.04,0.04,0,0,3,0,1,4,0,0,0,3,6,1,0
8476392,2021,18.35,17.18,6,2,115,48,31,194,21,13,14,102,564,231,39
8476393,2021,11.08,10.92,7,6,103,40,28,171,22,9,9,94,23,66,16
8476396,2021,0.14,0.14,0,0,2,0,0,2,0,0,0,2,7,0,1
8476399,2021,20.8,20.31,9,8,212,56,61,329,33,16,13,196,2,163,34
8476400,2021,1.41,1.32,1,1,17,3,2,22,3,1,0,16,58,11,11
8476404,2021,0.3,0.28,0,0,6,2,1,9,1,1,0,5,9,11,1
8476410,2021,1.31,1.25,1,1,10,4,0,14,3,1,1,9,0,4,0
8476415,2021,0.04,0.04,0,0,3,0,2,5,0,0,0,3,1,6,0
8476419,2021,14.21,13.79,10,11,126,43,30,199,39,18,8,108,748,171,30
8476422,2021,5.5,5.32,6,7,135,43,52,230,17,4,5,131,0,94,19
8476428,2021,0.88,0.86,0,0,8,2,3,13,0,0,1,8,6,5,5
8476429,2021,3.55,3.52,8,7,80,45,77,202,18,3,4,77,0,77,15
8476432,2021,21.51,20.19,11,10,160,61,45,266,44,23,9,137,642,80,33
8476436,2021,2.15,2.07,1,0,23,10,10,43,1,0,1,23,5,47,3
8476437,2021,5.58,5.52,6,6,58,21,16,95,21,9,6,49,89,15,14
8476438,2021,20.75,20,17,8,158,40,38,236,49,24,14,134,8,20,45
8476439,2021,4.88,4.7,1,0,55,20,16,91,4,3,2,52,1,78,3
8476441,2021,1.18,1.12,2,1,32,9,18,59,6,3,2,29,0,61,5
8476442,2021,7.95,7.86,8,3,82,24,14,120,17,6,4,76,2,96,21
8476448,2021,15.33,14.95,12,11,135,57,45,237,35,12,15,123,508,42,44
8476449,2021,0.1,0.1,0,1,5,2,2,9,1,0,1,5,0,8,2
8476453,2021,16.46,16.18,27,17,156,58,62,276,69,25,8,131,1,32,24
8476454,2021,15.14,14.49,22,17,154,30,47,231,50,11,8,143,178,42,43
8476455,2021,21.84,20.83,16,13,150,44,57,251,59,30,14,120,241,94,17
8476456,2021,27.52,26.34,53,32,222,58,64,344,115,30,23,192,18,99,63
8476457,2021,4.5,4.42,10,7,119,55,86,260,25,8,9,111,0,183,23
8476458,2021,17.26,16.89,18,15,161,55,41,257,54,21,10,140,363,41,32
8476459,2021,28.61,26.67,33,19,219,94,70,383,81,29,16,190,700,67,62
8476460,2021,20.43,19.66,23,18,159,56,49,264,70,29,17,130,430,36,49
8476461,2021,9.17,8.82,8,3,79,29,28,136,17,6,9,73,238,22,25
8476462,2021,11.35,11.01,10,11,197,88,117,402,30,9,12,188,0,87,20
8476463,2021,4.91,4.87,9,16,126,31,75,232,30,5,3,121,0,42,24
8476466,2021,0.02,0.02,0,0,1,0,0,1,0,0,0,1,0,0,0
8476467,2021,5.96,5.58,9,7,95,33,48,176,17,1,10,94,0,182,32
8476468,2021,28.79,27.22,36,31,206,87,57,350,99,32,22,174,667,172,56
8476469,2021,10.13,9.61,4,4,103,32,44,179,14,6,8,97,3,104,30
8476470,2021,1.02,1.01,3,1,24,14,14,52,4,0,4,24,0,19,0
8476473,2021,2.04,2.01,2,4,71,27,52,150,10,4,4,67,0,130,19
8476474,2021,0.83,0.68,0,0,4,5,2,11,0,0,0,4,0,5,0
8476479,2021,25.97,24.13,14,10,194,66,39,299,51,27,21,167,676,74,22
8476480,2021,14.45,13.98,8,6,91,32,30,153,30,16,7,75,26,62,21
8476483,2021,17.81,17.25,12,9,184,81,77,342,41,20,9,164,36,99,28
8476495,2021,0,0,0,0,0,0,0,0,0,0,0,0,0,1,1
8476505,2021,0.02,0.02,0,0,1,1,0,2,0,0,0,1,0,3,0
8476525,2021,1.36,1.3,7,5,48,25,29,102,14,2,6,46,0,50,6
8476539,2021,24.36,23.69,24,12,251,80,82,413,66,30,15,221,43,61,38
8476545,2021,0,0,0,0,0,0,1,1,0,0,0,0,0,7,1
8476624,2021,15.93,15.53,14,6,116,41,25,182,33,13,11,103,366,130,39
8476779,2021,2.03,2,8,6,67,23,37,127,17,3,6,64,0,22,11
8476792,2021,6.03,5.92,14,20,119,54,72,245,43,9,7,110,0,53,16
8476807,2021,0.17,0.17,2,1,5,3,3,11,3,0,1,5,0,12,1
8476822,2021,15.24,14.92,5,2,116,51,26,193,16,9,7,107,425,179,17
8476826,2021,15.36,14.97,20,7,128,58,60,246,48,21,5,107,444,77,54
8476850,2021,1.1,1.1,1,3,26,7,12,45,4,0,1,26,0,32,4
8476851,2021,9.69,8.56,7,8,89,33,23,145,21,6,7,83,214,67,18
8476853,2021,9.35,9.06,32,26,221,69,94,384,68,10,13,211,0,92,40
8476854,2021,6.28,6.17,11,11,142,59,74,275,27,5,6,137,0,70,35
8476856,2021,6.83,6.12,12,8,116,38,97,251,27,7,11,109,0,114,15
8476867,2021,4.64,4.54,1,1,44,18,9,71,7,5,2,39,66,42,8
8476869,2021,8.79,8.47,16,14,184,69,77,330,39,9,17,175,0,95,51
8476870,2021,0,0,0,0,0,0,0,0,0,0,0,0,0,0,0
8476871,2021,16.43,16.08,10,10,159,38,45,242,34,14,16,145,20,84,22
8476872,2021,14.44,13.47,10,9,110,38,48,196,30,11,7,99,395,151,31
8476873,2021,1.79,1.74,1,2,14,8,7,29,5,2,1,12,86,5,4
8476874,2021,2.44,2.34,2,5,61,26,52,139,8,1,3,60,0,67,10
8476875,2021,7.13,6.95,11,9,140,70,85,295,31,11,10,129,0,97,43
8476878,2021,8.89,8.49,7,1,92,28,25,145,18,10,6,82,143,81,24
8476879,2021,3.3,3.2,7,16,102,36,75,213,28,5,3,97,0,117,15
8476880,2021,19.41,18.69,14,14,151,75,53,279,52,24,13,127,22,240,36
8476881,2021,29.02,27.67,21,13,205,76,83,364,64,30,17,175,769,105,65
8476882,2021,18.95,18.32,26,17,202,62,62,326,65,22,16,180,24,15,34
8476884,2021,0.49,0.49,3,1,8,9,13,30,4,0,0,8,0,10,3
8476885,2021,10.69,9.74,14,14,204,73,111,388,39,11,23,193,0,207,24
8476886,2021,0.31,0.3,2,2,11,8,7,26,4,0,1,11,0,21,1
8476887,2021,26.94,25.85,27,15,226,107,91,424,84,42,16,184,1,112,53
8476889,2021,11.9,11,8,6,89,41,20,150,19,5,14,84,383,129,27
8476891,2021,3.94,3.93,9,11,118,36,57,211,24,4,1,114,0,40,21
8476892,2021,7.35,7.18,10,19,135,48,61,244,35,6,9,129,0,72,51
8476897,2021,7.84,7.71,12,3,70,19,28,117,23,8,4,62,75,70,12
8476902,2021,4.91,4.32,13,8,136,23,52,211,25,4,8,132,0,111,20
8476905,2021,18.07,17.77,17,26,125,33,37,195,64,21,9,104,653,68,40
8476906,2021,7.2,6.79,16,21,151,65,98,314,51,14,8,137,0,60,44
8476907,2021,1.47,1.45,2,0,14,2,3,19,2,0,3,14,0,19,7
8476913,2021,4.07,3.96,4,2,36,16,13,65,11,5,4,31,102,67,15
8476915,2021,2.77,2.62,0,0,32,7,12,51,3,3,1,29,53,88,2
8476917,2021,4.76,4.36,10,15,104,33,88,225,28,3,9,101,0,99,49
8476918,2021,12.45,11.55,3,4,110,45,30,185,15,8,5,102,18,85,57
8476919,2021,9.39,9.06,1,11,72,28,21,121,18,6,7,66,264,42,23
8476921,2021,7.95,7.62,6,3,77,44,31,152,15,6,7,71,23,83,11
8476923,2021,10.96,10.67,18,17,158,66,88,312,46,11,10,147,0,91,38
8476924,2021,2.06,1.93,0,0,15,7,6,28,2,2,0,13,0,11,0
8476925,2021,12.37,12.14,10,11,87,47,29,163,28,7,6,80,719,188,19
8476927,2021,9.44,9.46,8,11,93,21,20,134,28,9,7,84,356,87,37
8476931,2021,4.42,4.32,7,11,80,31,69,180,22,4,4,76,0,166,18
8476934,2021,12.56,12.22,7,3,99,29,29,157,22,12,8,87,16,94,18
8476952,2021,6.85,6.75,6,1,44,20,24,88,14,7,1,37,87,92,11
8476958,2021,8.67,8.38,14,24,165,72,104,341,42,4,9,161,0,50,74
8476960,2021,10.07,9.95,3,3,71,33,19,123,17,11,3,60,13,11,15
8476966,2021,0.01,0.01,0,0,1,0,0,1,0,0,0,1,5,0,0
8476967,2021,2.89,2.87,7,9,92,27,60,179,21,5,9,87,0,103,21
8476975,2021,1.27,1.2,1,1,16,5,5,26,2,0,1,16,31,58,5
8476979,2021,3.17,3.05,8,7,79,34,60,173,18,3,4,76,0,45,10
8476981,2021,18.71,18.27,7,6,152,74,57,283,32,19,13,133,20,153,33
8476982,2021,0.26,0.27,1,0,2,0,4,6,1,0,0,2,11,3,1
8476983,2021,0.01,0.01,0,0,1,0,1,2,0,0,0,1,0,2,0
8476988,2021,2,1.99,7,4,61,18,35,114,11,0,4,61,0,82,8
8476989,2021,0.58,0.57,0,1,9,7,9,25,1,0,0,9,0,25,4
8476994,2021,8.25,8.18,8,4,92,30,32,154,25,13,5,79,12,25,22
8477003,2021,0.35,0.32,0,0,4,3,1,8,0,0,1,4,0,3,1
8477015,2021,15.03,14.64,17,12,121,48,66,235,39,10,9,111,48,14,51
8477018,2021,2.58,2.54,6,4,78,25,63,166,13,3,4,75,0,49,16
8477021,2021,14.74,14.54,21,17,117,42,34,193,51,13,7,104,76,75,36
8477034,2021,1.29,1.18,3,3,40,11,33,84,8,2,4,38,0,71,18
8477070,2021,3.97,3.84,1,0,36,15,16,67,3,2,5,34,5,139,6
8477073,2021,2.68,2.72,2,1,46,17,26,89,5,2,6,44,0,105,5
8477126,2021,1.94,1.9,2,1,19,4,9,32,3,0,1,19,56,27,8
8477149,2021,0.61,0.6,2,0,4,5,1,10,2,0,0,4,1,14,1
8477205,2021,0.76,0.75,2,3,28,11,23,62,6,1,1,27,0,27,10
8477210,2021,3.27,3.17,3,2,38,8,5,51,6,1,4,37,0,56,7
8477215,2021,2.37,2.24,6,5,57,16,46,119,11,0,3,57,0,49,7
8477220,2021,5.43,5.33,15,13,117,55,85,257,32,4,7,113,0,37,32
8477240,2021,2.7,2.6,1,1,15,6,6,27,6,4,3,11,74,36,4
8477244,2021,2.9,2.8,3,6,82,47,52,181,13,4,7,78,0,149,19
8477290,2021,10.08,9.74,8,1,94,33,24,151,16,7,5,87,14,141,36
8477320,2021,2.56,2.51,4,3,28,8,10,46,9,2,5,26,0,82,6
8477330,2021,18.96,17.6,3,14,161,59,65,285,32,15,11,146,8,93,18
8477335,2021,1.62,1.63,1,3,39,10,34,83,5,1,2,38,0,122,7
8477341,2021,12.8,12.04,18,4,114,31,34,179,35,13,9,101,4,64,26
8477343,2021,0.04,0.04,0,0,2,1,0,3,0,0,0,2,0,1,0
8477346,2021,11.21,10.66,17,19,203,68,120,391,44,8,11,195,0,179,74
8477353,2021,9.83,9.73,5,3,101,43,34,178,15,7,4,94,11,117,29
8477355,2021,2.1,2.04,3,3,35,25,18,78,8,2,2,33,0,11,1
8477359,2021,2.02,1.98,1,1,47,14,43,104,3,1,4,46,0,33,7
8477365,2021,2.43,2.41,3,5,80,27,42,149,10,2,4,78,0,156,16
8477369,2021,4.24,4.06,7,4,97,21,51,169,21,10,6,87,0,118,23
8477380,2021,2,1.97,0,1,34,12,6,52,2,1,2,33,49,8,5
8477384,2021,1.13,1.1,4,2,45,18,24,87,6,0,3,45,0,118,9
8477392,2021,0.7,0.69,0,0,3,8,6,17,0,0,0,3,1,16,2
8477401,2021,5.36,5.09,0,2,65,18,20,103,4,2,3,63,2,104,12
8477402,2021,22.29,22.02,22,24,199,53,52,304,76,30,11,169,13,57,46
8477404,2021,37.28,35.84,23,21,264,84,86,434,84,40,29,224,13,72,41
8477406,2021,10.69,10.18,8,8,89,33,22,144,25,9,10,80,11,19,29
8477407,2021,22.95,22.2,18,9,167,39,47,253,58,31,17,136,1,38,37
8477409,2021,21.11,20.86,19,12,167,65,80,312,55,24,13,143,19,50,63
8477416,2021,27.85,26.85,18,11,215,97,90,402,57,28,19,187,10,85,57
8477419,2021,0.98,0.95,0,0,12,5,3,20,0,0,0,12,0,58,4
8477425,2021,0.24,0.22,0,0,2,4,2,8,0,0,0,2,0,5,0
8477426,2021,18.75,17.96,5,11,166,74,63,303,32,16,13,150,426,106,59
8477429,2021,23.24,22.34,18,14,183,59,41,283,53,21,17,162,377,45,34
8477433,2021,0.47,0.47,0,1,13,11,9,33,1,0,1,13,0,36,0
8477435,2021,5.25,5.06,14,8,111,51,79,241,28,6,11,105,0,90,27
8477444,2021,14.8,14.55,24,15,149,66,98,313,61,22,12,127,8,49,28
8477446,2021,5.84,5.67,5,2,51,16,17,84,14,7,2,44,192,116,14
8477447,2021,11.33,10.81,22,16,205,68,144,417,52,14,16,191,0,37,60
8477450,2021,7.33,7.31,2,4,66,32,27,125,11,5,3,61,123,101,20
8477451,2021,26.13,25.36,21,10,239,102,80,421,65,34,21,205,513,72,35
8477454,2021,10.71,10.34,9,4,108,31,37,176,19,6,11,102,34,161,24
8477456,2021,16.66,16.28,9,6,102,44,53,199,33,18,10,84,338,31,26
8477460,2021,5.58,5.31,4,4,50,18,16,84,12,4,2,46,104,31,17
8477461,2021,0.11,0.11,0,0,2,0,1,3,0,0,0,2,0,3,0
8477462,2021,2.08,2.03,4,4,59,36,45,140,9,1,2,58,0,138,10
8477464,2021,1.89,1.91,1,1,21,9,11,41,2,0,3,21,14,6,7
8477471,2021,0.7,0.7,0,0,4,2,3,9,0,0,0,4,0,18,0
8477472,2021,0.05,0.05,2,0,4,0,1,5,2,0,1,4,0,1,2
8477473,2021,0.57,0.55,0,0,16,1,8,25,0,0,0,16,0,12,7
8477474,2021,0.02,0.02,0,0,0,1,2,3,0,0,0,0,0,4,0
8477476,2021,19.43,18.41,12,7,155,58,56,269,38,19,13,136,8,82,18
8477478,2021,15.96,14.72,5,6,120,42,32,194,20,9,16,111,4,159,24
8477479,2021,26.52,24.61,18,14,180,66,60,306,62,30,13,150,6,65,42
8477482,2021,13.5,13.12,7,5,104,63,42,209,21,9,11,95,5,169,36
8477488,2021,5.93,5.74,10,11,148,61,95,304,28,7,14,141,0,39,45
8477492,2021,28.36,26.81,38,18,299,86,116,501,88,32,24,267,383,68,37
8477493,2021,28.66,27.37,26,23,214,60,66,340,88,39,20,175,713,50,59
8477494,2021,4.64,4.61,9,5,62,25,17,104,20,6,3,56,31,27,6
8477495,2021,7.08,6.89,14,26,156,52,92,300,45,5,9,151,0,76,25
8477496,2021,27.52,26.27,24,16,236,74,71,381,82,42,15,194,842,66,55
8477497,2021,11.08,10.91,11,4,111,40,46,197,23,8,9,103,414,59,32
8477498,2021,10.71,10.39,12,14,203,83,124,410,35,9,8,194,0,196,33
8477499,2021,6.07,5.74,7,7,97,43,60,200,16,2,11,95,0,230,12
8477500,2021,25.74,24.75,12,9,195,66,43,304,52,31,11,164,841,96,32
8477501,2021,24.62,24.05,14,13,180,47,37,264,52,25,11,155,0,89,38
8477503,2021,11.28,11.09,18,10,104,41,61,206,39,11,13,93,39,24,36
8477504,2021,11.57,11.36,14,11,173,78,100,351,37,12,10,161,0,150,26
8477505,2021,9.41,9.03,16,10,95,24,33,152,37,11,7,84,555,47,45
8477506,2021,5.85,5.67,7,9,122,37,67,226,21,5,7,117,0,86,15
8477507,2021,4.17,4.15,8,10,106,60,59,225,22,4,8,102,0,181,32
8477508,2021,10.13,9.67,4,4,95,29,23,147,16,8,7,87,136,186,17
8477511,2021,9.18,8.87,11,3,82,22,28,132,23,9,5,73,3,46,13
8477512,2021,0.15,0.14,0,0,4,0,1,5,0,0,0,4,33,16,0
8477527,2021,1.38,1.33,2,3,9,3,6,18,7,2,0,7,0,90,4
8477541,2021,0.02,0.02,0,0,1,1,3,5,0,0,0,1,0,3,0
8477573,2021,4.61,4.6,3,1,38,17,9,64,12,8,2,30,8,58,8
8477631,2021,0,0,0,0,0,0,0,0,0,0,0,0,0,6,0
8477810,2021,0.72,0.69,3,1,18,14,24,56,6,2,0,16,0,60,5
8477839,2021,15.88,15.49,14,10,129,53,32,214,43,19,5,110,11,45,38
8477845,2021,2.97,2.93,6,10,75,27,45,147,17,1,5,74,0,25,30
8477846,2021,6.76,6.56,4,5,67,26,24,117,12,3,5,64,200,136,19
8477851,2021,1.9,1.85,4,2,63,14,24,101,8,2,2,61,0,27,6
8477887,2021,4.92,4.65,4,1,51,18,14,83,9,4,4,47,242,100,9
8477903,2021,14.44,13.98,4,8,124,35,38,197,26,14,6,110,10,250,23
8477919,2021,12.23,12.04,15,15,132,47,48,227,44,14,10,118,461,48,38
8477930,2021,9.06,8.86,5,6,72,32,25,129,20,9,5,63,483,88,26
8477931,2021,10.24,10.29,8,6,84,44,28,156,17,3,3,81,362,85,27
8477932,2021,10.72,9.92,13,29,180,53,84,317,57,15,18,165,0,62,43
8477933,2021,30.51,28.84,31,18,186,80,59,325,82,33,18,153,174,49,37
8477934,2021,42.54,40.9,33,22,278,109,95,482,110,55,21,223,887,53,74
8477935,2021,27.06,24.8,15,6,241,51,106,398,49,28,14,213,411,119,41
8477936,2021,0.08,0.08,0,0,2,0,0,2,0,0,0,2,0,0,0
8477938,2021,2.81,2.75,1,1,54,24,40,118,4,2,4,52,0,76,7
8477939,2021,28.22,27.35,34,12,256,109,102,467,80,34,21,222,34,19,59
8477940,2021,22.68,21.71,18,9,245,97,108,450,55,28,26,217,2,32,41
8477941,2021,11.6,11.44,4,7,93,41,25,159,23,12,11,81,0,153,9
8477942,2021,28.33,27.41,31,21,262,96,95,453,85,33,18,229,4,52,38
8477943,2021,2.05,1.99,1,0,24,10,10,44,5,4,1,20,0,29,3
8477944,2021,5.94,5.85,5,1,65,25,17,107,19,13,2,52,1,14,12
8477946,2021,23.52,22.53,26,12,212,69,104,385,69,31,19,181,630,76,38
8477947,2021,12.87,12.5,15,5,94,47,36,177,34,14,5,80,0,27,29
8477948,2021,7.04,6.91,11,13,123,51,75,249,31,7,10,116,0,64,23
8477949,2021,16.46,15.52,15,11,139,52,37,228,38,12,9,127,9,32,40
8477950,2021,6.83,6.63,21,20,151,40,73,264,51,10,8,141,0,41,27
8477951,2021,14.3,13.87,27,9,123,40,49,212,59,23,10,100,114,15,52
8477952,2021,15.01,14.41,10,3,123,47,41,211,30,17,7,106,54,86,13
8477953,2021,11.13,11.06,13,8,129,49,57,235,32,11,14,118,5,110,40
8477955,2021,21.8,21.16,12,11,199,88,66,353,50,27,15,172,224,65,43
8477956,2021,31.08,29.29,27,10,312,126,122,560,77,40,16,272,7,63,36
8477960,2021,30.25,29.21,8,11,247,84,112,443,54,35,23,212,25,111,34
8477962,2021,7.31,6.94,3,2,65,37,30,132,13,8,3,57,11,122,11
8477964,2021,18.55,18.34,23,11,111,39,38,188,60,26,10,85,131,160,44
8477969,2021,3.24,3.21,11,6,83,53,53,189,19,2,6,81,0,122,17
8477974,2021,0.1,0.09,0,0,2,0,0,2,0,0,0,2,0,0,0
8477979,2021,9.12,8.99,9,3,87,32,33,152,23,11,6,76,3,140,17
8477986,2021,10.17,9.6,10,16,153,66,79,298,37,11,12,142,0,64,26
8477987,2021,17.4,16.44,11,4,159,63,46,268,31,16,21,143,15,70,39
8477989,2021,11.86,11.38,15,7,87,29,28,144,33,11,6,76,548,32,16
8477996,2021,8.52,8.3,6,2,67,25,26,118,15,7,6,60,354,93,17
8477998,2021,17.37,16.77,10,4,142,49,54,245,26,12,11,130,13,127,44
8478010,2021,26.43,25.57,14,16,176,77,38,291,58,28,10,148,366,75,33
8478013,2021,4.92,4.87,2,5,87,35,51,173,10,3,4,84,0,47,9
8478017,2021,1.9,1.85,1,3,27,14,8,49,5,1,2,26,0,27,4
8478020,2021,7.1,6.75,4,3,64,19,26,109,18,11,4,53,30,42,26
8478021,2021,0.78,0.76,0,5,33,6,31,70,5,0,3,33,0,40,5
8478038,2021,9.33,8.95,11,33,158,44,65,267,57,13,10,145,0,54,45
8478040,2021,1.1,1.1,0,0,9,7,3,19,0,0,0,9,0,23,1
8478042,2021,25.6,24.74,17,12,227,97,88,412,49,20,19,207,12,23,24
8478043,2021,8.07,7.88,7,1,80,20,23,123,13,5,5,75,108,137,23
8478046,2021,16.93,16.38,10,5,138,45,34,217,33,18,9,120,0,66,36
8478047,2021,25.16,24.3,24,16,175,67,54,296,63,23,17,152,8,85,36
8478051,2021,4.61,4.55,0,2,65,15,20,100,6,4,4,61,2,53,14
8478055,2021,7.9,7.55,13,14,145,47,104,296,37,10,5,135,0,45,51
8478056,2021,0.89,0.9,0,1,8,8,6,22,1,0,1,8,3,12,0
8478057,2021,4.37,4.38,3,2,31,10,8,49,8,3,6,28,40,77,7
8478058,2021,0.06,0.07,0,0,0,2,0,2,0,0,0,0,2,2,1
8478062,2021,2.7,2.58,2,6,76,30,52,158,12,4,5,72,0,129,14
8478067,2021,12.78,12.1,8,6,127,39,46,212,26,12,13,115,8,83,19
8478074,2021,0.05,0.03,0,0,2,0,0,2,0,0,0,2,0,13,0
8478075,2021,4.08,4.02,3,0,51,13,29,93,8,5,4,46,1,11,16
8478099,2021,3.01,2.92,2,1,36,11,15,62,6,3,1,33,0,28,6
8478104,2021,1.96,1.9,3,1,17,8,8,33,4,0,0,17,1,37,2
8478106,2021,0.47,0.44,1,0,3,1,0,4,1,0,1,3,0,0,2
8478109,2021,16.62,16.25,18,11,164,59,70,293,49,20,15,144,0,10,18
8478115,2021,17.2,16.7,14,6,154,63,53,270,35,15,8,139,29,66,32
8478131,2021,13.71,12.86,6,7,119,39,47,205,27,14,4,105,2,29,28
8478133,2021,11.11,10.83,11,5,124,31,40,195,29,13,5,111,461,88,39
8478136,2021,3.94,3.84,5,5,73,23,28,124,14,4,5,69,0,118,27
8478146,2021,6.5,6.34,3,4,61,20,14,95,12,5,5,56,3,41,16
8478147,2021,0.48,0.43,0,0,3,0,1,4,1,1,0,2,0,10,0
8478173,2021,1.65,1.63,1,1,10,3,1,14,3,1,1,9,1,12,1
8478178,2021,0.04,0.04,0,0,2,1,2,5,0,0,0,2,0,4,1
8478211,2021,11.7,11.08,7,4,94,48,35,177,17,6,9,88,5,153,21
8478233,2021,26.63,26.03,13,7,185,50,65,300,55,35,14,150,21,73,52
8478250,2021,0.2,0.18,2,0,1,1,2,4,2,0,0,1,1,1,0
8478366,2021,13.97,13.6,10,4,161,48,57,266,32,18,12,143,12,68,22
8478396,2021,8.4,8.26,12,26,189,92,116,397,48,10,14,179,0,63,38
8478397,2021,8.14,7.73,21,25,152,62,75,289,50,4,16,148,0,63,24
8478398,2021,35.14,34.07,27,19,317,78,104,499,93,47,17,270,1,32,66
8478399,2021,2.66,2.58,6,7,92,29,69,190,14,1,9,91,0,98,17
8478400,2021,5.96,5.82,5,2,47,13,12,72,10,3,3,44,86,28,4
8478401,2021,18.47,17.35,10,11,148,63,53,264,36,15,7,133,189,80,33
8478402,2021,42.51,41.3,49,30,315,78,88,481,123,44,27,271,562,75,73
8478403,2021,11.21,10.8,6,5,133,27,33,193,25,14,5,119,184,45,25
8478407,2021,6.52,6.35,9,19,121,58,103,282,35,7,12,114,0,76,25
8478408,2021,3.05,2.98,2,3,46,22,32,100,7,2,2,44,0,55,7
8478413,2021,14.37,13.88,7,10,110,35,21,166,27,10,12,100,18,155,14
8478414,2021,31.03,30,22,19,326,122,125,573,76,35,26,291,18,162,49
8478415,2021,0.8,0.8,1,2,13,2,5,20,3,0,0,13,0,24,1
8478416,2021,2.91,2.86,7,5,86,41,49,176,13,1,5,85,0,165,21
8478420,2021,30.68,29.83,37,19,254,110,95,459,92,36,19,218,164,58,48
8478421,2021,1.38,1.33,0,1,14,2,4,20,2,1,0,13,2,20,0
8478424,2021,6.43,6.39,3,3,67,33,42,142,13,7,2,60,28,51,26
8478425,2021,0.41,0.39,0,0,6,7,5,18,0,0,0,6,0,11,0
8478427,2021,37.6,36.16,28,16,221,108,73,402,81,37,29,184,555,76,68
8478430,2021,6.66,6.5,8,14,138,56,83,277,31,9,6,129,0,40,24
8478431,2021,7.67,7.39,5,7,78,21,24,123,19,7,7,71,3,104,24
8478432,2021,8.4,8.13,4,1,76,19,28,123,10,5,7,71,76,91,17
8478434,2021,12.68,11.76,12,5,94,23,25,142,24,7,9,87,76,246,33
8478438,2021,2.67,2.68,2,4,25,12,10,47,7,1,1,24,62,4,14
8478439,2021,23.47,22.02,27,9,220,77,85,382,52,16,19,204,13,80,22
8478440,2021,15.46,15.12,12,14,126,30,27,183,48,22,3,104,460,11,47
8478442,2021,0.1,0.1,1,0,1,0,0,1,1,0,0,1,0,0,1
8478443,2021,3.69,3.59,5,4,125,37,51,213,15,6,4,119,0,143,32
8478444,2021,25.26,23.23,10,13,195,90,106,391,46,23,16,172,27,35,33
8478445,2021,15.65,15.24,25,19,161,47,44,252,59,15,9,146,234,36,43
8478446,2021,0.07,0.07,0,0,3,0,1,4,0,0,0,3,3,1,0
8478447,2021,0.88,0.88,1,1,7,5,3,15,3,1,0,6,6,9,7
8478449,2021,32.46,30.88,22,13,213,91,63,367,72,37,23,176,357,82,24
8478451,2021,4.05,3.86,6,3,97,32,57,186,14,5,10,92,0,55,16
8478452,2021,3.99,3.92,7,9,95,21,49,165,21,5,2,90,0,100,26
8478454,2021,0.14,0.13,1,1,6,3,2,11,2,0,1,6,0,20,1
8478458,2021,11.87,11.6,14,9,131,51,37,219,45,22,7,109,372,60,32
8478460,2021,13.65,12.39,22,15,216,97,115,428,48,11,13,205,0,33,39
8478462,2021,21.82,20.38,19,5,145,51,42,238,39,15,23,130,454,85,34
8478463,2021,16.05,15.43,15,7,154,47,51,252,34,12,17,142,4,39,36
8478465,2021,0,0,0,0,0,0,0,0,0,0,0,0,0,0,0
8478466,2021,14,13.99,4,2,153,67,49,269,20,14,11,139,0,43,20
8478467,2021,1.32,1.33,1,4,36,16,42,94,7,2,4,34,0,158,17
8478468,2021,2.87,2.81,3,2,75,25,51,151,7,2,3,73,0,224,10
8478469,2021,10.22,9.58,14,17,173,54,103,330,38,7,11,166,0,73,29
8478472,2021,11.36,10.98,10,8,86,39,25,150,30,12,2,74,20,106,45
8478474,2021,14.97,14.27,9,5,131,52,41,224,34,20,11,111,16,181,29
8478476,2021,2.29,2.21,5,2,40,22,23,85,9,2,5,38,0,43,16
8478477,2021,1.28,1.21,3,3,17,9,12,38,6,0,4,17,124,21,5
8478480,2021,0.03,0.03,0,0,1,0,1,2,0,0,0,1,6,3,1
8478483,2021,26.51,25.84,36,26,224,91,105,420,97,35,13,189,10,75,72
8478485,2021,0.01,0.01,0,0,0,1,0,1,0,0,0,0,0,4,0
8478486,2021,0.92,0.92,0,0,2,2,1,5,0,0,0,2,2,4,0
8478491,2021,0.12,0.12,0,1,5,2,1,8,1,0,0,5,0,1,0
8478493,2021,27.48,26.19,11,12,224,53,54,331,49,26,16,198,697,138,30
8478495,2021,13.82,12.36,13,7,144,55,82,281,31,11,13,133,0,67,12
8478498,2021,20.88,20.14,11,6,185,40,53,278,42,25,12,160,10,62,35
8478500,2021,8.34,8.04,8,14,170,51,101,322,31,9,7,161,0,74,17
8478506,2021,0.68,0.68,3,4,18,4,16,38,9,2,1,16,0,27,7
8478507,2021,4.35,4.29,10,14,90,39,62,191,25,1,6,89,0,73,43
8478508,2021,16.98,16.81,3,4,136,55,52,243,24,17,5,119,12,191,37
8478512,2021,1.29,1.27,3,2,14,8,7,29,7,2,0,12,23,3,6
8478519,2021,18.23,17.69,13,13,146,56,58,260,43,17,12,129,441,75,60
8478528,2021,1.16,1.12,1,2,14,4,8,26,3,0,0,14,9,12,6
8478542,2021,22.84,21.82,15,9,244,66,83,393,43,19,17,225,183,89,33
8478550,2021,17.7,16.95,43,31,177,88,105,370,96,22,12,155,1,22,56
8478567,2021,2.51,2.32,1,7,41,15,20,76,11,3,2,38,0,43,9
8478569,2021,4.73,4.3,3,2,32,13,7,52,8,3,2,29,84,48,8
8478585,2021,8.93,8.78,7,5,72,23,23,118,22,10,5,62,286,38,26
8478831,2021,0.19,0.19,0,0,3,0,1,4,0,0,0,3,1,2,1
8478838,2021,1.35,1.32,0,0,10,1,0,11,1,1,0,9,13,7,4
8478840,2021,1.5,1.44,4,2,49,17,31,97,8,2,4,47,0,89,4
8478841,2021,0.89,0.85,1,3,18,12,15,45,4,0,4,18,0,24,1
8478846,2021,0.44,0.41,1,0,5,2,4,11,2,1,0,4,0,5,6
8478851,2021,5.57,5.48,13,14,95,40,53,188,30,3,8,92,0,95,27
8478856,2021,18.45,17.92,22,11,203,63,65,331,52,19,17,184,5,52,50
8478859,2021,2.43,2.42,6,4,58,21,31,110,13,3,5,55,0,109,7
8478864,2021,31.19,30.5,39,22,289,111,115,515,108,47,19,242,5,73,57
8478866,2021,7.76,7.72,7,3,88,26,24,138,13,3,6,85,9,72,22
8478868,2021,0.61,0.57,0,0,9,5,7,21,0,0,0,9,0,21,1
8478870,2021,9.81,9.67,7,5,98,35,27,160,23,11,3,87,8,115,35
8478873,2021,24.77,24.23,15,15,192,72,63,327,67,37,15,155,1,6,35
8478874,2021,8.19,7.94,5,4,94,32,36,162,14,5,4,89,56,72,21
8478881,2021,0.13,0.15,0,0,1,0,1,2,0,0,0,1,0,3,0
8478882,2021,7.88,7.58,13,15,108,37,59,204,33,5,8,103,0,124,22
8478891,2021,11.27,10.99,8,5,98,38,35,171,21,8,6,90,7,64,15
8478904,2021,11.09,10.81,2,3,80,33,29,142,13,8,8,72,51,67,24
8478906,2021,0,0,1,0,0,0,0,0,1,0,0,0,0,1,0
8478911,2021,6.25,5.98,16,3,153,51,72,276,21,2,20,151,0,124,8
8478915,2021,0.29,0.28,5,1,14,3,10,27,6,0,0,14,0,6,2
8478949,2021,0.08,0.08,0,0,2,0,1,3,0,0,0,2,0,3,0
8478967,2021,1.93,1.9,1,1,24,9,7,40,2,0,1,24,42,54,6
8478970,2021,1.05,1.01,1,2,25,11,15,51,3,0,2,25,0,32,6
8478975,2021,18.11,17.64,15,14,121,43,43,207,47,18,13,103,11,114,25
8478996,2021,1.63,1.58,1,0,14,4,3,21,3,2,0,12,23,11,3
8479026,2021,1.17,1.18,2,1,28,21,23,72,4,1,0,27,0,50,8
8479066,2021,9.36,9.15,4,5,91,32,39,162,18,9,7,82,1,117,18
8479249,2021,0.33,0.33,0,2,4,1,0,5,2,0,1,4,3,0,0
8479252,2021,0.08,0.08,0,0,3,1,1,5,0,0,0,3,0,4,1
8479289,2021,0.24,0.22,0,0,2,0,1,3,1,1,0,1,0,2,0
8479291,2021,7.05,7.03,3,3,71,13,26,110,12,6,7,65,181,84,22
8479293,2021,8.47,8.04,4,2,51,13,13,77,15,9,7,42,1,98,10
8479304,2021,0.33,0.34,1,1,5,2,3,10,2,0,0,5,4,6,0
8479314,2021,34.58,33.29,39,23,253,121,81,455,104,42,21,211,20,93,41
8479315,2021,0.66,0.65,0,0,10,2,3,15,0,0,2,10,0,3,2
8479316,2021,15.32,14.86,6,3,125,51,33,209,22,13,9,112,48,223,20
8479318,2021,41.86,40.01,26,20,348,136,115,599,106,60,32,288,691,67,92
8479320,2021,0.37,0.34,0,0,6,4,8,18,0,0,0,6,0,3,0
8479321,2021,0.04,0.04,1,0,0,1,0,1,1,0,0,0,0,0,0
8479322,2021,0.14,0.13,0,0,2,0,0,2,0,0,0,2,0,1,1
8479323,2021,7.06,6.82,33,30,158,39,78,275,74,11,13,147,0,30,78
8479324,2021,4.05,3.9,6,5,73,27,54,154,15,4,5,69,0,129,19
8479325,2021,8.86,8.16,16,30,166,61,68,295,56,10,12,156,0,155,29
8479328,2021,10.37,9.12,2,2,69,27,14,110,7,3,7,66,1,98,15
8479333,2021,0.29,0.29,0,1,12,3,7,22,1,0,0,12,0,7,2
8479335,2021,14.42,13.21,14,5,130,44,18,192,27,8,11,122,26,30,21
8479336,2021,8.8,8.35,3,3,83,31,25,139,15,9,4,74,6,134,13
8479337,2021,31.16,30.15,19,18,270,84,116,470,78,41,18,229,24,101,67
8479338,2021,0.42,0.41,0,1,12,3,11,26,1,0,0,12,0,82,4
8479339,2021,17.56,17.16,15,15,167,71,79,317,56,26,17,141,14,34,27
8479341,2021,2.19,2.1,3,4,52,30,28,110,7,0,1,52,0,22,6
8479343,2021,20.52,19.98,22,13,177,51,46,274,63,28,16,149,29,17,61
8479344,2021,20.93,20.17,14,8,160,66,38,264,36,14,10,146,0,81,27
8479345,2021,6.72,6.66,7,7,141,82,70,293,21,7,7,134,0,51,19
8479346,2021,15.31,14.91,7,7,143,45,40,228,32,18,13,125,92,87,24
8479347,2021,1.09,1.07,1,0,18,7,10,35,2,1,1,17,0,45,3
8479348,2021,1.24,1.13,5,3,26,5,25,56,10,2,4,24,0,14,6
8479351,2021,6.86,6.62,7,7,67,22,36,125,20,6,5,61,203,37,18
8479353,2021,6.35,6.12,6,5,39,21,9,69,20,9,7,30,140,62,13
8479355,2021,0.46,0.45,0,0,18,7,9,34,0,0,1,18,0,14,2
8479356,2021,6.24,5.87,8,5,80,28,39,147,19,6,6,74,0,103,6
8479359,2021,0.92,0.93,0,0,10,5,2,17,1,1,0,9,1,34,2
8479362,2021,0.59,0.61,0,0,5,2,1,8,1,1,0,4,1,9,1
8479364,2021,0.22,0.22,0,0,3,2,1,6,0,0,0,3,2,15,0
8479365,2021,10.81,10.67,9,1,100,26,31,157,18,8,11,92,35,119,23
8479366,2021,5.38,5.23,4,3,34,15,7,56,11,4,4,30,66,22,7
8479367,2021,1.75,1.75,0,0,13,7,4,24,0,0,0,13,0,49,1
8479368,2021,0.06,0.06,0,0,2,1,1,4,0,0,0,2,1,2,0
8479369,2021,3.43,3.41,4,9,72,37,58,167,15,2,5,70,0,191,15
8479370,2021,8.92,8.75,8,4,97,21,39,157,20,8,5,89,172,55,38
8479371,2021,3.52,3.27,11,10,88,43,58,189,24,3,7,85,0,69,22
8479372,2021,1.5,1.47,2,2,36,16,30,82,7,3,2,33,0,63,5
8479373,2021,13.77,13.39,7,3,105,32,41,178,22,12,9,93,0,16,21
8479376,2021,1.59,1.6,6,1,27,15,13,55,7,0,0,27,0,13,7
8479378,2021,2.98,2.87,5,7,80,48,52,180,13,1,4,79,0,131,13
8479379,2021,4.18,3.73,3,1,50,14,19,83,8,4,2,46,2,86,7
8479382,2021,1.5,1.39,0,0,10,5,2,17,0,0,0,10,57,17,0
8479383,2021,6.16,6.01,2,2,58,22,20,100,7,3,2,55,7,138,16
8479385,2021,17.13,16.98,32,16,188,54,81,323,75,27,12,161,6,6,36
8479388,2021,1.93,1.89,7,3,49,24,44,117,12,2,1,47,0,122,11
8479390,2021,14,13.53,9,2,104,38,21,163,22,11,11,93,6,103,23
8479393,2021,14.36,14.2,7,8,156,54,53,263,23,8,11,148,12,118,28
8479395,2021,0.5,0.5,0,3,11,9,13,33,3,0,0,11,0,5,1
8479398,2021,3.14,3.17,12,11,79,37,72,188,28,5,5,74,0,65,21
8479400,2021,35.25,33.77,21,11,233,96,64,393,60,28,18,205,532,112,22
8479402,2021,4.68,4.6,6,12,90,44,75,209,25,7,8,83,0,41,21
8479404,2021,5.02,4.75,0,3,41,16,28,85,7,4,3,37,82,26,22
8479407,2021,19.14,18.65,26,21,197,66,61,324,73,26,17,171,0,26,29
8479410,2021,7.28,7.15,16,15,149,57,77,283,38,7,5,142,0,139,23
8479413,2021,0.03,0.03,0,0,2,0,1,3,0,0,0,2,0,4,1
8479414,2021,15.08,14.6,4,2,97,48,20,165,18,12,7,85,23,210,13
8479415,2021,7.04,6.89,7,7,78,28,20,126,20,6,4,72,604,145,46
8479419,2021,2.7,2.5,3,1,14,8,3,25,6,2,6,12,0,17,4
8479420,2021,26.09,24.7,15,15,253,95,109,457,68,38,22,215,393,66,49
8479421,2021,0.31,0.29,1,1,15,2,11,28,2,0,0,15,0,16,1
8479425,2021,7.46,7.26,18,15,133,58,89,280,38,5,8,128,0,70,16
8479439,2021,1.33,1.35,0,0,17,5,4,26,0,0,3,17,0,9,0
8479442,2021,1.5,1.49,1,1,50,18,19,87,3,1,2,49,0,33,7
8479447,2021,0.61,0.65,0,0,5,0,0,5,0,0,2,5,0,1,0
8479458,2021,2.33,2.29,4,5,65,37,36,138,11,2,3,63,0,128,13
8479465,2021,1.96,2,3,0,23,8,6,37,5,2,1,21,1,17,6
8479482,2021,0.51,0.48,0,1,10,10,20,40,2,1,3,9,0,22,1
8479511,2021,6.47,6.31,4,7,64,25,20,109,17,6,6,58,2,33,26
8479512,2021,0.84,0.82,0,0,8,0,3,11,1,1,0,7,0,9,0
8479514,2021,9.85,9.6,13,9,63,19,12,94,37,15,6,48,52,25,31
8479516,2021,0.13,0.13,0,0,1,1,1,3,1,1,0,0,8,2,1
8479518,2021,0.21,0.21,1,0,1,0,0,1,1,0,1,1,0,0,0
8479520,2021,8.58,8.15,5,6,91,29,41,161,17,6,4,85,8,201,16
8479523,2021,1.96,1.94,3,3,41,17,27,85,9,3,6,38,0,39,7
8479525,2021,19.41,18.79,11,6,159,56,44,259,39,22,15,137,303,153,29
8479526,2021,0.49,0.44,1,1,8,1,2,11,2,0,0,8,22,8,1
8479534,2021,0.05,0.05,0,2,3,0,3,6,2,0,0,3,0,0,3
8479536,2021,2.29,2.2,2,0,29,10,8,47,4,2,4,27,1,18,3
8479542,2021,17.92,17.56,15,4,125,41,57,223,44,25,7,100,24,63,53
8479543,2021,5.45,5.29,5,1,49,16,12,77,11,5,4,44,6,156,4
8479546,2021,2.03,2.01,3,1,25,9,9,43,6,2,2,23,1,32,9
8479550,2021,0,0,0,0,0,0,1,1,0,0,0,0,2,3,1
8479553,2021,7.9,7.44,4,3,49,17,15,81,14,7,10,42,0,59,9
8479573,2021,1.68,1.71,0,0,23,7,8,38,0,0,2,23,44,31,7
8479578,2021,1.45,1.43,3,3,41,9,17,67,6,0,1,41,0,86,13
8479580,2021,7.57,7.5,2,2,58,32,12,102,7,3,4,55,295,103,11
8479587,2021,0.04,0.04,0,0,0,1,0,1,0,0,0,0,5,5,4
8479591,2021,0.02,0.02,0,0,1,0,0,1,0,0,0,1,0,0,1
8479597,2021,0.23,0.21,0,0,4,1,2,7,0,0,0,4,0,3,1
8479602,2021,0.18,0.17,1,1,5,2,2,9,2,0,0,5,0,5,2
8479619,2021,4.13,3.75,1,1,36,13,15,64,6,4,2,32,0,31,8
8479639,2021,4.7,4.58,4,6,108,49,61,218,13,3,9,105,0,62,20
8479644,2021,2.48,2.48,3,0,26,8,9,43,6,3,2,23,2,29,3
8479661,2021,17.98,17.72,9,8,124,56,35,215,41,24,10,100,10,318,32
8479671,2021,0.44,0.46,1,0,5,3,3,11,1,0,1,5,0,23,3
8479675,2021,25.12,23.37,20,11,202,83,56,341,48,17,23,185,28,69,30
8479705,2021,3.45,3.01,1,1,30,9,13,52,5,3,4,27,4,84,13
8479718,2021,1.91,1.8,3,0,16,5,7,28,6,3,2,13,6,10,4
8479729,2021,0.34,0.3,0,0,5,0,1,6,0,0,0,5,0,12,0
8479772,2021,8.69,8.16,3,3,82,39,24,145,9,3,7,79,16,159,22
8479933,2021,6.58,6.29,0,1,53,27,23,103,12,11,5,42,3,58,9
8479941,2021,8.64,8.62,3,1,72,34,25,131,14,10,6,62,108,85,15
8479944,2021,8.18,7.87,6,4,78,24,28,130,15,5,8,73,4,231,19
8479945,2021,1.41,1.41,3,5,44,21,20,85,8,0,3,44,0,50,12
8479968,2021,4.25,4.18,3,2,50,21,15,86,10,5,5,45,12,40,6
8479972,2021,0.32,0.33,0,0,7,2,1,10,0,0,0,7,1,6,3
8479974,2021,3.43,3.26,3,2,34,9,8,51,7,2,3,32,83,26,13
8479976,2021,0.34,0.35,1,1,11,2,8,21,2,0,1,11,0,8,3
8479977,2021,18.74,18.1,14,7,114,41,33,188,41,20,7,94,2,114,34
8479980,2021,4.79,4.62,4,6,116,46,77,239,14,4,12,112,0,57,25
8479981,2021,5.02,4.98,2,0,36,17,16,69,3,1,1,35,1,104,7
8479982,2021,0.33,0.32,0,0,5,5,7,17,0,0,2,5,0,7,3
8479983,2021,2.32,2.32,3,9,49,28,31,108,14,2,2,47,0,140,31
8479984,2021,2.29,2.31,4,3,49,26,37,112,9,2,1,47,0,83,4
8479985,2021,0.03,0.04,0,0,2,0,2,4,0,0,0,2,0,3,0
8479986,2021,2.67,2.67,1,5,31,8,8,47,8,2,3,29,6,18,7
8479987,2021,9.72,9.37,6,9,97,45,47,189,22,7,3,90,351,55,25
8479991,2021,3.61,3.54,3,1,35,12,14,61,6,2,3,33,122,45,13
8479992,2021,16.63,16.2,8,4,129,44,22,195,27,15,18,114,410,142,29
8479994,2021,0.57,0.57,0,0,5,6,6,17,0,0,0,5,9,12,2
8479996,2021,0.94,0.9,0,1,9,3,3,15,1,0,0,9,20,13,1
8479998,2021,3.09,3.05,4,2,58,27,48,133,8,2,2,56,0,133,10
8479999,2021,6.96,6.63,6,7,79,20,21,120,19,6,2,73,202,19,13
8480001,2021,1.18,1.18,4,2,27,11,17,55,6,0,0,27,0,27,7
8480002,2021,20.35,19.06,21,18,153,61,56,270,60,21,12,132,730,50,45
8480003,2021,7.84,7.79,7,6,74,31,30,135,23,10,4,64,168,31,18
8480005,2021,3.06,3.04,0,1,43,6,15,64,3,2,4,41,0,72,5
8480007,2021,3.51,3.39,2,2,30,12,8,50,6,2,2,28,0,13,8
8480008,2021,3.18,3.17,4,1,33,12,13,58,10,5,2,28,103,24,6
8480009,2021,13.98,13.49,6,6,151,58,57,266,23,11,8,140,0,176,15
8480011,2021,2.76,2.83,2,3,31,13,16,60,9,4,4,27,2,90,9
8480012,2021,23.84,22.49,20,16,192,98,97,387,68,32,10,160,238,49,56
8480014,2021,4.15,4.01,1,1,41,11,8,60,7,5,3,36,60,6,6
8480015,2021,13.76,13.36,8,3,126,37,50,213,21,10,11,116,21,98,36
8480018,2021,18.81,17.41,19,21,186,52,71,309,61,21,17,165,699,89,50
8480019,2021,1.37,1.31,1,2,14,6,2,22,4,1,3,13,0,16,2
8480021,2021,1.74,1.76,2,1,21,9,7,37,3,0,1,21,58,17,3
8480023,2021,18.57,18.3,36,21,115,51,25,191,77,20,6,95,562,13,60
8480025,2021,4.63,4.48,4,3,34,12,8,54,12,5,5,29,18,129,9
8480027,2021,30.15,28.45,19,19,220,73,107,400,79,41,25,179,0,50,48
8480028,2021,8.46,7.98,7,4,85,26,41,152,16,5,14,80,226,44,27
8480029,2021,22.6,21.85,8,6,162,47,47,256,32,18,17,144,8,101,44
8480031,2021,7.66,7.55,5,5,72,38,20,130,16,6,4,66,22,111,9
8480035,2021,3.83,3.72,6,10,83,19,44,146,19,3,5,80,0,73,12
8480036,2021,9.92,9.31,18,13,156,62,94,312,36,5,16,151,0,52,45
8480037,2021,0.62,0.61,0,1,7,1,0,8,1,0,0,7,2,0,3
8480039,2021,14.1,13.67,17,9,159,67,69,295,40,14,7,145,38,55,38
8480041,2021,0,0,0,0,0,0,1,1,0,0,0,0,0,0,0
8480043,2021,3.65,3.55,6,12,79,31,52,162,23,5,6,74,0,87,19
8480049,2021,0.51,0.53,1,4,14,9,5,28,5,0,0,14,0,21,6
8480053,2021,2.41,2.22,4,4,31,18,11,60,8,0,4,31,31,20,8
8480054,2021,0.02,0.02,0,1,2,0,1,3,1,0,0,2,0,0,0
8480056,2021,0.47,0.47,0,0,10,6,6,22,0,0,0,10,0,5,2
8480058,2021,0.37,0.37,0,0,7,2,4,13,0,0,1,7,0,6,5
8480060,2021,5.74,5.57,1,1,33,15,6,54,9,7,3,26,53,14,6
8480064,2021,26.17,25.16,7,13,172,74,73,319,55,35,13,137,529,79,24
8480068,2021,9.95,9.47,5,3,92,23,23,138,17,9,9,83,227,40,21
8480069,2021,15.02,14.57,29,29,240,79,175,494,86,28,21,212,0,95,49
8480070,2021,0.08,0.08,1,0,2,3,4,9,1,0,0,2,0,2,0
8480071,2021,0.74,0.73,3,1,24,5,14,43,5,1,3,23,0,7,5
8480072,2021,2.91,2.65,1,0,29,4,5,38,2,1,5,28,21,23,2
8480073,2021,3.73,3.54,6,8,86,29,53,168,14,0,8,86,0,39,10
8480074,2021,8.48,8.36,7,2,59,23,27,109,20,11,4,48,20,13,16
8480078,2021,14.47,13.4,8,6,135,53,43,231,22,8,12,127,135,24,23
8480083,2021,0.1,0.1,0,0,0,2,0,2,0,0,0,0,0,1,0
8480087,2021,0.33,0.33,0,0,3,0,0,3,0,0,1,3,0,0,0
8480113,2021,22.26,21.53,10,10,215,78,52,345,37,17,13,198,15,48,46
8480144,2021,12.43,12.19,10,5,102,34,32,168,26,11,5,91,616,80,30
8480145,2021,5.97,5.8,16,15,140,63,75,278,34,3,8,137,0,185,27
8480157,2021,0.88,0.91,1,4,18,7,14,39,7,2,1,16,0,6,3
8480160,2021,1.71,1.68,1,0,25,9,15,49,2,1,2,24,0,96,10
8480172,2021,3.4,3.34,5,10,86,44,68,198,18,3,7,83,0,93,6
8480184,2021,1.3,1.27,3,9,41,10,28,79,13,1,5,40,0,59,9
8480185,2021,10.25,9.78,10,7,84,26,43,153,26,9,8,75,321,103,38
8480188,2021,3.25,3.16,3,2,36,8,6,50,8,3,2,33,2,16,3
8480192,2021,0.19,0.18,0,0,7,2,4,13,0,0,0,7,0,0,0
8480196,2021,1.69,1.65,8,1,43,8,34,85,10,1,0,42,0,55,24
8480205,2021,5.37,4.97,2,3,62,22,21,105,11,6,4,56,2,36,11
8480208,2021,11.66,11.34,19,8,111,38,40,189,44,17,11,94,18,89,21
8480216,2021,9.86,9.64,3,2,85,30,31,146,17,12,6,73,59,22,13
8480220,2021,4,3.72,3,1,23,9,11,43,9,5,0,18,0,21,10
8480222,2021,1.81,1.77,3,7,34,17,25,76,12,2,2,32,0,32,8
8480226,2021,5.18,4.96,0,2,42,15,15,72,4,2,3,40,1,25,13
8480231,2021,0.29,0.28,0,0,8,2,7,17,0,0,1,8,0,2,1
8480259,2021,0.06,0.06,0,0,1,1,1,3,0,0,0,1,0,4,0
8480281,2021,4.63,4.5,0,0,43,16,7,66,2,2,4,41,1,69,5
8480289,2021,2.76,2.69,1,2,33,6,7,46,5,2,4,31,30,49,6
8480292,2021,1.6,1.61,2,0,13,5,7,25,3,1,0,12,0,27,4
8480293,2021,0.12,0.11,0,0,1,4,2,7,0,0,0,1,0,9,1
8480304,2021,0.49,0.46,1,0,7,2,1,10,1,0,0,7,0,3,1
8480306,2021,1.13,1.03,0,0,22,7,14,43,1,1,1,21,0,15,2
8480326,2021,1.68,1.64,1,0,17,9,2,28,3,2,1,15,7,9,2
8480336,2021,1.04,0.88,1,1,18,4,10,32,2,0,2,18,0,9,1
8480355,2021,1.46,1.39,1,1,11,8,3,22,4,2,0,9,70,51,9
8480384,2021,0.32,0.29,0,0,6,0,1,7,0,0,0,6,12,22,1
8480434,2021,5.89,5.68,12,12,119,31,97,247,27,3,12,116,0,74,26
8480441,2021,0.45,0.47,0,1,5,3,1,9,2,1,0,4,0,7,2
8480443,2021,1.82,1.65,0,1,18,5,7,30,2,1,3,17,1,14,7
8480448,2021,5.64,5.58,0,5,48,16,19,83,12,7,3,41,0,131,11
8480459,2021,21.66,19.98,14,7,166,50,51,267,36,15,14,151,495,24,46
8480466,2021,0.04,0.04,0,0,1,1,0,2,0,0,0,1,0,1,0
8480467,2021,0.24,0.24,1,1,9,0,5,14,2,0,2,9,0,7,2
8480727,2021,4.18,4.1,8,3,94,40,54,188,19,8,7,86,0,98,13
8480748,2021,0.84,0.89,0,1,9,1,4,14,2,1,0,8,1,12,4
8480762,2021,12.51,12.28,10,7,104,32,51,187,27,10,5,94,2,95,30
8480776,2021,0.13,0.12,0,0,2,0,0,2,0,0,0,2,0,0,0
8480789,2021,16.1,15.8,6,5,157,58,61,276,24,13,10,144,6,101,19
8480796,2021,4.41,4.34,6,3,96,30,55,181,17,8,5,88,0,251,14
8480797,2021,14.19,13.78,10,7,119,35,54,208,34,17,5,102,41,73,25
8480798,2021,7.36,7.08,11,4,86,19,37,142,21,6,4,80,51,31,24
8480800,2021,6.36,6.14,31,29,150,52,140,342,68,8,12,142,0,19,41
8480801,2021,33.46,31.85,29,8,288,85,88,461,67,30,23,258,218,270,41
8480802,2021,8.39,7.97,8,4,82,29,32,143,21,9,5,73,248,28,39
8480803,2021,8.14,7.87,12,19,205,73,122,400,43,12,17,193,0,80,37
8480806,2021,11.7,11.38,8,5,84,33,28,145,29,16,6,68,391,38,22
8480807,2021,2.27,2.27,5,5,44,13,26,83,10,0,3,44,0,100,8
8480813,2021,6.95,6.86,4,3,73,24,28,125,15,8,4,65,222,123,19
8480814,2021,0.11,0.11,0,0,1,0,0,1,0,0,0,1,0,0,0
8480817,2021,5.11,5.01,7,6,102,38,81,221,20,7,5,95,0,151,59
8480821,2021,15.43,14.93,5,9,154,53,77,284,24,10,12,144,5,57,24
8480822,2021,0.06,0.05,0,0,1,1,2,4,0,0,0,1,0,6,1
8480823,2021,0,0,0,0,0,0,1,1,0,0,0,0,0,1,0
8480829,2021,9.22,9.12,7,10,81,30,35,146,29,12,7,69,176,74,25
8480830,2021,31.74,30.89,24,15,249,114,104,467,69,30,29,219,0,189,44
8480831,2021,0.6,0.62,0,0,18,6,17,41,1,1,0,17,0,21,8
8480835,2021,0.84,0.8,0,0,6,0,2,8,2,2,1,4,12,4,2
8480839,2021,7.68,7.48,21,19,170,53,98,321,53,13,6,157,0,121,27
8480842,2021,0,0,0,0,0,0,0,0,0,0,0,0,0,0,0
8480844,2021,0.27,0.25,0,0,3,0,0,3,0,0,0,3,0,1,0
8480845,2021,5.26,5.22,4,4,51,34,14,99,13,5,5,46,129,68,10
8480846,2021,0.85,0.8,0,0,9,5,6,20,0,0,0,9,2,9,4
8480847,2021,0.88,0.84,4,1,36,8,41,85,6,1,1,35,0,12,13
8480848,2021,0.02,0.02,0,0,1,1,0,2,0,0,0,1,1,3,0
8480849,2021,10.91,10.31,7,7,82,34,34,150,24,10,8,72,415,84,18
8480853,2021,0.07,0.06,0,0,1,0,0,1,0,0,0,1,0,1,0
8480855,2021,1.85,1.64,0,1,13,8,3,24,3,2,6,11,35,33,2
8480858,2021,0.03,0.03,0,0,2,0,0,2,0,0,1,2,2,0,0
8480860,2021,0.46,0.42,2,1,16,6,8,30,4,1,1,15,0,28,4
8480863,2021,1.27,1.3,0,0,14,2,5,21,1,1,1,13,1,24,1
8480865,2021,8.91,8.29,21,17,190,79,132,401,51,13,14,177,0,78,27
8480870,2021,2.19,2.17,1,1,17,4,10,31,3,1,2,16,38,19,4
8480871,2021,4.9,4.75,4,7,64,27,39,130,22,11,4,53,0,26,11
8480873,2021,3.09,2.96,5,6,46,30,46,122,16,5,3,41,0,88,18
8480878,2021,0.76,0.78,1,2,32,11,16,59,4,1,2,31,0,15,3
8480879,2021,0.27,0.28,1,0,6,3,3,12,1,0,1,6,0,4,2
8480883,2021,3.69,3.59,5,10,77,38,72,187,20,5,2,72,0,45,13
8480884,2021,0.63,0.61,1,1,17,7,12,36,4,2,1,15,0,12,0
8480887,2021,0.36,0.36,0,0,9,2,4,15,1,1,2,8,0,10,3
8480890,2021,1.84,1.78,0,1,22,7,6,35,3,2,4,20,8,25,1
8480901,2021,7.34,7.07,2,5,68,24,24,116,10,3,4,65,0,71,12
8480913,2021,0,0,0,0,0,0,0,0,0,0,0,0,0,1,0
8480945,2021,0.31,0.31,0,1,7,1,6,14,1,0,0,7,0,13,0
8480950,2021,1.91,1.84,5,8,54,21,29,104,15,2,0,52,0,187,15
8480979,2021,1.72,1.61,1,1,14,4,4,22,4,2,2,12,38,26,1
8480980,2021,3.54,3.57,3,1,44,15,22,81,6,2,3,42,62,48,9
8480988,2021,1.47,1.34,1,0,10,3,5,18,2,1,0,9,7,4,3
8480990,2021,0.07,0.08,0,0,4,0,5,9,0,0,0,4,0,1,1
8481003,2021,0,0,0,0,0,0,1,1,0,0,0,0,0,5,0
8481004,2021,1.14,1.12,1,0,13,3,7,23,1,0,2,13,29,12,4
8481014,2021,3.32,3.24,2,8,107,41,96,244,13,3,1,104,0,227,24
8481019,2021,0,0,0,0,0,0,0,0,0,0,0,0,0,0,1
8481032,2021,0.89,0.86,0,0,11,3,3,17,2,2,0,9,0,17,1
8481058,2021,1.18,1.04,3,0,16,5,6,27,5,2,5,14,0,5,2
8481059,2021,0.44,0.45,3,3,14,3,8,25,6,0,0,14,0,5,6
8481061,2021,5.18,4.9,4,2,45,19,18,82,11,5,5,40,173,52,18
8481068,2021,19.11,18.36,13,9,168,70,56,294,46,24,11,144,89,30,48
8481077,2021,1.02,0.94,1,0,25,7,4,36,2,1,1,24,1,13,1
8481093,2021,0.55,0.54,0,0,6,0,1,7,1,1,1,5,0,12,2
8481102,2021,0.96,0.91,0,0,8,3,3,14,0,0,2,8,0,13,1
8481122,2021,1.62,1.58,1,3,45,19,23,87,5,1,2,44,0,168,7
8481133,2021,0.03,0.03,0,0,1,0,0,1,0,0,0,1,0,2,0
8481147,2021,1.71,1.72,1,3,22,10,10,42,5,1,1,21,79,112,11
8481161,2021,0.25,0.25,0,0,4,4,3,11,1,1,0,3,0,9,0
8481167,2021,0.05,0.05,0,0,1,1,1,3,0,0,0,1,0,2,1
8481178,2021,0.23,0.2,0,0,4,2,5,11,0,0,0,4,0,5,3
8481186,2021,12.23,12.02,12,4,127,29,46,202,24,8,10,119,5,100,38
8481239,2021,0.54,0.48,0,0,5,1,5,11,0,0,0,5,0,2,2
8481433,2021,1.89,1.89,2,1,10,4,5,19,4,1,0,9,1,9,3
8481441,2021,3.16,3.21,2,1,21,6,8,35,7,4,3,17,0,2,7
8481461,2021,1.41,1.35,3,1,30,17,18,65,6,2,2,28,0,15,6
8481477,2021,10.87,10.69,6,5,101,28,21,150,20,9,6,92,312,99,10
8481481,2021,9.7,9.2,8,6,91,31,19,141,24,10,10,81,313,74,31
8481489,2021,0.03,0.03,0,0,1,0,0,1,0,0,0,1,0,3,0
8481517,2021,2.99,2.99,2,1,45,9,13,67,6,3,1,42,3,16,9
8481518,2021,1.51,1.37,1,0,10,2,3,15,4,3,1,7,0,8,1
8481521,2021,1.05,0.97,2,0,16,12,17,45,4,2,2,14,0,24,6
8481522,2021,4.86,4.78,11,4,56,23,20,99,22,7,1,49,61,25,15
8481523,2021,12.75,12.45,9,8,116,41,41,198,26,9,8,107,179,49,42
8481524,2021,2.72,2.65,6,6,49,23,30,102,17,5,4,44,0,53,14
8481527,2021,0.01,0.01,0,0,0,1,0,1,0,0,1,0,0,0,0
8481528,2021,16.17,15.77,14,11,160,50,55,265,38,13,13,147,383,35,33
8481530,2021,0.14,0.14,0,0,1,0,0,1,0,0,0,1,0,0,0
8481532,2021,1.2,1.11,0,0,13,3,3,19,0,0,3,13,12,8,3
8481533,2021,16.67,16.32,21,17,181,70,82,333,61,23,15,158,217,56,40
8481535,2021,14.08,13.46,3,5,132,32,26,190,18,10,15,122,0,41,25
8481537,2021,0.17,0.15,0,1,5,2,6,13,2,1,0,4,0,16,1
8481540,2021,15.75,15.47,12,8,188,71,68,327,43,23,14,165,5,18,32
8481542,2021,8.96,8.45,20,23,187,59,109,355,50,7,15,180,0,151,41
8481546,2021,1.27,1.25,5,2,33,13,26,72,10,3,4,30,0,20,5
8481550,2021,0.05,0.05,0,1,4,0,2,6,1,0,1,4,0,1,1
8481552,2021,0.12,0.11,0,0,2,1,0,3,0,0,0,2,0,1,0
8481553,2021,2.14,2.11,2,2,18,8,5,31,4,0,2,18,3,15,1
8481554,2021,8.45,8.33,6,5,62,24,27,113,18,7,13,55,1,8,12
8481555,2021,0.07,0.06,0,1,2,0,1,3,1,0,0,2,0,4,0
8481557,2021,8.49,8.39,14,10,113,34,50,197,39,15,3,98,9,23,27
8481559,2021,18.2,17.71,21,9,165,58,73,296,56,26,11,139,122,6,49
8481560,2021,16.02,15.41,11,2,194,65,51,310,27,14,23,180,0,31,20
8481568,2021,0.35,0.34,1,0,12,6,3,21,2,1,3,11,0,15,5
8481572,2021,1.04,1.04,2,3,25,8,11,44,5,0,2,25,0,9,5
8481575,2021,0.52,0.52,2,3,18,3,18,39,5,0,1,18,0,23,5
8481577,2021,14.1,13.8,16,5,111,50,28,189,32,11,12,100,21,49,17
8481580,2021,11.5,11.34,7,2,106,31,27,164,18,9,16,97,148,46,15
8481581,2021,2.12,2.09,2,1,36,24,25,85,4,1,1,35,0,30,9
8481582,2021,0.65,0.65,0,0,14,3,4,21,1,1,3,13,0,10,3
8481596,2021,0.95,0.94,1,0,5,6,4,15,1,0,0,5,17,0,2
8481598,2021,1.06,1.04,0,2,29,12,19,60,3,1,3,28,0,10,5
8481599,2021,0.5,0.5,0,0,14,5,12,31,0,0,0,14,0,14,1
8481600,2021,2.58,2.53,3,5,53,22,35,110,8,0,2,53,0,61,10
8481604,2021,0.31,0.35,0,0,1,0,1,2,0,0,0,1,0,0,2
8481606,2021,1.41,1.36,3,3,41,19,39,99,8,2,4,39,0,32,3
8481609,2021,0.91,0.87,2,0,24,10,20,54,3,1,1,23,0,39,12
8481617,2021,11.14,10.73,9,3,115,42,34,191,26,14,5,101,8,84,32
8481618,2021,10.86,10.75,11,9,113,30,60,203,33,13,6,100,136,40,20
8481624,2021,17.15,16.93,8,3,147,32,26,205,32,21,8,126,0,52,24
8481626,2021,1.9,1.87,2,0,23,5,9,37,4,2,2,21,51,14,5
8481641,2021,5.78,5.47,2,4,59,19,20,98,7,1,6,58,0,97,7
8481655,2021,0.38,0.39,0,0,3,3,4,10,0,0,0,3,15,5,1
8481656,2021,4.35,4.15,4,2,34,10,17,61,9,3,6,31,56,20,8
8481657,2021,0.15,0.16,0,0,3,0,0,3,0,0,0,3,0,0,0
8481701,2021,0.13,0.13,1,1,3,3,1,7,2,0,0,3,0,5,1
8481703,2021,0.17,0.17,0,1,1,1,1,3,1,0,0,1,0,1,0
8481708,2021,0.4,0.38,0,2,8,6,3,17,2,0,2,8,0,4,15
8481711,2021,1.81,1.73,1,4,21,7,14,42,6,1,1,20,2,12,10
8481720,2021,1.52,1.51,0,0,8,3,1,12,1,1,1,7,2,7,0
8481740,2021,0.27,0.28,0,0,3,1,1,5,0,0,0,3,1,2,2
8481815,2021,0.05,0.05,0,0,2,0,1,3,0,0,0,2,0,0,0
8481827,2021,0.18,0.17,0,0,2,1,1,4,0,0,0,2,0,7,0
8481849,2021,0.04,0.04,0,0,1,1,4,6,0,0,0,1,0,12,0
8482055,2021,3.77,3.71,1,1,40,14,8,62,5,3,3,37,18,12,9
8482061,2021,0.03,0.03,0,0,0,1,1,2,0,0,0,0,0,1,0
8482062,2021,0.26,0.25,0,0,3,1,2,6,0,0,0,3,0,21,3
8482067,2021,0.25,0.28,0,1,4,3,1,8,1,0,0,4,0,4,1
8482070,2021,0.17,0.17,0,0,1,1,0,2,0,0,0,1,0,7,0
8482072,2021,0.22,0.2,0,0,5,3,6,14,1,1,0,4,0,8,1
8482073,2021,1.08,1.1,3,6,25,17,23,65,11,2,1,23,0,60,7
8482078,2021,21.34,20.53,15,19,184,40,63,287,57,23,17,161,12,62,26
8482079,2021,0.69,0.68,0,0,5,2,0,7,0,0,1,5,7,1,1
8482089,2021,0.74,0.77,1,0,8,2,1,11,2,1,0,7,1,10,0
8482093,2021,14.4,14.12,12,11,110,57,36,203,40,17,16,93,11,69,15
8482097,2021,0.31,0.31,0,1,6,0,3,9,2,1,0,5,0,0,1
8482109,2021,11.4,10.83,6,6,110,43,40,193,31,19,4,91,14,108,44
8482110,2021,17.87,17.35,21,4,154,39,54,247,42,17,9,137,209,26,56
8482111,2021,0.51,0.51,0,1,13,2,3,18,2,1,1,12,0,5,2
8482113,2021,15.84,15.37,14,12,125,46,52,223,44,18,9,107,334,26,59
8482116,2021,25.97,25.06,22,14,177,64,73,314,58,22,16,155,180,125,38
8482117,2021,1.39,1.32,0,1,15,4,4,23,1,0,0,15,16,0,6
8482124,2021,5.56,5.31,4,1,40,23,14,77,10,5,3,35,124,20,15
8482125,2021,0.94,0.92,1,1,12,5,6,23,2,0,0,12,0,5,5
8482133,2021,1.38,1.37,4,1,13,8,4,25,5,0,1,13,40,3,9
8482142,2021,6.97,6.64,15,13,137,65,88,290,32,4,13,133,0,40,19
8482148,2021,0.71,0.69,0,0,7,0,2,9,1,1,0,6,6,1,3
8482149,2021,2.88,2.87,5,0,21,13,14,48,7,2,1,19,0,17,7
8482150,2021,0.21,0.21,0,0,0,2,0,2,0,0,0,0,0,0,0
8482175,2021,0.18,0.18,0,0,3,1,2,6,0,0,0,3,0,1,2
8482192,2021,0.07,0.07,0,0,4,1,1,6,0,0,1,4,0,3,2
8482197,2021,0.76,0.62,0,0,2,4,1,7,0,0,0,2,0,15,0
8482222,2021,11.44,10.98,16,13,103,33,30,166,39,10,8,93,0,53,40
8482241,2021,1.77,1.72,3,1,9,10,5,24,6,2,0,7,4,23,6
8482243,2021,0.01,0.01,0,0,1,0,0,1,0,0,0,1,0,0,1
8482245,2021,3.79,3.62,6,10,92,35,67,194,22,6,8,86,0,155,14
8482408,2021,0,0,0,0,0,0,0,0,0,0,0,0,0,3,0
8482475,2021,7.4,7.26,5,2,98,45,46,189,14,7,11,91,0,50,19
8482624,2021,0.56,0.55,0,1,15,6,11,32,1,0,1,15,0,5,1
8482634,2021,0.36,0.36,0,1,2,2,1,5,1,0,0,2,0,1,3
8482635,2021,1.65,1.64,1,1,12,7,6,25,2,0,1,12,1,60,5
8482641,2021,0.48,0.48,1,0,11,3,5,19,2,1,0,10,0,10,3
8482652,2021,0,0,0,0,0,0,1,1,0,0,0,0,0,0,0
8482654,2021,0.55,0.55,0,0,8,3,2,13,1,1,0,7,20,4,2
8482655,2021,2.89,2.58,6,5,40,25,34,99,15,4,4,36,0,32,10
8482660,2021,1.15,1.08,1,2,5,8,7,20,3,0,0,5,0,4,2
8482665,2021,2.5,2.28,4,2,18,8,10,36,9,3,1,15,39,7,6
8482667,2021,1.53,1.35,1,3,8,3,4,15,4,0,2,8,3,4,2
8482671,2021,0.54,0.5,1,0,10,1,6,17,3,2,0,8,0,1,6
8482705,2021,15.92,15.43,9,6,148,53,53,254,31,16,9,132,362,98,24
8482745,2021,1.65,1.54,0,1,12,3,1,16,3,2,0,10,0,8,2
8482815,2021,0.07,0.07,0,0,1,2,1,4,0,0,0,1,1,4,0
8482834,2021,1.05,1.08,0,0,10,1,3,14,1,1,0,9,0,8,0
8483397,2021,1.34,1.36,0,0,12,4,3,19,3,3,1,9,5,15,2
8483565,2021,0.37,0.36,0,2,13,2,9,24,3,1,0,12,0,19,1
8483570,2021,0.98,0.93,0,0,8,3,1,12,1,1,1,7,11,1,1
8465009,2020,1.97,1.92,4,4,67,30,51,148,10,2,5,65,0,88,14
8466138,2020,4.17,4.04,8,7,42,14,10,66,20,5,5,37,39,32,13
8466139,2020,7.54,7.36,2,3,54,28,15,97,9,4,6,50,141,40,22
8469455,2020,8.49,8.23,15,5,81,31,26,138,30,10,11,71,276,26,15
8469459,2020,0.19,0.18,1,0,3,1,3,7,2,1,0,2,32,10,3
8470047,2020,3.43,3.4,4,5,25,9,7,41,15,6,2,19,109,9,7
8470144,2020,2.5,2.42,3,2,24,10,3,37,6,1,4,23,20,23,7
8470281,2020,4.1,3.97,7,4,110,24,64,198,15,4,6,106,0,32,27
8470595,2020,10.09,9.21,4,4,82,29,34,145,13,5,9,77,268,23,17
8470600,2020,3.61,3.52,9,6,87,40,74,201,19,4,5,83,0,38,9
8470601,2020,1.17,1.13,1,1,18,9,11,38,2,0,2,18,0,27,4
8470604,2020,12.65,12.36,8,5,154,35,37,226,30,17,22,137,153,41,20
8470606,2020,14.94,14.44,10,5,128,39,39,206,31,16,8,112,2,85,11
8470610,2020,9.56,9.07,7,5,90,23,8,121,19,7,7,83,34,18,12
8470612,2020,7.62,7.5,6,6,70,30,33,133,17,5,4,65,350,66,24
8470613,2020,8.97,8.79,14,8,138,56,100,294,29,7,20,131,0,31,36
8470621,2020,7.87,7.72,8,4,62,26,21,109,21,9,7,53,0,56,15
8470626,2020,0.24,0.23,1,0,5,0,2,7,1,0,0,5,1,1,6
8470638,2020,19.52,18.94,11,14,182,74,42,298,48,23,5,159,714,49,35
8470642,2020,4.38,4.28,6,7,104,42,69,215,19,6,4,98,0,70,11
8470655,2020,2.81,2.79,0,1,30,9,10,49,4,3,3,27,81,31,5
8470755,2020,1.36,1.34,3,0,18,5,4,27,4,1,0,17,77,14,4
8470775,2020,2,1.99,2,1,20,9,9,38,5,2,0,18,142,60,8
8470794,2020,18.1,17.33,14,12,139,72,31,242,51,25,12,114,364,64,17
8470966,2020,5.5,5.09,6,11,142,70,94,306,26,9,6,133,0,51,21
8471214,2020,17.8,17.45,11,7,182,83,86,351,42,24,12,158,0,98,11
8471215,2020,5.68,5.58,8,12,72,20,34,126,28,8,2,64,152,18,26
8471218,2020,12.87,12.59,20,11,113,31,25,169,46,15,5,98,3,63,25
8471228,2020,2.9,2.88,6,2,25,9,11,45,12,4,1,21,0,4,3
8471233,2020,5.23,5.07,5,7,50,20,23,93,20,8,3,42,311,51,25
8471260,2020,7.17,7.08,6,4,76,23,35,134,14,4,9,72,53,106,21
8471262,2020,7.99,7.73,6,4,61,14,12,87,17,7,3,54,202,66,10
8471274,2020,3.04,2.93,7,12,72,21,62,155,22,3,6,69,0,76,14
8471276,2020,8.17,7.88,24,12,83,29,29,141,44,8,8,75,321,25,21
8471284,2020,1.27,1.23,1,1,33,12,31,76,5,3,3,30,0,47,8
8471303,2020,2.34,2.3,5,3,99,33,45,177,8,0,8,99,0,80,13
8471669,2020,14.12,13.2,10,6,101,32,24,157,29,13,12,88,323,38,20
8471675,2020,20.07,19.56,20,18,159,49,43,251,62,24,16,135,672,44,51
8471676,2020,5.78,5.35,6,1,73,21,24,118,14,7,4,66,5,31,10
8471677,2020,0.33,0.32,0,0,13,5,6,24,1,1,1,12,0,30,2
8471685,2020,11.07,10.7,24,13,118,44,54,216,50,13,13,105,661,45,12
8471686,2020,3.09,2.89,4,3,53,19,27,99,10,3,5,50,0,58,9
8471698,2020,14.64,14.16,13,8,106,30,34,170,43,22,7,84,139,70,28
8471699,2020,7.86,7.5,4,2,88,31,37,156,11,5,4,83,4,79,12
8471707,2020,4.04,3.86,3,2,51,15,22,88,10,5,2,46,2,26,8
8471709,2020,1.61,1.53,2,3,37,25,25,87,6,1,4,36,0,40,10
8471724,2020,4.76,4.7,26,12,131,47,82,260,45,7,12,124,0,92,23
8471729,2020,1.99,1.94,4,5,41,14,33,88,9,0,3,41,0,41,8
8471735,2020,4.29,4.15,16,8,113,30,74,217,27,3,9,110,0,18,14
8471769,2020,1.01,0.96,4,1,29,19,19,67,5,0,4,29,0,15,10
8471794,2020,6.65,6.33,2,3,83,14,33,130,8,3,5,80,6,39,13
8471804,2020,0.72,0.74,1,1,9,4,1,14,3,1,1,8,7,8,2
8471817,2020,3.83,3.53,1,3,26,10,18,54,5,1,5,25,4,141,11
8471873,2020,1.68,1.66,2,4,37,18,25,80,9,3,3,34,0,36,12
8471887,2020,17.01,16.16,8,10,145,35,19,199,32,14,12,131,2,77,17
8472382,2020,2,1.99,2,2,50,28,47,125,5,1,3,49,0,41,6
8473415,2020,0.16,0.15,2,1,4,5,9,18,3,0,0,4,0,22,0
8473419,2020,18.65,17.83,26,14,143,39,46,228,69,29,7,114,11,66,42
8473422,2020,8.99,8.42,8,5,81,25,15,121,20,7,4,74,117,133,13
8473446,2020,0.14,0.14,1,0,5,0,3,8,1,0,0,5,0,7,1
8473449,2020,4.25,3.99,6,5,45,14,10,69,13,2,4,43,26,29,10
8473453,2020,5.72,5.73,2,3,68,25,19,112,10,5,3,63,11,71,8
8473463,2020,2.48,2.48,4,3,27,6,8,41,8,1,1,26,26,83,10
8473473,2020,8.49,8.03,6,7,74,20,20,114,23,10,4,64,9,139,19
8473504,2020,7.2,6.99,6,1,50,23,20,93,11,4,0,46,0,191,18
8473507,2020,7.25,7.05,13,17,128,43,88,259,42,12,7,116,0,97,10
8473512,2020,12.58,12.08,13,12,121,56,35,212,42,17,8,104,484,32,19
8473533,2020,17.2,16.65,10,12,103,41,24,168,38,16,9,87,630,135,15
8473544,2020,7.23,6.94,5,6,67,34,29,130,19,8,5,59,229,80,17
8473548,2020,10.42,10.13,9,14,115,29,62,206,43,20,9,95,1,8,19
8473563,2020,9.37,9.08,16,22,91,35,35,161,53,15,8,76,353,25,33
8473564,2020,0.83,0.79,0,0,14,3,8,25,0,0,0,14,6,9,2
8473573,2020,3.99,3.68,4,3,30,14,12,56,9,2,1,28,36,9,4
8473618,2020,8.68,8.32,8,2,57,22,28,107,19,9,3,48,5,84,15
8473986,2020,14.14,14.1,11,7,122,43,39,204,33,15,6,107,1,59,14
8473994,2020,12.67,12.43,14,10,124,41,44,209,35,11,9,113,266,73,18
8474000,2020,1.01,1,2,1,28,12,9,49,5,2,1,26,0,20,6
8474009,2020,7.46,7.32,8,9,66,21,16,103,27,10,6,56,365,11,22
8474013,2020,1.23,1.12,3,4,30,13,14,57,8,1,7,29,0,38,10
8474027,2020,2.15,2.04,1,4,59,23,37,119,6,1,6,58,0,78,7
8474031,2020,4.17,4.08,6,7,93,32,62,187,15,2,5,91,0,57,14
8474034,2020,5.88,5.83,6,9,46,12,10,68,19,4,5,42,2,75,6
8474037,2020,16.69,16.04,11,15,132,37,28,197,43,17,5,115,9,40,20
8474038,2020,4.92,4.84,8,3,44,19,18,81,16,5,3,39,11,116,13
8474040,2020,9.45,8.91,5,3,89,24,19,132,15,7,7,82,81,5,7
8474053,2020,13.37,12.78,6,8,114,40,42,196,31,17,10,97,446,58,27
8474056,2020,4.1,3.94,9,5,99,39,57,195,19,5,5,94,0,41,12
8474062,2020,2.86,2.82,4,1,40,11,7,58,7,2,3,38,162,33,9
8474066,2020,0.12,0.12,1,1,2,2,2,6,2,0,1,2,0,10,0
8474068,2020,2.81,2.72,3,0,27,10,14,51,5,2,2,25,97,16,8
8474090,2020,2.69,2.68,3,2,58,20,36,114,10,5,2,53,0,84,7
8474091,2020,7.6,7.43,2,1,65,20,9,94,12,9,3,56,276,18,23
8474098,2020,4.89,4.86,3,2,53,9,14,76,10,5,2,48,5,64,9
8474102,2020,11.57,11.12,20,19,152,51,86,289,58,19,9,133,0,45,17
8474125,2020,0.51,0.48,0,2,6,4,7,17,2,0,1,6,0,9,1
8474134,2020,0.05,0.05,0,0,1,0,2,3,0,0,0,1,0,4,0
8474141,2020,12.92,12.69,33,18,187,49,83,319,66,15,10,172,2,12,32
8474145,2020,1.29,1.25,1,3,31,10,29,70,5,1,0,30,0,85,7
8474149,2020,10.3,9.72,5,2,89,43,31,163,20,13,6,76,0,38,17
8474150,2020,12.54,12.26,9,14,144,47,53,244,32,9,10,135,387,43,48
8474151,2020,4.42,4.4,5,3,86,28,46,160,12,4,3,82,0,69,10
8474157,2020,16.35,15.86,15,12,174,57,54,285,51,24,12,150,20,33,15
8474161,2020,9.04,8.77,18,16,104,38,53,195,43,9,9,95,7,17,19
8474162,2020,3.82,3.75,9,14,103,30,59,192,27,4,5,99,0,101,24
8474166,2020,6.37,6.16,9,13,85,37,61,183,31,9,6,76,0,44,12
8474176,2020,9.1,8.99,8,2,85,17,27,129,16,6,5,79,3,22,21
8474189,2020,9.54,9.31,6,9,69,38,27,134,23,8,6,61,333,36,19
8474190,2020,7.14,6.71,0,2,62,21,22,105,9,7,4,55,6,64,13
8474207,2020,1.47,1.44,2,0,23,9,14,46,2,0,1,23,0,28,3
8474218,2020,1.58,1.53,2,2,44,19,31,94,4,0,5,44,0,69,10
8474230,2020,0,0,0,0,0,0,1,1,0,0,0,0,0,10,0
8474291,2020,3.74,3.59,3,1,21,11,6,38,5,1,1,20,173,34,11
8474563,2020,5.48,5.28,11,14,101,49,84,234,33,8,9,93,0,91,8
8474564,2020,11.96,11.6,8,9,91,29,31,151,34,17,3,74,236,38,5
8474565,2020,5.71,5.65,7,9,126,57,95,278,23,7,7,119,0,28,23
8474567,2020,1.67,1.68,2,2,36,23,26,85,4,0,2,36,0,67,7
8474568,2020,1.68,1.64,2,0,42,22,25,89,4,2,5,40,0,99,6
8474573,2020,6.51,6.45,15,12,77,21,24,122,35,8,4,69,14,13,19
8474574,2020,3.99,3.85,10,4,109,22,57,188,20,6,6,103,0,61,22
8474578,2020,5.3,5.07,7,7,110,49,80,239,22,8,8,102,0,20,39
8474579,2020,0.07,0.06,0,0,0,1,1,2,0,0,0,0,0,3,0
8474581,2020,1.22,1.21,4,4,23,12,27,62,8,0,1,23,0,15,5
8474584,2020,3.66,3.56,3,6,77,17,32,126,13,4,6,73,0,125,9
8474586,2020,13.59,13.26,9,8,128,45,30,203,33,16,3,112,3,30,15
8474589,2020,3.67,3.58,3,3,38,14,7,59,9,3,2,35,6,43,10
8474590,2020,6.35,6.21,17,17,128,63,60,251,44,10,3,118,0,52,24
8474600,2020,7.48,7.26,12,13,141,60,87,288,33,8,8,133,0,27,15
8474602,2020,3.2,3.12,19,5,67,29,34,130,27,3,6,64,0,28,12
8474604,2020,0.07,0.07,0,0,1,1,0,2,0,0,0,1,0,2,0
8474610,2020,1.77,1.56,0,1,22,3,6,31,3,2,3,20,18,11,5
8474612,2020,2.21,2.13,3,4,79,22,50,151,10,3,4,76,0,48,10
8474613,2020,3.66,3.48,3,2,44,13,13,70,6,1,2,43,130,25,10
8474618,2020,1.97,1.97,1,5,55,9,49,113,9,3,5,52,0,60,19
8474628,2020,1.38,1.33,1,1,41,14,23,78,4,2,2,39,0,24,5
8474641,2020,7.82,6.63,6,3,77,25,27,129,21,12,7,65,303,40,11
8474673,2020,2.01,1.98,4,9,48,24,38,110,14,1,2,47,0,34,22
8474683,2020,6.11,6.01,4,5,66,31,25,122,15,6,2,60,288,65,9
8474685,2020,2.59,2.57,2,1,26,6,13,45,3,0,2,26,0,12,6
8474688,2020,0.67,0.67,1,2,13,8,8,29,3,0,2,13,0,17,3
8474697,2020,0.49,0.48,0,0,18,14,15,47,0,0,0,18,0,54,1
8474709,2020,6.75,6.71,4,1,68,14,11,93,11,6,4,62,3,181,11
8474715,2020,15.35,14.65,12,7,158,52,40,250,34,15,16,143,7,22,22
8474716,2020,7.19,6.48,7,11,94,44,54,192,25,7,6,87,0,52,17
8474736,2020,0.23,0.23,0,0,1,0,0,1,0,0,0,1,0,13,2
8474749,2020,0.02,0.02,0,0,2,0,0,2,0,0,0,2,0,1,0
8474818,2020,1.56,1.51,5,4,45,19,28,92,10,1,1,44,0,19,5
8474849,2020,3.77,3.72,3,0,28,13,8,49,4,1,1,27,2,63,9
8474870,2020,8.15,8.1,10,4,76,26,20,122,22,8,5,68,170,63,4
8474884,2020,9.35,8.8,9,10,114,25,47,186,36,17,5,97,6,29,21
8475098,2020,4.09,3.96,8,4,35,10,11,56,17,5,2,30,217,17,12
8475149,2020,4.93,4.88,5,3,46,20,19,85,14,6,4,40,32,12,10
8475151,2020,14.54,14.15,3,8,115,66,42,223,21,10,6,105,8,62,22
8475158,2020,13.13,13.01,14,16,129,32,24,185,54,24,17,105,703,24,43
8475160,2020,5.19,5.19,3,0,65,22,18,105,7,4,3,61,6,69,8
8475163,2020,10.05,9.58,3,4,65,20,14,99,16,9,5,56,2,40,13
8475164,2020,7.45,7.18,3,5,91,45,36,172,16,8,8,83,9,19,25
8475166,2020,23.22,21.88,18,13,163,59,56,278,50,19,13,144,470,51,32
8475167,2020,8.4,8.27,22,14,138,68,107,313,45,9,6,129,0,51,12
8475168,2020,8.75,8.38,5,2,72,30,23,125,13,6,6,66,161,30,13
8475169,2020,21.39,20.59,19,8,194,61,67,322,49,22,22,172,23,97,30
8475170,2020,15.76,14.87,15,5,113,39,27,179,36,16,7,97,318,119,24
8475171,2020,3.24,3.1,11,10,83,39,53,175,24,3,4,80,0,72,12
8475172,2020,17.23,16.69,16,5,170,55,64,289,32,11,17,159,392,36,22
8475176,2020,4.28,4.1,10,3,73,18,52,143,18,5,10,68,0,21,7
8475177,2020,1.8,1.69,4,5,58,27,47,132,10,1,7,57,0,96,15
8475178,2020,2.6,2.49,3,0,18,12,8,38,5,2,1,16,0,73,3
8475179,2020,1.69,1.67,1,3,51,20,39,110,4,0,0,51,0,93,8
8475181,2020,3.59,3.51,13,16,79,27,40,146,31,2,6,77,0,58,6
8475184,2020,17.43,16.5,7,3,102,43,32,177,30,20,6,82,30,115,17
8475186,2020,0.15,0.14,2,0,8,2,5,15,2,0,0,8,0,9,0
8475188,2020,1.87,1.87,1,5,39,25,44,108,8,2,2,37,0,98,8
8475191,2020,15.51,15.24,8,3,124,45,42,211,25,14,14,110,0,46,21
8475193,2020,10.18,9.93,12,8,82,23,36,141,30,10,8,72,12,63,16
8475197,2020,8.33,7.88,13,27,146,46,99,291,48,8,4,138,0,26,16
8475200,2020,4.1,3.96,6,8,83,35,46,164,22,8,1,75,0,87,30
8475204,2020,0.25,0.25,0,0,2,0,0,2,0,0,0,2,0,0,0
8475208,2020,2.08,2.08,3,7,50,19,35,104,14,4,4,46,0,63,24
8475209,2020,6.17,6.01,5,4,59,29,16,104,13,4,5,55,6,70,16
8475213,2020,0.18,0.18,0,0,3,0,1,4,0,0,0,3,3,2,1
8475218,2020,5.47,5.38,9,8,110,56,63,229,23,6,2,104,0,23,17
8475220,2020,5.4,5.28,7,8,40,16,6,62,26,11,2,29,2,109,15
8475222,2020,1.58,1.51,4,0,55,14,33,102,6,2,4,53,0,27,8
8475225,2020,11.4,11.19,9,10,132,55,49,236,32,13,10,119,10,66,24
8475231,2020,7.43,7.44,5,2,72,19,21,112,14,7,4,65,342,112,12
8475233,2020,3.78,3.3,0,5,69,23,32,124,6,1,1,68,0,132,7
8475235,2020,6.78,6.65,2,3,65,39,22,126,10,5,4,60,1,136,4
8475236,2020,3.68,3.67,2,2,39,12,8,59,7,3,2,36,272,33,16
8475246,2020,0.14,0.13,0,1,5,4,3,12,1,0,0,5,0,12,0
8475278,2020,0.1,0.1,0,0,2,1,0,3,1,1,0,1,12,8,2
8475279,2020,2.88,2.84,4,2,81,30,46,157,7,1,5,80,0,77,9
8475287,2020,12.8,12.53,8,4,86,37,21,144,21,9,5,77,269,63,18
8475314,2020,10.16,10,5,2,80,19,18,117,19,12,8,68,63,39,7
8475324,2020,1.68,1.67,6,6,60,16,31,107,14,2,3,58,0,56,15
8475343,2020,8.9,8.79,2,2,68,29,13,110,15,11,5,57,431,109,38
8475413,2020,2,1.94,3,1,27,13,15,55,5,1,2,26,43,17,6
8475455,2020,1.65,1.64,7,10,51,32,55,138,19,2,2,49,0,143,13
8475461,2020,0.42,0.46,1,0,3,0,2,5,1,0,0,3,16,6,0
8475462,2020,2.7,2.59,2,7,84,31,52,167,11,2,2,82,0,244,14
8475613,2020,0.66,0.67,1,0,5,1,3,9,2,1,1,4,0,3,0
8475625,2020,0.85,0.78,2,0,27,9,10,46,2,0,3,27,0,56,7
8475690,2020,2.08,2.05,2,7,66,21,35,122,11,2,2,64,0,33,23
8475692,2020,7.55,7.2,15,9,74,37,32,143,35,11,11,63,11,12,18
8475714,2020,8.99,8.76,7,8,91,23,19,133,28,13,3,78,42,30,19
8475718,2020,2.5,2.5,7,11,57,24,36,117,20,2,6,55,0,82,17
8475722,2020,7.46,7.32,6,3,67,28,24,119,18,9,5,58,3,69,18
8475726,2020,21.89,21.29,9,7,158,51,56,265,44,28,9,130,21,75,25
8475728,2020,6.6,6.42,2,4,58,27,21,106,14,8,4,50,296,77,22
8475729,2020,0.07,0.06,0,0,3,0,1,4,0,0,0,3,0,2,0
8475735,2020,0.28,0.31,0,0,4,0,0,4,1,1,0,3,20,7,1
8475744,2020,6.86,6.61,13,7,78,24,20,122,29,9,8,69,204,21,16
8475745,2020,6.76,6.67,5,5,79,28,20,127,16,6,5,73,244,57,28
8475747,2020,1.36,1.3,3,4,54,18,31,103,10,3,3,51,0,87,2
8475750,2020,1.56,1.56,4,1,41,21,29,91,5,0,1,41,0,34,7
8475752,2020,7.07,6.91,4,1,56,38,32,126,11,6,6,50,6,81,15
8475753,2020,5.52,5.48,6,12,117,32,74,223,25,7,6,110,0,127,24
8475754,2020,19.81,19.08,10,5,121,50,35,206,33,18,11,103,351,36,22
8475760,2020,7.71,7.33,7,4,78,22,17,117,17,6,8,72,127,48,12
8475762,2020,2.15,2.12,4,6,67,34,73,174,12,2,3,65,0,80,19
8475763,2020,13.51,13.32,13,6,126,51,48,225,31,12,11,114,234,60,22
8475764,2020,3.36,3.24,5,13,75,30,76,181,23,5,7,70,0,27,21
8475765,2020,4.96,4.63,7,3,65,16,30,111,14,4,3,61,0,30,10
8475766,2020,3.5,3.4,3,4,41,18,20,79,10,3,2,38,6,100,5
8475768,2020,6.29,6.23,6,6,71,25,28,124,20,8,4,63,7,40,18
8475772,2020,3.87,3.78,7,2,44,10,15,69,13,4,2,40,256,17,11
8475780,2020,4.26,4.25,0,3,57,15,14,86,5,2,0,55,41,75,14
8475784,2020,10.7,10.29,4,3,111,42,36,189,14,7,9,104,28,20,30
8475786,2020,18.58,17.34,6,11,115,36,32,183,32,15,15,100,18,69,17
8475790,2020,1.7,1.68,1,2,58,19,44,121,4,1,5,57,0,111,6
8475791,2020,12.22,12.01,12,11,136,49,51,236,33,10,10,126,7,34,19
8475792,2020,3.5,3.46,3,0,25,10,21,56,6,3,2,22,4,43,7
8475793,2020,9.29,9.06,7,7,67,20,18,105,21,7,5,60,424,43,13
8475794,2020,0.84,0.88,0,0,8,0,4,12,2,2,0,6,19,8,1
8475796,2020,3.14,2.98,1,0,51,13,17,81,4,3,6,48,0,36,6
8475797,2020,0.57,0.55,1,0,30,12,11,53,1,0,1,30,0,56,6
8475798,2020,11.88,11.27,9,5,75,32,25,132,27,13,8,62,244,46,23
8475799,2020,17.99,17.39,8,7,126,41,38,205,35,20,16,106,1,68,16
8475807,2020,4.82,4.57,1,5,46,22,13,81,7,1,2,45,5,92,10
8475808,2020,0.44,0.47,0,0,3,3,5,11,0,0,0,3,35,19,2
8475810,2020,20.85,20.38,10,10,154,65,39,258,42,22,9,132,3,62,30
8475820,2020,14.57,13.93,9,5,86,36,27,149,31,17,8,69,13,14,18
8475825,2020,2.39,2.08,2,0,54,26,42,122,4,2,5,52,1,215,3
8475834,2020,3.95,3.75,3,1,26,17,7,50,5,1,5,25,3,22,11
8475842,2020,1.72,1.77,2,2,23,4,8,35,6,2,0,21,33,29,2
8475844,2020,0,0,0,0,0,0,0,0,0,0,0,0,0,0,0
8475848,2020,12.57,12.42,3,6,106,37,34,177,23,14,4,92,23,46,7
8475855,2020,6.44,6.29,5,7,38,16,15,69,18,6,2,32,12,78,5
8475868,2020,0.42,0.41,1,2,12,5,8,25,4,1,0,11,0,21,2
8475869,2020,0.13,0.13,0,0,7,0,4,11,0,0,0,7,0,14,4
8475906,2020,4.87,4.71,13,16,108,47,76,231,36,7,9,101,0,49,17
8475913,2020,15.7,15.1,26,14,98,47,28,173,61,21,7,77,12,31,58
8475958,2020,0.28,0.27,0,2,4,0,1,5,2,0,0,4,10,1,4
8475968,2020,0.23,0.23,1,0,3,2,1,6,1,0,0,3,4,2,1
8476191,2020,1.32,1.31,0,3,27,19,20,66,4,1,1,26,0,64,6
8476278,2020,7.52,7.33,5,5,64,32,19,115,22,12,8,52,30,45,15
8476285,2020,0.52,0.51,1,0,3,2,2,7,1,0,0,3,0,9,1
8476288,2020,5,4.68,3,2,48,20,29,97,13,8,1,40,3,44,8
8476292,2020,15.57,15.29,16,15,109,37,42,188,46,15,11,94,0,82,26
8476300,2020,1.32,1.27,2,2,33,29,29,91,4,0,2,33,0,41,7
8476312,2020,0.65,0.66,4,2,19,7,21,47,7,1,2,18,0,61,5
8476323,2020,0.43,0.44,0,1,5,0,2,7,3,2,0,3,1,16,1
8476326,2020,10.02,9.82,4,2,62,24,17,103,13,7,4,55,4,192,14
8476329,2020,3.58,3.53,2,3,23,15,11,49,10,5,0,18,75,18,8
8476331,2020,1.84,1.75,5,4,44,19,26,89,9,0,3,44,0,76,9
8476344,2020,2.27,2.21,1,0,17,5,4,26,4,3,1,14,42,13,6
8476346,2020,14.38,13.36,22,7,112,44,41,197,48,19,4,93,0,8,23
8476356,2020,5.35,5.19,1,1,63,14,10,87,7,5,2,58,1,21,18
8476368,2020,0.07,0.08,0,0,4,2,1,7,0,0,0,4,0,10,0
8476374,2020,6.59,6.6,3,2,88,22,23,133,9,4,2,84,230,99,24
8476381,2020,1.47,1.45,2,0,24,5,9,38,4,2,0,22,30,20,3
8476389,2020,14.93,14.03,14,12,123,44,22,189,43,17,12,106,430,107,17
8476390,2020,0.03,0.03,1,0,3,0,0,3,1,0,0,3,0,10,0
8476392,2020,10.11,9.85,7,7,81,28,29,138,24,10,4,71,358,161,16
8476393,2020,5.18,5.01,6,7,61,17,19,97,18,5,4,56,19,48,8
8476396,2020,0.64,0.6,2,0,5,3,0,8,3,1,1,4,7,4,5
8476399,2020,13.76,13.71,7,10,121,32,28,181,31,14,8,107,2,109,25
8476404,2020,0.06,0.06,0,0,2,2,0,4,0,0,0,2,15,14,1
8476407,2020,0.62,0.61,0,0,16,9,10,35,0,0,2,16,0,14,2
8476410,2020,5.22,5.11,1,2,50,26,18,94,9,6,5,44,3,33,16
8476415,2020,1.58,1.42,1,1,15,4,6,25,2,0,2,15,0,23,4
8476419,2020,10.82,10.19,8,6,81,29,20,130,28,14,4,67,472,111,17
8476422,2020,2.69,2.63,8,19,98,36,35,169,27,0,11,98,0,70,16
8476428,2020,6.09,5.86,3,0,62,32,18,112,13,10,4,52,0,20,17
8476429,2020,2.61,2.54,7,6,79,26,61,166,15,2,6,77,0,76,6
8476430,2020,0.63,0.69,1,0,11,3,4,18,1,0,1,11,0,4,0
8476432,2020,8.14,7.84,5,3,79,31,21,131,16,8,6,71,301,76,14
8476437,2020,6.42,6.36,7,6,53,16,34,103,23,10,1,43,218,21,20
8476438,2020,8.62,8.39,2,7,68,31,30,129,24,15,4,53,27,16,8
8476439,2020,5.08,5.03,3,1,36,27,14,77,8,4,1,32,3,97,6
8476441,2020,4.06,3.95,4,6,77,42,61,180,13,3,3,74,0,98,6
8476442,2020,4.66,4.65,2,0,45,7,5,57,7,5,2,40,4,25,7
8476443,2020,0.33,0.32,0,0,5,3,2,10,0,0,0,5,0,17,0
8476448,2020,14.78,14.22,14,11,111,35,52,198,39,14,10,97,519,29,30
8476449,2020,0.2,0.2,2,0,8,3,5,16,3,1,0,7,0,9,0
8476454,2020,17.16,16.57,10,9,135,55,53,243,35,16,12,119,73,26,22
8476455,2020,20.41,19.63,12,20,155,64,52,271,52,20,20,135,287,81,16
8476456,2020,13.54,12.93,22,19,123,31,37,191,61,20,9,103,17,51,37
8476457,2020,2.69,2.46,2,4,52,40,38,130,10,4,4,48,1,166,12
8476458,2020,13.34,13.03,19,16,129,35,47,211,49,14,14,115,322,22,22
8476459,2020,20.24,19.67,17,9,171,79,66,316,50,24,8,147,479,75,39
8476460,2020,16.07,15.56,20,22,126,37,42,205,63,21,11,105,353,31,48
8476461,2020,13.87,13.42,12,10,121,40,46,207,41,19,11,102,428,34,21
8476462,2020,7.84,7.63,16,15,180,73,109,362,41,10,12,170,0,52,19
8476463,2020,4.82,4.78,7,7,80,24,62,166,23,9,4,71,0,35,14
8476467,2020,4.37,4.33,3,5,84,25,36,145,14,6,7,78,0,148,17
8476468,2020,13.57,12.91,19,12,106,53,39,198,46,15,9,91,279,90,29
8476469,2020,6.33,6.22,5,2,73,20,30,123,14,7,2,66,7,86,18
8476470,2020,0.6,0.57,0,1,26,9,17,52,1,0,1,26,0,39,3
8476473,2020,2.25,2.17,5,7,80,21,61,162,15,3,0,77,0,98,11
8476474,2020,0.24,0.25,0,0,5,0,0,5,0,0,1,5,1,4,1
8476479,2020,7.97,7.89,15,4,73,32,35,140,24,5,5,68,475,76,14
8476480,2020,12.68,12.44,3,6,86,23,15,124,17,8,6,78,137,71,13
8476483,2020,14.89,14.31,15,4,144,60,61,265,28,9,11,135,5,65,21
8476525,2020,2.47,2.4,3,5,64,32,43,139,12,4,3,60,0,91,14
8476539,2020,16.18,15.62,17,9,176,65,90,331,44,18,15,158,41,44,29
8476545,2020,0.66,0.63,0,0,4,5,2,11,0,0,0,4,0,46,1
8476624,2020,8.97,8.92,6,8,72,16,14,102,20,6,1,66,163,110,16
8476779,2020,0.76,0.74,0,0,14,6,11,31,1,1,1,13,0,4,2
8476792,2020,5.3,5.12,14,16,110,38,59,207,32,2,6,108,0,51,7
8476807,2020,0.39,0.39,2,0,14,8,7,29,3,1,0,13,0,32,1
8476822,2020,7.41,7.14,5,4,67,24,19,110,15,6,4,61,525,68,10
8476826,2020,15.65,15.33,17,2,117,32,30,179,36,17,12,100,314,51,18
8476850,2020,1.38,1.33,4,10,29,16,22,67,14,0,2,29,0,38,11
8476851,2020,7.97,7.61,5,3,62,25,13,100,13,5,4,57,3,44,6
8476853,2020,5.52,5.43,11,20,101,45,72,218,36,5,4,96,0,63,19
8476854,2020,1.98,1.96,1,3,29,20,19,68,6,2,2,27,0,9,7
8476856,2020,5.67,5.3,9,6,88,45,52,185,20,5,17,83,0,74,11
8476858,2020,2.49,2.34,6,1,44,13,12,69,8,1,5,43,3,78,13
8476869,2020,4.12,4.03,2,5,104,32,43,179,10,3,8,101,0,66,21
8476870,2020,1.12,1.08,0,0,15,4,10,29,1,1,1,14,2,35,7
8476871,2020,13.32,12.5,6,2,110,39,32,181,18,10,10,100,6,54,23
8476872,2020,7.15,7.03,9,2,89,15,29,133,20,9,7,80,211,141,20
8476873,2020,4.47,4.33,2,5,35,10,17,62,11,4,1,31,152,35,14
8476874,2020,1.62,1.62,1,3,43,22,13,78,4,0,1,43,0,41,4
8476875,2020,3.39,3.4,6,5,86,25,44,155,16,5,4,81,0,41,22
8476879,2020,2.43,2.43,5,8,58,20,32,110,17,4,5,54,0,74,11
8476880,2020,9.68,9.37,14,5,83,22,33,138,32,13,9,70,11,105,20
8476881,2020,17.91,17.31,13,11,112,42,36,190,43,19,8,93,484,39,35
8476882,2020,4.95,4.79,5,4,49,12,23,84,14,5,2,44,13,8,10
8476885,2020,3.09,3.03,5,5,70,29,57,156,12,2,6,68,0,111,17
8476886,2020,0.86,0.84,0,0,17,8,16,41,1,1,1,16,0,10,3
8476887,2020,11.27,10.77,9,11,128,49,35,212,32,12,10,116,2,47,22
8476888,2020,4.41,4.33,6,2,36,17,15,68,12,4,2,32,9,14,10
8476889,2020,9.08,8.89,4,4,94,22,28,144,14,6,9,88,423,100,18
8476891,2020,2.54,2.52,9,6,80,17,29,126,20,5,3,75,0,19,14
8476892,2020,2.45,2.41,5,5,60,20,37,117,12,2,2,58,0,35,13
8476897,2020,4.25,4.31,4,1,32,13,5,50,9,4,5,28,115,50,5
8476902,2020,3.8,3.77,6,5,100,37,47,184,16,5,6,95,0,114,9
8476905,2020,10.04,9.89,13,8,83,23,18,124,35,14,9,69,375,43,23
8476906,2020,4.09,3.99,5,6,85,42,62,189,20,9,9,76,0,18,10
8476907,2020,1.9,1.87,1,0,25,1,2,28,2,1,2,24,1,35,1
8476913,2020,4.15,4.14,3,1,27,7,6,40,9,5,0,22,57,73,15
8476915,2020,4.12,4.13,3,5,41,19,13,73,11,3,2,38,171,151,7
8476917,2020,4.12,3.93,5,5,82,41,57,180,14,4,2,78,0,66,25
8476918,2020,6.7,6.51,4,1,58,23,12,93,10,5,2,53,3,38,12
8476919,2020,6.05,5.81,9,4,53,18,11,82,19,6,4,47,269,23,22
8476921,2020,7.6,7.47,6,3,62,21,14,97,13,4,4,58,78,90,11
8476923,2020,4.32,4.21,10,8,91,38,66,195,21,3,6,88,0,57,23
8476924,2020,0.01,0.01,0,0,0,1,0,1,0,0,0,0,0,1,0
8476925,2020,6.66,6.62,4,3,58,21,16,95,15,8,4,50,318,74,15
8476927,2020,4.97,4.96,13,2,49,15,13,77,22,7,1,42,200,53,11
8476931,2020,0.6,0.57,0,2,15,6,8,29,3,1,0,14,0,22,6
8476934,2020,5.43,5.46,2,3,58,23,21,102,13,8,1,50,3,44,16
8476941,2020,0.31,0.31,0,1,8,8,5,21,2,1,0,7,0,11,1
8476952,2020,0.37,0.36,1,0,2,1,1,4,1,0,1,2,0,4,0
8476958,2020,4.62,4.4,5,7,101,48,66,215,15,3,11,98,0,35,24
8476960,2020,7.33,7.15,9,4,85,31,37,153,23,10,5,75,4,11,18
8476966,2020,0.03,0.03,2,1,0,1,0,1,3,0,1,0,17,6,1
8476967,2020,2.02,1.97,4,2,57,15,41,113,8,2,2,55,0,28,8
8476975,2020,4.45,4.16,0,4,33,16,13,62,8,4,3,29,33,136,10
8476979,2020,1.13,1.1,6,5,33,22,38,93,12,1,4,32,0,21,7
8476981,2020,14.2,13.91,4,3,125,58,35,218,24,17,5,108,7,139,17
8476988,2020,1.08,1.07,0,3,43,21,33,97,4,1,4,42,0,55,3
8476994,2020,2.52,2.4,7,1,33,8,13,54,12,4,2,29,3,37,10
8477015,2020,13.39,13.02,6,8,123,39,38,200,35,21,4,102,12,22,56
8477018,2020,2.12,2,1,3,54,14,33,101,5,1,3,53,0,44,8
8477021,2020,9.66,9.19,8,7,68,24,26,118,23,8,0,60,124,41,17
8477038,2020,5.02,4.8,3,3,58,16,22,96,10,4,3,54,0,3,9
8477043,2020,1.7,1.65,5,4,39,14,24,77,11,2,0,37,0,10,5
8477046,2020,0.05,0.05,0,0,2,0,2,4,0,0,0,2,0,1,0
8477070,2020,0.45,0.44,2,1,6,2,3,11,3,0,1,6,0,28,0
8477073,2020,0.55,0.54,0,2,16,13,13,42,4,2,0,14,0,46,2
8477126,2020,1.16,1.14,2,0,12,1,2,15,2,0,2,12,12,14,1
8477149,2020,0,0,0,0,0,0,0,0,0,0,0,0,0,3,0
8477210,2020,0.47,0.44,0,0,6,2,5,13,0,0,0,6,1,14,4
8477215,2020,1.51,1.5,3,5,43,21,28,92,12,4,1,39,0,44,1
8477220,2020,3.4,3.26,8,2,76,30,53,159,15,5,5,71,0,15,18
8477240,2020,1.3,1.19,5,1,10,1,7,18,6,0,1,10,8,45,8
8477244,2020,0.4,0.4,1,1,16,9,18,43,2,0,1,16,0,32,1
8477290,2020,6.02,5.75,5,2,50,19,9,78,11,4,5,46,32,71,12
8477314,2020,0.29,0.27,0,0,3,0,0,3,0,0,0,3,8,1,0
8477320,2020,0.71,0.73,0,0,10,6,2,18,1,1,0,9,0,25,1
8477330,2020,13.17,12.57,11,10,155,37,68,260,38,17,7,138,0,57,10
8477335,2020,0.1,0.11,0,1,3,3,2,8,1,0,0,3,0,10,1
8477341,2020,7.69,7.4,4,2,65,22,17,104,11,5,4,60,11,39,23
8477343,2020,0.63,0.61,1,0,4,2,0,6,1,0,0,4,0,1,0
8477346,2020,4.44,4.36,14,16,101,34,46,181,36,6,9,95,0,114,43
8477353,2020,4.54,4.55,3,0,40,15,18,73,9,6,2,34,12,100,13
8477355,2020,1.14,1.09,4,6,37,11,27,75,11,1,1,36,0,7,8
8477359,2020,1.85,1.81,1,0,50,20,27,97,1,0,3,50,0,69,8
8477365,2020,1.59,1.55,2,4,48,24,31,103,7,1,3,47,0,108,13
8477366,2020,0.57,0.57,0,0,11,5,4,20,1,1,0,10,44,29,2
8477369,2020,1.75,1.7,7,9,47,19,18,84,17,1,2,46,0,62,12
8477380,2020,0.3,0.3,0,0,7,1,0,8,1,1,0,6,0,4,0
8477384,2020,0.28,0.28,1,0,8,9,14,31,1,0,0,8,0,71,3
8477391,2020,0.12,0.11,1,0,1,0,0,1,1,0,0,1,4,0,0
8477392,2020,1.19,1.12,0,0,7,1,1,9,0,0,1,7,0,6,0
8477401,2020,1.48,1.5,2,1,21,7,10,38,5,2,2,19,4,84,4
8477402,2020,12.44,12.45,17,11,120,41,40,201,48,20,11,100,4,49,30
8477404,2020,21.91,21.23,20,14,142,43,54,239,57,23,11,119,3,43,17
8477406,2020,11.07,10.95,8,4,95,26,27,148,23,11,6,84,20,26,16
8477407,2020,11.75,11.58,14,8,101,26,38,165,32,10,9,91,0,30,8
8477409,2020,14.71,13.99,9,9,106,28,36,170,36,18,10,88,23,30,18
8477416,2020,13,12.71,18,8,143,60,34,237,44,18,12,125,3,42,39
8477425,2020,13.36,13.04,5,3,128,33,23,184,25,17,11,111,7,38,18
8477426,2020,8.89,8.55,10,5,105,56,34,195,20,5,5,100,219,74,40
8477429,2020,18.15,16.96,13,11,114,31,31,176,39,15,12,99,123,67,22
8477433,2020,0.91,0.9,3,4,33,12,12,57,7,0,2,33,0,44,9
8477435,2020,3.82,3.81,6,7,101,43,82,226,15,2,7,99,0,77,18
8477444,2020,9.61,9.44,15,10,102,31,47,180,44,19,5,83,2,22,16
8477446,2020,0.65,0.61,0,0,3,3,2,8,0,0,1,3,18,12,2
8477447,2020,7.08,6.79,15,19,161,62,125,348,42,8,16,153,0,22,25
8477450,2020,6.18,6.04,4,4,66,27,33,126,15,7,2,59,136,78,28
8477451,2020,8.1,7.85,8,7,74,41,23,138,22,7,4,67,198,55,21
8477454,2020,7.29,6.79,3,6,69,19,13,101,20,11,8,58,20,82,10
8477455,2020,0.77,0.74,1,0,13,1,4,18,1,0,0,13,34,22,6
8477456,2020,5.27,5.35,5,3,47,22,19,88,18,10,3,37,215,32,16
8477462,2020,1.71,1.69,2,1,29,23,25,77,5,2,2,27,0,100,5
8477463,2020,0.17,0.17,0,1,9,2,2,13,1,0,0,9,0,12,1
8477464,2020,0.87,0.8,1,0,8,5,1,14,1,0,0,8,0,6,0
8477473,2020,0.55,0.55,0,0,6,1,0,7,0,0,0,6,0,2,0
8477474,2020,0,0,0,1,0,0,1,1,1,0,0,0,0,4,1
8477476,2020,7.15,6.88,2,4,78,22,28,128,13,7,3,71,5,85,3
8477478,2020,8.76,8.56,8,1,65,20,18,103,15,6,8,59,3,131,12
8477479,2020,4.45,4.31,1,1,20,7,7,34,7,5,3,15,1,13,6
8477482,2020,10.32,10.08,3,3,67,35,23,125,16,10,7,57,28,69,12
8477488,2020,4.58,4.56,13,8,89,55,87,231,25,4,22,85,0,17,21
8477492,2020,18.74,18.19,28,17,206,74,94,374,65,20,22,186,239,38,16
8477493,2020,20.69,19.63,25,7,175,45,39,259,58,26,11,149,562,31,38
8477494,2020,6.23,6.21,11,10,76,20,25,121,23,2,3,74,21,42,17
8477495,2020,6.19,6.03,8,16,141,42,73,256,29,5,3,136,0,102,20
8477496,2020,13.93,13.42,12,16,130,27,45,202,47,19,8,111,509,53,30
8477497,2020,14.27,12.72,12,7,98,35,21,154,29,10,15,88,340,49,28
8477498,2020,8.25,8.09,8,12,155,53,81,289,36,16,9,139,0,117,24
8477499,2020,5.22,4.31,7,7,73,38,42,153,18,4,6,69,0,193,12
8477500,2020,15.8,14.87,9,11,131,48,47,226,39,19,5,112,648,64,25
8477501,2020,9.11,9.03,4,7,98,34,40,172,21,10,8,88,1,65,23
8477502,2020,0.4,0.37,0,0,14,6,7,27,1,1,0,13,0,38,1
8477503,2020,6.06,5.9,13,2,99,19,35,153,24,9,3,90,192,15,18
8477504,2020,4.83,4.53,8,9,116,46,84,246,21,4,7,112,0,78,14
8477505,2020,11.03,10.73,7,5,81,24,27,132,29,17,6,64,389,29,29
8477506,2020,4.55,4.48,10,5,121,37,76,234,17,2,6,119,0,97,9
8477507,2020,1.82,1.84,2,5,51,21,47,119,8,1,5,50,0,185,16
8477508,2020,8.58,8.38,3,3,55,24,12,91,13,7,7,48,159,99,18
8477511,2020,11.26,10.95,10,4,137,48,50,235,29,15,5,122,18,49,11
8477512,2020,0.07,0.08,0,0,1,0,0,1,0,0,0,1,6,1,0
8477520,2020,0.25,0.28,0,0,2,0,0,2,0,0,0,2,0,0,0
8477527,2020,0.37,0.38,0,1,5,1,0,6,1,0,1,5,1,43,1
8477541,2020,0.07,0.07,0,0,2,1,3,6,0,0,0,2,0,10,0
8477544,2020,0.32,0.31,0,0,1,2,0,3,0,0,0,1,6,1,0
8477573,2020,1.04,1.08,0,0,10,5,2,17,1,1,2,9,2,14,3
8477680,2020,0,0,0,0,0,0,2,2,0,0,0,0,2,0,0
8477810,2020,0.82,0.77,2,6,27,12,12,51,8,0,2,27,0,40,4
8477814,2020,0.05,0.05,0,0,2,1,1,4,0,0,0,2,0,1,0
8477839,2020,11.04,10.7,4,4,88,32,24,144,22,14,6,74,3,24,25
8477845,2020,0.49,0.48,0,2,23,13,13,49,3,1,3,22,0,13,2
8477846,2020,4.96,4.91,0,1,50,15,9,74,5,4,5,46,61,77,4
8477851,2020,2.42,2.32,5,5,38,23,25,86,11,1,4,37,1,45,2
8477887,2020,0.19,0.17,0,0,5,3,2,10,0,0,0,5,16,7,1
8477901,2020,0.4,0.39,1,0,5,1,2,8,1,0,0,5,0,10,1
8477903,2020,7.66,7.54,7,5,62,26,18,106,18,6,8,56,10,179,10
8477919,2020,2.27,2.33,3,5,20,8,7,35,10,2,2,18,87,9,14
8477930,2020,7.22,6.86,0,2,60,20,21,101,11,9,6,51,259,26,17
8477931,2020,7.39,7.2,3,5,59,20,11,90,16,8,7,51,200,51,8
8477932,2020,6.28,6.16,5,6,102,43,50,195,22,11,6,91,0,23,11
8477933,2020,18.56,17.64,8,7,130,60,25,215,40,25,10,105,126,15,17
8477934,2020,24,22.9,30,23,168,61,73,302,84,31,11,137,574,37,56
8477935,2020,12.12,11.69,7,10,106,33,30,169,27,10,12,96,124,108,16
8477936,2020,2.53,2.49,1,2,19,13,9,41,4,1,4,18,1,32,4
8477937,2020,5.27,5.06,0,0,50,22,26,98,5,5,6,45,9,83,15
8477938,2020,2.11,2.08,0,1,62,24,40,126,4,3,3,59,0,63,7
8477939,2020,17.69,17.13,16,9,133,47,37,217,42,17,16,116,13,12,30
8477940,2020,12.73,12.38,11,15,148,46,59,253,47,21,10,127,1,26,18
8477941,2020,14.25,13.19,7,4,121,49,19,189,26,15,14,106,0,102,16
8477942,2020,16.43,15.7,12,8,162,65,63,290,40,20,14,142,5,27,41
8477944,2020,10.69,10.52,11,6,100,48,48,196,36,19,7,81,4,29,20
8477946,2020,11.95,11.72,11,3,134,42,47,223,23,9,9,125,362,38,21
8477947,2020,0.71,0.68,0,0,8,5,3,16,0,0,0,8,0,4,0
8477948,2020,5.7,5.59,5,7,99,36,60,195,14,2,7,97,0,48,17
8477949,2020,17.99,17.82,11,4,142,58,42,242,33,18,3,124,12,52,39
8477950,2020,0.31,0.31,0,1,13,5,4,22,1,0,1,13,0,3,1
8477951,2020,12.4,11.68,11,11,105,29,46,180,32,10,13,95,230,15,26
8477952,2020,5.75,5.54,7,1,58,21,17,96,18,10,2,48,85,34,3
8477953,2020,5.01,4.97,8,11,68,17,27,112,30,11,5,57,0,41,16
8477955,2020,10.37,10.16,12,6,94,31,32,157,32,14,6,80,56,40,21
8477956,2020,15.14,14.87,21,7,176,71,87,334,48,20,12,156,2,35,25
8477960,2020,11.1,10.86,13,2,127,47,64,238,29,14,14,113,27,47,15
8477962,2020,4.3,4.3,5,2,50,17,27,94,11,4,3,46,6,109,8
8477963,2020,2.4,2.21,3,0,18,6,9,33,5,2,2,16,1,43,5
8477964,2020,5.82,5.65,6,1,43,15,13,71,12,5,4,38,82,49,9
8477969,2020,2.04,2.03,3,4,46,22,26,94,9,2,5,44,0,51,10
8477974,2020,0.69,0.68,0,0,14,2,7,23,0,0,1,14,28,19,3
8477979,2020,5.49,5.23,4,5,53,23,17,93,12,3,4,50,2,120,16
8477986,2020,5.22,5.14,7,4,94,39,40,173,18,7,9,87,0,54,15
8477987,2020,10.73,10.25,10,4,104,36,31,171,20,6,16,98,27,50,27
8477989,2020,15.22,14.33,7,7,93,37,22,152,31,17,10,76,553,48,19
8477996,2020,3.74,3.7,0,1,43,14,13,70,5,4,1,39,124,50,7
8477998,2020,13.56,13.32,7,3,91,39,25,155,20,10,11,81,18,60,16
8478010,2020,17.72,17.39,12,13,131,47,35,213,48,23,8,108,256,23,27
8478011,2020,0.05,0.05,0,0,2,1,0,3,0,0,0,2,0,3,0
8478013,2020,1.8,1.79,1,0,47,14,24,85,2,1,1,46,0,26,6
8478017,2020,1.44,1.43,0,1,9,2,1,12,3,2,0,7,0,14,0
8478020,2020,2.47,2.45,2,1,24,8,9,41,3,0,3,24,94,8,3
8478021,2020,0.54,0.53,2,0,11,8,10,29,2,0,0,11,0,15,3
8478027,2020,0.65,0.66,1,2,12,3,5,20,3,0,0,12,67,23,5
8478029,2020,0.14,0.13,0,0,1,2,0,3,0,0,0,1,4,1,1
8478038,2020,6.27,6.25,9,13,121,41,59,221,31,9,7,112,0,44,32
8478040,2020,0,0,0,0,0,0,1,1,0,0,0,0,0,8,2
8478042,2020,13.82,13.59,13,2,151,62,51,264,25,10,13,141,9,15,18
8478043,2020,2.71,2.74,3,3,33,12,12,57,6,0,2,33,54,89,7
8478046,2020,8.51,8.38,6,1,76,28,35,139,14,7,4,69,1,32,23
8478047,2020,6.68,6.56,1,2,38,12,12,62,13,10,3,28,7,28,9
8478049,2020,0.11,0.1,0,0,3,1,3,7,0,0,0,3,0,4,1
8478055,2020,3.62,3.61,8,4,94,21,48,163,17,5,3,89,0,29,19
8478056,2020,1.74,1.65,3,0,16,4,5,25,3,0,1,16,36,23,3
8478057,2020,0.56,0.61,0,0,9,0,2,11,1,1,0,8,37,23,3
8478067,2020,7.33,6.74,4,2,58,27,17,102,14,8,8,50,3,43,10
8478069,2020,0.08,0.08,0,0,1,0,0,1,0,0,0,1,0,7,1
8478074,2020,1.12,1.1,2,0,19,3,5,27,4,2,0,17,0,51,1
8478075,2020,4.14,4.03,4,2,41,21,21,83,11,5,2,36,0,48,25
8478099,2020,12.03,11.65,11,5,128,45,55,228,28,12,14,116,0,61,17
8478104,2020,3.23,3.26,4,3,31,10,12,53,15,8,2,23,3,103,9
8478106,2020,0.38,0.4,0,0,8,0,3,11,2,2,0,6,0,3,5
8478109,2020,11.74,11.48,13,6,129,49,50,228,32,13,12,116,1,17,23
8478115,2020,5.83,5.85,3,2,61,18,24,103,12,7,1,54,102,43,6
8478131,2020,0.7,0.66,0,0,4,4,1,9,0,0,0,4,0,1,1
8478133,2020,5.21,5.09,6,4,55,18,18,91,13,3,3,52,204,79,12
8478136,2020,0.04,0.04,0,0,1,1,0,2,0,0,0,1,0,2,0
8478146,2020,4.28,4.24,0,4,40,21,11,72,7,3,1,37,5,43,11
8478211,2020,3.33,3.26,3,2,39,14,13,66,8,3,5,36,4,94,4
8478233,2020,13.56,13.2,13,1,91,39,39,169,32,18,9,73,2,51,40
8478366,2020,16.13,15.63,3,5,156,49,38,243,26,18,6,138,4,68,22
8478396,2020,4.23,4.15,7,4,89,50,67,206,15,4,7,85,0,28,19
8478397,2020,6.2,5.77,8,8,96,54,47,197,21,5,4,91,0,49,16
8478398,2020,17.75,16.73,13,10,166,62,74,302,49,26,12,140,6,18,37
8478399,2020,0.27,0.25,0,0,7,11,11,29,0,0,0,7,0,20,3
8478400,2020,9.29,8.88,4,4,69,33,30,132,18,10,6,59,170,58,15
8478401,2020,11.69,11.42,10,8,103,36,37,176,35,17,8,86,311,42,20
8478402,2020,24.74,24,50,22,200,57,57,314,105,33,20,167,316,61,36
8478403,2020,6.21,5.75,5,11,61,31,15,107,18,2,7,59,195,20,4
8478407,2020,3.46,3.43,6,8,73,22,69,164,20,6,2,67,0,36,10
8478408,2020,1.62,1.64,1,3,36,17,28,81,6,2,2,34,0,44,4
8478413,2020,7.51,7.45,15,11,80,31,31,142,32,6,11,74,16,87,16
8478414,2020,12.23,11.77,10,9,155,64,79,298,31,12,14,143,9,75,22
8478415,2020,1.1,1.1,4,5,35,16,31,82,9,0,0,35,0,63,6
8478416,2020,3.25,3.24,10,3,84,30,45,159,18,5,4,79,0,99,6
8478420,2020,22.19,20.95,18,18,177,63,70,310,66,30,10,147,32,26,32
8478421,2020,0,0,0,0,0,0,0,0,0,0,0,0,0,0,0
8478424,2020,2.08,2.1,1,0,16,5,8,29,2,1,1,15,11,11,1
8478427,2020,18.55,17.81,25,8,148,60,43,251,57,24,9,124,365,38,33
8478430,2020,0.25,0.25,1,0,7,5,4,16,1,0,0,7,0,3,2
8478431,2020,3.13,2.94,3,2,21,7,7,35,8,3,5,18,1,20,2
8478432,2020,5.29,5.05,4,4,47,20,18,85,11,3,5,44,12,148,7
8478434,2020,6.12,5.97,3,6,46,20,10,76,12,3,5,43,62,107,9
8478436,2020,0,0,0,0,0,0,3,3,0,0,0,0,0,0,0
8478439,2020,10.38,10.12,12,11,99,46,45,190,33,10,8,89,6,55,16
8478440,2020,7.61,7.26,6,2,71,19,22,112,17,9,7,62,197,8,17
8478443,2020,1.31,1.3,0,1,43,24,23,90,4,3,1,40,0,38,6
8478444,2020,18.99,18.58,16,10,141,54,52,247,49,23,9,118,8,32,16
8478445,2020,14.26,14.1,14,14,134,39,44,217,45,17,11,117,152,22,28
8478446,2020,0.15,0.15,1,0,1,1,3,5,1,0,0,1,19,12,3
8478447,2020,3.48,3.44,8,0,38,9,15,62,10,2,3,36,2,28,7
8478449,2020,12.38,11.97,19,9,92,47,47,186,43,15,5,77,230,52,8
8478451,2020,1.94,1.84,2,4,53,16,31,100,8,2,5,51,0,31,13
8478452,2020,0.81,0.78,3,1,23,8,24,55,4,0,2,23,0,27,9
8478454,2020,0.1,0.08,0,0,5,2,0,7,0,0,0,5,0,9,0
8478455,2020,5.23,5.22,3,1,67,20,13,100,8,4,4,63,0,97,5
8478458,2020,9.5,9.17,7,15,85,25,20,130,34,12,5,73,232,34,19
8478460,2020,4.2,3.97,9,4,79,24,38,141,20,7,5,72,0,21,10
8478462,2020,6.11,6.07,5,4,52,24,17,93,15,6,4,46,142,50,26
8478463,2020,10.8,10.39,6,7,109,33,32,174,28,15,6,94,2,39,15
8478465,2020,0,0,0,0,0,0,0,0,0,0,0,0,0,0,0
8478466,2020,5.61,5.69,4,3,74,24,29,127,20,13,2,61,4,28,11
8478467,2020,0.12,0.12,1,0,6,3,3,12,1,0,0,6,0,5,0
8478468,2020,1.44,1.41,5,2,48,17,33,98,8,1,2,47,0,98,7
8478469,2020,5.48,5.36,17,8,120,42,79,241,31,6,12,114,0,68,18
8478472,2020,7.02,6.98,4,3,58,17,16,91,19,12,4,46,43,82,12
8478474,2020,8.75,8.48,8,1,70,42,23,135,13,4,6,66,20,155,20
8478476,2020,0.05,0.05,0,0,3,2,3,8,0,0,0,3,0,1,2
8478477,2020,0.22,0.22,1,0,3,2,0,5,1,0,0,3,30,8,1
8478483,2020,21.05,20.53,35,12,156,51,87,294,67,20,13,136,4,23,53
8478485,2020,0.88,0.84,0,0,10,2,2,14,0,0,0,10,0,11,2
8478488,2020,0.01,0.01,0,0,1,0,0,1,0,0,0,1,0,1,0
8478491,2020,1.3,1.22,2,4,42,28,34,104,7,1,4,41,0,37,4
8478493,2020,16.62,15.78,9,2,120,30,20,170,30,19,14,101,394,105,21
8478495,2020,13.09,12.55,10,8,130,51,70,251,30,12,8,118,0,63,18
8478498,2020,10.45,10.15,5,4,92,16,19,127,14,5,9,87,6,33,24
8478500,2020,6.06,5.92,8,11,126,40,86,252,26,7,8,119,0,56,5
8478502,2020,0,0,0,0,0,0,1,1,0,0,0,0,0,2,0
8478506,2020,0.42,0.4,0,3,14,5,9,28,4,1,0,13,0,11,4
8478507,2020,2.46,2.47,5,5,56,23,27,106,13,3,4,53,0,48,29
8478508,2020,5.84,5.68,5,1,62,29,15,106,11,5,5,57,4,94,10
8478512,2020,0.06,0.06,0,0,2,1,1,4,0,0,0,2,7,2,1
8478519,2020,8.96,8.73,3,10,74,21,14,109,22,9,8,65,230,64,21
8478528,2020,2.69,2.7,3,4,39,8,16,63,10,3,3,36,24,31,9
8478542,2020,6.14,6.06,5,2,65,17,28,110,14,7,2,58,54,21,15
8478550,2020,10.35,9.9,25,16,106,59,57,222,58,17,6,89,0,13,21
8478567,2020,0.79,0.78,1,3,29,7,14,50,5,1,1,28,0,36,6
8478569,2020,7.97,7.76,7,0,68,16,17,101,11,4,9,64,272,90,15
8478585,2020,5.61,5.49,8,3,37,23,10,70,13,2,1,35,153,13,20
8478831,2020,4.02,3.47,4,1,42,15,18,75,10,5,8,37,103,17,6
8478840,2020,0.21,0.21,0,0,7,3,2,12,0,0,1,7,0,30,0
8478841,2020,0.05,0.05,0,0,3,0,1,4,0,0,0,3,0,2,0
8478846,2020,0.68,0.64,2,1,16,5,11,32,3,0,2,16,0,3,1
8478851,2020,2.35,2.24,1,1,31,17,20,68,3,1,4,30,0,22,10
8478856,2020,11.46,11.27,22,5,135,50,57,242,39,12,10,123,7,26,34
8478857,2020,0.01,0.01,0,0,1,0,0,1,0,0,0,1,0,2,0
8478859,2020,0.7,0.73,1,1,22,12,13,47,3,1,2,21,0,49,3
8478864,2020,20.46,19.87,17,7,157,71,51,279,51,27,11,130,3,29,27
8478866,2020,0.35,0.34,0,0,4,1,6,11,0,0,1,4,3,12,0
8478868,2020,0.07,0.06,0,1,3,3,4,10,1,0,0,3,0,9,3
8478870,2020,8.63,7.82,3,6,66,15,18,99,17,8,7,58,0,81,31
8478873,2020,6.78,6.71,10,3,69,34,26,129,20,7,8,62,2,5,19
8478874,2020,7.15,6.93,3,3,66,25,18,109,11,5,4,61,54,16,9
8478882,2020,2.13,2.1,4,6,48,19,35,102,12,2,2,46,0,69,17
8478888,2020,0.44,0.47,0,0,3,1,2,6,0,0,0,3,5,2,3
8478891,2020,9.45,9.29,7,6,88,31,21,140,25,12,6,76,7,61,13
8478904,2020,5.06,5.04,1,5,40,21,15,76,8,2,1,38,158,47,11
8478906,2020,1.68,1.67,3,7,45,19,20,84,10,0,4,45,0,35,8
8478911,2020,2.55,2.48,1,7,57,34,55,146,10,2,5,55,0,61,4
8478915,2020,0.15,0.14,0,0,2,2,4,8,0,0,0,2,0,0,0
8478949,2020,0.43,0.43,0,1,7,0,0,7,1,0,0,7,0,22,1
8478967,2020,2.24,2.03,1,1,15,9,2,26,3,1,0,14,39,39,3
8478970,2020,0.35,0.34,1,0,14,2,10,26,1,0,0,14,0,11,4
8478975,2020,4.91,4.87,5,3,50,25,15,90,10,2,5,48,13,73,13
8478996,2020,1.45,1.41,0,1,10,0,4,14,5,4,1,6,7,14,4
8479026,2020,2.74,2.66,5,5,76,33,59,168,11,1,6,75,0,69,19
8479066,2020,3.88,3.88,2,0,46,16,5,67,4,2,6,44,0,85,8
8479252,2020,0.24,0.24,1,2,12,2,4,18,3,0,2,12,0,20,1
8479291,2020,6.89,6.66,3,3,62,15,14,91,14,8,5,54,196,110,11
8479293,2020,5.98,5.86,5,4,43,12,7,62,16,7,3,36,3,139,26
8479314,2020,19.11,18.45,18,9,151,58,53,262,43,16,13,135,3,132,21
8479315,2020,0,0,0,0,0,0,0,0,0,0,0,0,0,0,0
8479316,2020,7.73,7.61,6,3,71,29,17,117,19,10,4,61,15,84,8
8479318,2020,30.04,29.29,15,10,222,93,51,366,66,41,19,181,453,57,47
8479322,2020,2.31,2.19,2,1,24,7,8,39,7,4,3,20,0,28,6
8479323,2020,6.74,6.62,19,23,102,37,42,181,47,5,4,97,0,23,38
8479324,2020,2.77,2.66,5,10,65,24,40,129,16,1,5,64,0,98,19
8479325,2020,5.05,4.63,12,13,92,44,53,189,30,5,5,87,0,65,20
8479328,2020,3.37,3.27,5,1,38,9,9,56,8,2,4,36,4,56,5
8479329,2020,0,0,0,0,0,0,0,0,0,0,0,0,0,0,0
8479333,2020,1.33,1.24,1,1,33,13,10,56,4,2,1,31,0,26,5
8479335,2020,4.18,4.07,3,1,34,7,4,45,11,7,3,27,6,15,14
8479336,2020,4.69,4.59,2,3,66,17,18,101,11,6,6,60,3,104,6
8479337,2020,20.01,19.51,14,10,155,44,69,268,56,32,6,123,16,70,31
8479339,2020,5.46,5.32,7,5,82,27,51,160,24,12,4,70,6,36,9
8479343,2020,13.65,13.21,11,10,124,52,36,212,35,14,4,110,19,20,23
8479344,2020,17,16.27,5,5,115,36,28,179,25,15,11,100,0,101,23
8479345,2020,9.06,8.75,13,10,176,80,100,356,41,18,21,158,0,59,20
8479346,2020,8.55,8.46,6,5,84,35,37,156,22,11,2,73,9,59,15
8479348,2020,0.6,0.58,2,4,24,9,13,46,6,0,2,24,0,9,1
8479351,2020,4.79,4.43,3,3,42,12,16,70,12,6,3,36,237,41,10
8479353,2020,4.93,4.71,3,3,33,15,6,54,7,1,1,32,119,57,6
8479355,2020,0.93,0.81,1,0,24,11,22,57,3,2,1,22,0,23,2
8479356,2020,1.51,1.56,0,0,19,6,11,36,3,3,2,16,2,36,2
8479358,2020,0.27,0.25,0,0,4,2,1,7,0,0,0,4,1,17,0
8479364,2020,0.05,0.05,0,0,2,0,0,2,0,0,0,2,1,5,1
8479365,2020,3.63,3.62,1,0,44,19,12,75,5,4,0,40,37,61,9
8479366,2020,0.01,0.01,0,0,0,1,1,2,0,0,0,0,0,0,0
8479367,2020,0.09,0.1,0,0,3,1,0,4,0,0,0,3,0,6,0
8479368,2020,8.7,8.36,1,3,77,28,28,133,11,7,6,70,5,100,20
8479369,2020,0.25,0.27,0,3,5,4,4,13,3,0,0,5,0,35,5
8479370,2020,8.56,8.34,8,2,92,29,33,154,17,7,8,85,162,45,24
8479371,2020,1.41,1.37,5,5,58,15,25,98,12,2,1,56,0,32,8
8479372,2020,0.38,0.38,2,1,14,7,14,35,4,1,0,13,0,10,2
8479376,2020,0.81,0.8,1,3,20,8,14,42,5,1,1,19,0,19,7
8479378,2020,1.98,1.93,0,3,63,33,35,131,4,1,3,62,0,49,7
8479379,2020,1.19,1.19,2,1,20,2,5,27,4,1,2,19,0,28,1
8479381,2020,1.99,1.99,1,0,33,5,11,49,1,0,3,33,1,41,5
8479382,2020,0.95,0.96,1,0,15,5,7,27,1,0,0,15,56,31,5
8479385,2020,10.86,10.88,16,5,98,41,32,171,35,14,7,84,6,7,32
8479387,2020,0.05,0.06,0,0,2,1,2,5,0,0,0,2,0,4,0
8479388,2020,0.96,0.95,0,0,29,7,19,55,1,1,3,28,0,50,4
8479393,2020,4.13,4.01,0,1,60,19,19,98,6,5,1,55,20,47,11
8479395,2020,0.4,0.4,2,0,10,5,7,22,3,1,1,9,0,5,3
8479398,2020,2.94,2.91,16,11,79,34,73,186,32,5,5,74,0,31,14
8479400,2020,6.14,6.01,5,7,76,22,33,131,21,9,5,67,166,59,18
8479402,2020,2.79,2.77,6,5,55,26,35,116,12,1,5,54,0,17,11
8479407,2020,10.39,10.2,11,12,101,43,37,181,30,7,7,94,3,31,17
8479410,2020,5.09,5.07,15,10,109,44,65,218,29,4,9,105,0,66,12
8479411,2020,0.05,0.06,0,0,0,1,1,2,0,0,1,0,0,0,0
8479414,2020,5.42,5.18,4,3,46,20,8,74,10,3,6,43,12,136,11
8479415,2020,6.75,6.59,3,3,56,21,18,95,15,9,4,47,308,77,25
8479419,2020,0.28,0.28,0,0,1,0,0,1,0,0,0,1,0,3,0
8479420,2020,10.1,9.66,4,2,96,19,31,146,14,8,6,88,2,25,13
8479425,2020,5.38,5.25,6,18,115,44,64,223,26,2,12,113,0,67,7
8479439,2020,2.12,2.1,3,5,49,25,41,115,9,1,3,48,0,38,8
8479442,2020,1.93,1.9,2,6,55,27,47,129,11,3,0,52,0,33,9
8479458,2020,1.97,1.91,9,4,70,40,65,175,17,4,6,66,0,114,7
8479462,2020,0.07,0.07,1,0,5,0,1,6,1,0,0,5,0,4,1
8479465,2020,4.65,4.42,4,3,46,15,16,77,10,3,7,43,6,64,9
8479466,2020,0.55,0.55,2,0,12,2,2,16,2,0,0,12,1,13,2
8479511,2020,8.12,7.74,9,8,60,35,13,108,25,8,2,52,1,9,22
8479514,2020,0.77,0.72,2,0,11,0,2,13,2,0,0,11,15,8,0
8479516,2020,0,0,0,0,0,0,0,0,0,0,0,0,0,0,1
8479523,2020,0.27,0.26,1,0,10,2,6,18,1,0,1,10,0,6,2
8479525,2020,5.35,5.27,2,1,46,14,14,74,12,9,3,37,101,36,5
8479542,2020,8.47,8.33,11,4,91,21,32,144,24,9,3,82,9,58,31
8479546,2020,0.27,0.28,0,0,6,1,3,10,0,0,1,6,0,11,0
8479547,2020,0.3,0.31,0,0,2,1,0,3,0,0,0,2,0,0,0
8479550,2020,0.8,0.78,0,0,6,3,0,9,0,0,0,6,11,5,2
8479571,2020,0.22,0.21,0,0,3,3,1,7,1,1,0,2,0,2,0
8479573,2020,6.37,6.17,1,2,55,27,28,110,9,6,0,49,74,26,24
8479580,2020,6.04,5.89,2,5,48,30,19,97,12,5,2,43,279,77,9
8479587,2020,2.53,2.46,0,1,23,16,13,52,2,1,3,22,43,52,5
8479602,2020,0.86,0.85,1,0,19,6,10,35,1,0,0,19,0,11,3
8479639,2020,1.54,1.54,2,1,31,13,31,75,6,3,3,28,0,29,5
8479644,2020,1.6,1.57,0,0,18,11,4,33,1,1,2,17,2,8,2
8479661,2020,2.95,2.96,2,0,23,4,6,33,7,5,1,18,1,53,0
8479671,2020,2.76,2.77,1,1,24,8,5,37,5,3,1,21,4,62,1
8479675,2020,10.23,9.7,10,3,88,48,28,164,23,10,13,78,3,38,14
8479705,2020,1.1,1.06,0,0,10,1,4,15,0,0,0,10,0,22,0
8479718,2020,2.86,2.66,0,0,26,11,10,47,3,3,2,23,1,8,4
8479772,2020,2.73,2.75,0,1,31,14,11,56,2,1,2,30,4,65,6
8479933,2020,0.52,0.51,0,1,5,1,3,9,1,0,1,5,0,7,1
8479944,2020,8.67,8.4,1,5,79,18,22,119,15,9,6,70,7,95,14
8479945,2020,0.57,0.56,0,0,16,7,9,32,1,1,1,15,0,13,5
8479968,2020,0.28,0.27,0,0,7,2,3,12,0,0,0,7,2,9,2
8479974,2020,6.1,5.9,2,3,49,30,25,104,9,4,4,45,226,45,11
8479976,2020,2.64,2.63,5,4,72,26,48,146,11,2,2,70,0,28,9
8479977,2020,11.99,11.95,10,3,70,30,18,118,21,8,6,62,0,52,32
8479980,2020,3.16,3.19,6,6,78,41,66,185,17,5,2,73,0,94,10
8479981,2020,0,0,0,0,0,0,0,0,0,0,0,0,0,1,0
8479982,2020,0.96,0.97,2,5,31,14,25,70,7,0,2,31,0,18,6
8479983,2020,2.32,2.2,7,9,58,22,26,106,17,1,8,57,1,155,30
8479984,2020,1.63,1.63,1,1,40,21,18,79,3,1,2,39,0,39,1
8479986,2020,0.38,0.37,0,0,4,3,5,12,0,0,0,4,0,8,2
8479987,2020,2.96,2.42,6,0,30,12,15,57,9,3,2,27,74,28,5
8479992,2020,7.45,7.24,8,1,62,11,21,94,12,3,5,59,134,72,7
8479994,2020,3.13,3.08,2,2,37,12,16,65,11,7,3,30,132,52,4
8479996,2020,4.72,4.28,4,2,28,8,19,55,10,4,6,24,110,10,11
8479998,2020,1.53,1.53,4,6,52,22,36,110,11,1,1,51,0,66,14
8479999,2020,6.56,6.41,6,6,61,19,14,94,22,10,2,51,216,9,18
8480001,2020,0.41,0.42,0,2,15,4,7,26,2,0,1,15,0,3,1
8480002,2020,6,5.89,2,3,44,18,15,77,11,6,0,38,203,11,12
8480003,2020,3.86,3.73,2,1,32,18,11,61,7,4,1,28,25,13,6
8480005,2020,0.47,0.47,1,0,5,3,2,10,1,0,0,5,0,8,2
8480008,2020,0.42,0.42,0,1,3,2,3,8,1,0,1,3,14,1,0
8480009,2020,5.33,5.11,3,8,65,29,42,136,22,11,5,54,1,78,8
8480011,2020,0.04,0.04,1,0,0,1,1,2,1,0,0,0,0,9,1
8480012,2020,8.24,7.82,5,6,63,32,31,126,21,10,4,53,63,11,11
8480014,2020,9.03,8.5,7,6,65,26,25,116,23,10,6,55,291,18,13
8480015,2020,8.76,8.61,8,3,86,27,21,134,18,7,10,79,2,58,17
8480018,2020,12.29,12.01,17,9,110,45,49,204,41,15,13,95,350,70,30
8480021,2020,2.89,2.82,1,1,28,12,11,51,3,1,1,27,47,7,7
8480023,2020,2.57,2.57,6,3,23,16,8,47,12,3,3,20,112,5,10
8480025,2020,0.46,0.46,1,0,6,1,1,8,2,1,1,5,6,10,1
8480027,2020,10.55,10.17,21,7,128,30,47,205,45,17,10,111,5,28,19
8480028,2020,0.1,0.09,0,0,0,2,0,2,0,0,0,0,10,0,0
8480029,2020,2.79,2.78,1,1,27,6,6,39,6,4,1,23,1,23,11
8480031,2020,12.42,12.22,13,4,94,51,36,181,33,16,9,78,12,93,20
8480035,2020,1.74,1.67,3,2,50,26,33,109,8,3,2,47,0,47,9
8480036,2020,7.71,7.43,8,11,121,54,87,262,27,8,5,113,0,47,16
8480037,2020,1.97,1.98,0,1,15,4,2,21,2,1,1,14,0,0,6
8480039,2020,13.27,12.92,17,10,114,43,31,188,41,14,6,100,36,45,17
8480043,2020,0.07,0.07,0,0,1,2,2,5,0,0,0,1,0,3,0
8480053,2020,0.58,0.55,1,1,8,1,1,10,2,0,0,8,4,7,2
8480056,2020,0.66,0.66,0,2,17,4,10,31,3,1,1,16,0,9,2
8480058,2020,0.76,0.74,4,0,27,12,9,48,5,1,2,26,0,22,4
8480063,2020,0.11,0.11,0,0,3,0,1,4,0,0,1,3,0,1,0
8480064,2020,12.48,11.69,8,10,96,38,34,168,35,17,11,79,379,72,17
8480069,2020,5.26,5.13,22,14,104,37,84,225,44,8,7,96,0,49,32
8480070,2020,1.21,1.15,1,3,23,8,22,53,7,3,0,20,0,17,2
8480072,2020,2.97,2.66,3,0,23,8,6,37,6,3,4,20,20,8,3
8480073,2020,1.87,1.79,5,6,42,15,36,93,13,2,3,40,0,26,8
8480074,2020,5.26,5.21,6,5,75,29,37,141,15,4,4,71,129,49,24
8480078,2020,7.29,7.21,8,6,76,26,21,123,22,8,5,68,130,15,23
8480083,2020,0,0,0,0,0,0,0,0,0,0,0,0,0,3,0
8480113,2020,14.18,13.7,9,7,120,40,32,192,30,14,9,106,2,26,15
8480144,2020,5.79,5.61,6,5,63,17,20,100,12,1,4,62,411,45,31
8480145,2020,3.98,3.89,19,10,100,36,64,200,32,3,8,97,0,137,19
8480158,2020,0.32,0.31,0,2,7,5,11,23,2,0,1,7,0,10,2
8480160,2020,1.19,1.01,1,3,26,10,14,50,6,2,0,24,0,76,7
8480172,2020,1.74,1.73,4,4,46,26,30,102,8,0,2,46,0,30,1
8480184,2020,0.35,0.35,2,1,8,6,6,20,3,0,0,8,0,14,0
8480185,2020,4.15,3.99,1,4,35,14,15,64,8,3,6,32,190,55,23
8480186,2020,4.22,4.31,1,5,35,8,8,51,13,7,1,28,2,36,11
8480196,2020,1.09,1.05,4,4,24,18,23,65,9,1,2,23,0,32,2
8480201,2020,0,0,0,0,0,0,1,1,0,0,0,0,0,2,0
8480205,2020,3.61,3.09,1,1,28,14,12,54,5,3,4,25,0,15,2
8480208,2020,15.31,14.97,12,5,111,59,42,212,34,17,11,94,5,102,15
8480221,2020,0,0,0,0,0,0,0,0,0,0,0,0,0,0,0
8480222,2020,0.15,0.14,1,0,4,2,2,8,2,1,0,3,0,1,0
8480226,2020,0.65,0.62,0,1,7,1,1,9,2,1,1,6,0,13,0
8480276,2020,0.32,0.3,1,0,5,0,1,6,1,0,0,5,0,0,1
8480289,2020,0.08,0.08,0,0,3,1,3,7,1,1,0,2,9,12,0
8480293,2020,1.22,1.23,2,3,26,10,12,48,9,4,2,22,0,25,2
8480326,2020,0.11,0.11,0,0,1,1,3,5,0,0,0,1,0,6,1
8480336,2020,4.17,3.92,4,8,92,33,56,181,17,5,5,87,0,43,10
8480384,2020,0.89,0.85,1,0,7,2,1,10,1,0,1,7,17,4,2
8480448,2020,0.08,0.09,0,0,1,0,0,1,1,1,0,0,1,4,0
8480459,2020,13.86,13.28,11,2,112,21,23,156,27,14,5,98,264,28,25
8480466,2020,0.03,0.03,0,0,1,0,2,3,0,0,0,1,0,2,0
8480467,2020,0.51,0.48,0,1,11,8,8,27,1,0,1,11,0,14,2
8480727,2020,3.2,3.18,4,6,54,34,39,127,12,2,7,52,0,85,9
8480748,2020,2.4,2.19,1,2,18,6,16,40,3,0,3,18,1,40,3
8480762,2020,8.79,8.65,8,2,75,31,31,137,18,8,6,67,3,94,15
8480769,2020,0.71,0.72,0,0,8,10,2,20,2,2,0,6,7,16,1
8480776,2020,0.19,0.19,0,0,3,1,1,5,0,0,0,3,0,0,1
8480789,2020,9.83,8.84,6,3,94,36,49,179,21,12,8,82,5,57,12
8480797,2020,13.36,12.84,12,6,122,38,29,189,38,20,14,102,6,48,27
8480798,2020,7.05,6.85,3,5,65,19,22,106,16,8,7,57,102,33,18
8480800,2020,4.89,4.58,20,18,98,44,91,233,41,3,5,95,0,18,34
8480801,2020,23.59,22.89,11,8,220,63,36,319,36,17,20,203,118,248,33
8480802,2020,0.28,0.27,1,0,3,4,5,12,1,0,0,3,41,3,1
8480803,2020,1.69,1.68,1,2,38,11,20,69,5,2,1,36,0,11,4
8480806,2020,5.45,5.27,2,1,52,20,16,88,9,6,3,46,189,16,18
8480807,2020,0.19,0.18,0,2,10,2,8,20,2,0,1,10,0,20,2
8480813,2020,1.47,1.49,0,0,8,2,6,16,1,1,1,7,17,7,1
8480814,2020,0.31,0.3,1,3,7,3,12,22,6,2,0,5,0,14,4
8480817,2020,2.76,2.76,2,5,62,27,47,136,12,5,6,57,0,93,33
8480821,2020,9.4,8.73,8,5,97,26,46,169,19,6,7,91,5,22,17
8480822,2020,0.24,0.26,0,0,2,0,1,3,0,0,0,2,0,6,0
8480829,2020,7.29,7.16,9,6,87,24,47,158,20,5,1,82,263,84,33
8480830,2020,18.75,18.29,13,14,147,55,86,288,42,15,12,132,2,114,23
8480831,2020,0.02,0.02,0,0,1,0,3,4,0,0,0,1,0,3,2
8480833,2020,1.56,1.54,0,2,23,8,11,42,4,2,1,21,0,7,7
8480839,2020,4.85,4.73,9,9,115,33,62,210,23,5,11,110,0,80,13
8480844,2020,0.31,0.33,1,3,6,2,3,11,4,0,0,6,1,15,3
8480845,2020,0.64,0.59,0,0,8,0,2,10,1,1,0,7,35,7,0
8480848,2020,3.24,3.11,2,0,31,11,17,59,5,3,2,28,46,47,4
8480849,2020,0.78,0.81,0,1,10,6,4,20,3,2,0,8,40,15,4
8480853,2020,3.84,3.74,3,1,40,11,12,63,4,0,3,40,2,13,6
8480860,2020,0.08,0.09,0,2,5,1,4,10,2,0,0,5,0,18,2
8480865,2020,1.95,1.9,6,5,70,25,48,143,14,3,6,67,0,40,13
8480871,2020,2.97,2.89,2,11,39,13,32,84,15,2,3,37,1,29,7
8480873,2020,0.28,0.29,1,3,9,2,3,14,4,0,0,9,0,11,2
8480879,2020,0.17,0.17,0,0,6,4,6,16,0,0,0,6,0,3,0
8480883,2020,2.97,2.85,14,7,69,32,76,177,23,2,7,67,0,32,8
8480884,2020,0.06,0.06,0,0,4,0,2,6,0,0,1,4,0,2,0
8480890,2020,1.07,1.07,0,0,3,1,0,4,2,2,0,1,12,2,1
8480901,2020,2.21,2.24,0,0,31,8,8,47,2,2,1,29,2,27,2
8480913,2020,0.21,0.2,1,2,10,5,7,22,3,0,1,10,0,6,0
8480944,2020,0,0,0,0,0,0,0,0,0,0,0,0,4,0,0
8480945,2020,0.02,0.01,0,0,1,0,3,4,0,0,1,1,0,5,0
8480946,2020,7.13,7,4,2,69,23,20,112,15,9,1,60,16,13,11
8480950,2020,0.94,0.92,1,0,36,15,21,72,2,1,4,35,0,103,8
8480965,2020,0.26,0.22,0,0,4,1,0,5,0,0,0,4,14,6,2
8481014,2020,2.66,2.56,3,2,71,42,78,191,6,1,6,70,0,138,8
8481019,2020,0.03,0.03,0,0,1,0,1,2,0,0,0,1,11,0,1
8481058,2020,0.24,0.22,0,0,1,2,1,4,0,0,1,1,0,0,0
8481068,2020,11.08,10.71,6,7,109,51,43,203,28,15,8,94,20,18,34
8481077,2020,4.76,4.7,7,3,60,27,17,104,13,3,8,57,0,25,13
8481105,2020,0,0,0,0,0,0,2,2,0,0,0,0,0,1,0
8481122,2020,0.17,0.15,0,0,3,3,2,8,0,0,0,3,0,20,0
8481147,2020,0.26,0.26,0,0,4,1,0,5,0,0,0,4,0,22,0
8481178,2020,0.11,0.11,0,0,5,1,2,8,0,0,0,5,0,1,1
8481186,2020,5.52,4.99,2,0,37,16,10,63,5,3,5,34,2,29,14
8481433,2020,0.7,0.67,1,1,11,0,1,12,2,0,1,11,1,1,1
8481442,2020,0,0,0,0,0,0,1,1,0,0,0,0,0,1,0
8481477,2020,8.4,8.41,4,2,64,15,12,91,17,11,5,53,69,48,12
8481479,2020,0.01,0.01,0,1,1,0,0,1,1,0,0,1,0,1,1
8481481,2020,4.64,4.45,1,6,42,20,15,77,10,3,5,39,180,32,6
8481516,2020,0.99,0.99,1,0,13,2,4,19,2,1,1,12,27,5,3
8481518,2020,0.29,0.28,0,1,5,1,0,6,2,1,0,4,0,5,1
8481522,2020,0.24,0.24,1,0,1,1,3,5,1,0,0,1,6,4,1
8481523,2020,3.01,2.98,6,2,26,14,10,50,10,2,2,24,76,7,18
8481524,2020,0.88,0.89,1,1,21,7,15,43,2,0,1,21,0,33,1
8481528,2020,6.17,6,8,1,62,18,22,102,13,4,4,58,95,30,13
8481533,2020,3.87,3.77,8,2,53,22,26,101,13,3,2,50,42,7,6
8481535,2020,11.47,10.92,5,9,118,37,41,196,27,13,8,105,1,26,42
8481540,2020,3.06,2.89,1,0,30,16,10,56,5,4,2,26,0,3,3
8481546,2020,0.05,0.06,0,0,1,2,3,6,0,0,0,1,0,1,1
8481554,2020,8.76,8.43,3,5,81,29,26,136,17,9,4,72,3,14,31
8481559,2020,12.65,12.17,14,6,142,50,65,257,31,11,15,131,216,15,56
8481560,2020,0.36,0.32,0,0,1,0,1,2,1,1,0,0,0,0,0
8481572,2020,0.2,0.19,0,0,9,1,0,10,0,0,0,9,0,2,1
8481580,2020,0.09,0.08,0,0,1,0,1,2,0,0,0,1,1,0,0
8481582,2020,0.79,0.81,0,1,9,5,4,18,1,0,1,9,0,3,1
8481596,2020,1.6,1.63,2,4,11,10,10,31,7,1,0,10,45,11,7
8481599,2020,0.12,0.13,0,1,6,0,8,14,2,1,1,5,0,4,1
8481600,2020,0.98,0.95,2,3,30,12,13,55,6,1,5,29,0,28,5
8481618,2020,0.96,0.94,1,2,8,8,5,21,3,0,0,8,16,3,2
8481624,2020,12.18,12.21,6,4,107,36,30,173,17,7,8,100,2,49,21
8481626,2020,2.59,2.45,1,0,28,7,11,46,6,5,2,23,4,16,4
8481629,2020,0.05,0.05,0,0,1,0,2,3,0,0,0,1,0,4,1
8481638,2020,0.32,0.33,0,0,6,1,1,8,0,0,0,6,1,4,3
8481640,2020,0.03,0.02,0,0,1,0,0,1,0,0,0,1,0,3,1
8481641,2020,3.88,3.84,4,1,31,10,13,54,11,6,1,25,1,40,7
8481708,2020,0.32,0.3,1,3,12,3,8,23,4,0,0,12,0,8,1
8481740,2020,0.22,0.22,1,0,4,1,1,6,1,0,1,4,0,5,2
8481812,2020,1.47,1.43,3,5,51,12,34,97,10,2,0,49,0,84,18
8481813,2020,2.52,2.49,1,0,24,10,16,50,3,2,0,22,139,31,9
8482055,2020,0.4,0.41,0,1,8,5,3,16,1,0,0,8,1,6,2
8482062,2020,0.07,0.07,0,0,1,0,0,1,0,0,0,1,0,0,0
8482063,2020,0.9,0.72,0,0,3,5,4,12,0,0,0,3,3,12,3
8482067,2020,0.46,0.46,1,1,4,5,2,11,3,1,0,3,0,8,0
8482072,2020,0.19,0.19,0,0,5,2,0,7,0,0,0,5,0,2,0
8482109,2020,7.46,7.41,6,3,67,27,21,115,21,12,3,55,13,43,15
8482116,2020,7.83,7.59,9,8,96,23,38,157,25,8,9,88,6,40,17
8482124,2020,0.64,0.64,0,1,9,2,1,12,1,0,0,9,26,3,3
8482142,2020,0.93,0.9,1,4,28,19,22,69,8,3,0,25,0,7,6
8482179,2020,0.1,0.11,1,0,2,0,0,2,1,0,0,2,0,2,1
8482222,2020,3.4,3.22,2,3,23,7,12,42,8,3,2,20,0,7,9
8482240,2020,2.72,2.59,1,0,22,12,4,38,2,1,2,21,1,19,12
8482241,2020,0.76,0.8,2,0,8,2,1,11,4,2,0,6,5,7,3
8482245,2020,1.71,1.7,6,5,39,16,30,85,14,3,1,36,0,89,8
8482247,2020,1.41,1.35,3,3,33,11,14,58,6,0,0,33,0,30,8
8482248,2020,0.89,0.9,0,0,5,1,2,8,1,1,0,4,29,14,2
8482369,2020,0.08,0.08,0,0,3,0,3,6,0,0,0,3,0,2,1
8482623,2020,0.7,0.67,0,0,7,1,2,10,0,0,2,7,6,12,1
8482635,2020,1.08,1.06,1,1,5,3,2,10,3,1,0,4,1,38,2
8482641,2020,0.26,0.26,0,0,6,3,2,11,0,0,0,6,0,1,1
8482654,2020,0.97,0.83,1,0,7,0,1,8,1,0,2,7,13,0,1
8465009,2019,3.12,2.81,2,6,85,31,39,155,13,5,2,80,0,78,26
8466138,2019,7.75,7.37,13,11,76,24,25,125,31,7,8,69,324,20,55
8466139,2019,13.88,13.33,6,5,117,34,41,192,22,11,8,106,36,57,29
8468493,2019,2.33,2.26,4,7,43,22,43,108,12,1,3,42,1,51,9
8468508,2019,6.95,5.85,2,1,60,14,12,86,11,8,8,52,3,20,3
8468674,2019,1.84,1.82,2,3,58,22,35,115,6,1,2,57,0,113,15
8469454,2019,11.68,11.54,8,7,115,34,37,186,25,10,5,105,9,52,11
8469455,2019,6.65,6.42,12,4,73,26,33,132,25,9,6,64,215,13,20
8469459,2019,8.06,7.44,10,7,74,22,17,113,21,4,7,70,431,25,29
8469465,2019,2.69,2.52,6,2,44,32,25,101,8,0,2,44,0,64,9
8470047,2019,8.24,7.78,7,7,63,23,18,104,20,6,4,57,324,28,17
8470110,2019,1.69,1.63,3,4,37,18,21,76,7,0,1,37,0,9,5
8470144,2019,8.11,7.56,3,1,86,22,20,128,8,4,4,82,210,44,11
8470151,2019,1.47,1.45,3,5,53,19,29,101,9,1,2,52,0,44,11
8470187,2019,3.08,3.01,7,3,96,43,73,212,12,2,8,94,1,135,6
8470257,2019,6.34,6.03,6,4,69,16,28,113,16,6,6,63,8,26,16
8470281,2019,4.32,3.96,8,16,111,43,102,256,27,3,6,108,0,26,42
8470318,2019,0.4,0.37,0,0,16,5,10,31,0,0,1,16,0,24,1
8470595,2019,15.51,14.99,20,8,113,56,63,232,47,19,10,94,495,24,25
8470600,2019,5.08,4.96,17,21,111,47,95,253,46,8,9,103,0,48,19
8470601,2019,1.44,1.44,0,3,43,18,32,93,4,1,4,42,0,58,3
8470604,2019,16.51,15.77,8,3,181,70,39,290,27,16,18,165,382,66,13
8470606,2019,17.53,16.38,12,6,167,65,57,289,35,17,16,150,7,143,28
8470607,2019,2.1,2.04,0,1,40,11,27,78,4,3,0,37,0,52,3
8470610,2019,23.77,23.01,11,9,155,51,32,238,45,25,16,130,41,27,21
8470612,2019,12.78,11.49,13,15,144,65,60,269,41,13,6,131,525,123,53
8470613,2019,11.99,11.63,17,16,225,97,193,515,45,12,26,213,0,72,49
8470619,2019,5.94,5.79,4,4,54,27,16,97,13,5,3,49,190,64,16
8470621,2019,8.96,8.71,9,8,76,39,43,158,22,5,4,71,4,60,17
8470626,2019,7.49,7.38,5,3,59,13,13,85,14,6,5,53,2,10,17
8470638,2019,24.07,23.31,12,14,200,65,58,323,56,30,10,170,757,46,44
8470642,2019,8.8,8.47,9,12,185,98,92,375,36,15,16,170,0,113,18
8470655,2019,2.38,2.33,4,1,33,10,5,48,6,1,4,32,23,33,5
8470755,2019,9.64,9.09,5,0,75,29,28,132,11,6,12,69,355,77,12
8470775,2019,8,7.65,7,3,67,22,26,115,14,4,10,63,433,117,25
8470794,2019,16.53,15.96,8,9,125,61,49,235,31,14,9,111,349,62,38
8470966,2019,6.43,6.29,11,14,156,73,119,348,30,5,14,151,0,42,36
8471214,2019,34.09,32.04,13,6,311,124,167,602,67,48,23,263,1,184,28
8471215,2019,18.84,18.02,27,22,171,56,66,293,74,25,18,146,441,38,70
8471217,2019,0.5,0.51,0,0,5,0,2,7,1,1,0,4,0,23,0
8471218,2019,18.71,18.12,27,15,180,73,55,308,64,22,20,158,325,102,37
8471228,2019,16.34,15.46,11,7,132,35,51,218,33,15,14,117,4,48,27
8471233,2019,10.44,10.22,8,7,73,32,19,124,24,9,5,64,578,58,36
8471242,2019,3.35,3.12,4,4,75,37,53,165,11,3,3,72,0,61,12
8471260,2019,6.66,6.5,3,6,74,17,30,121,17,8,7,66,42,107,21
8471262,2019,17.06,16.35,9,9,134,44,39,217,35,17,9,117,246,77,28
8471274,2019,3.84,3.68,7,20,101,31,81,213,31,4,9,97,0,90,7
8471276,2019,10.87,10.72,14,16,83,44,36,163,43,13,4,70,373,37,30
8471284,2019,2.93,2.87,4,1,63,23,42,128,7,2,4,61,0,34,8
8471303,2019,3.24,3.17,12,16,117,45,94,256,33,5,4,112,0,106,9
8471392,2019,1.8,1.71,0,3,34,17,22,73,3,0,1,34,0,104,4
8471426,2019,1.41,1.45,0,0,12,6,3,21,1,1,0,11,1,24,1
8471669,2019,19.8,18.69,11,10,136,41,23,200,38,17,16,119,624,63,41
8471675,2019,12.04,11.67,20,10,110,34,20,164,46,16,10,94,494,28,26
8471676,2019,4.82,4.65,2,1,43,24,28,95,8,5,5,38,3,41,12
8471677,2019,2.05,2.02,4,4,63,28,53,144,11,3,4,60,0,183,15
8471685,2019,17.4,16.89,24,17,135,58,50,243,62,21,9,114,775,49,39
8471686,2019,1.61,1.58,4,5,46,15,26,87,11,2,1,44,0,69,19
8471698,2019,24.1,21.23,15,8,134,72,42,248,49,26,14,108,120,91,42
8471699,2019,6.89,6.61,9,2,67,20,17,104,14,3,3,64,17,86,24
8471702,2019,7.55,7.37,13,11,126,38,68,232,32,8,12,118,0,124,14
8471707,2019,18.85,18.27,4,8,111,49,52,212,31,19,11,92,11,87,24
8471709,2019,3.11,3.04,5,5,74,55,71,200,15,5,5,69,0,37,18
8471716,2019,3.19,3.1,2,1,40,21,15,76,3,0,2,40,38,103,10
8471724,2019,7.98,7.75,14,14,176,58,105,339,43,15,12,161,0,101,31
8471729,2019,1.13,1.12,4,5,44,13,23,80,9,0,1,44,0,71,31
8471735,2019,4.57,4.38,19,20,127,54,89,270,44,5,3,122,0,18,24
8471743,2019,1.34,1.33,1,1,23,2,7,32,3,1,0,22,39,26,3
8471769,2019,0.55,0.55,2,2,18,8,13,39,5,1,2,17,0,20,11
8471794,2019,8.48,7.85,3,4,102,22,30,154,16,9,8,93,15,88,24
8471804,2019,4.51,4.27,3,3,55,16,10,81,10,4,5,51,6,46,4
8471817,2019,7.84,7.32,4,3,61,22,16,99,15,8,13,53,24,316,17
8471873,2019,3.81,3.71,5,9,88,29,50,167,19,5,2,83,0,67,40
8471887,2019,22.37,18.96,8,9,170,39,26,235,35,18,21,152,2,107,12
8472382,2019,2.46,2.4,6,6,60,30,34,124,14,2,3,58,0,30,16
8473412,2019,1.16,1.18,2,1,13,2,10,25,5,2,2,11,48,3,2
8473415,2019,2.34,2.24,1,1,55,34,34,123,2,0,5,55,0,115,4
8473419,2019,23.55,22.66,35,25,185,55,61,301,88,28,12,157,22,55,43
8473422,2019,14.6,13.83,11,10,132,36,31,199,31,10,14,122,160,212,39
8473446,2019,5.28,5.19,6,7,99,40,64,203,16,3,5,96,0,97,32
8473449,2019,7.96,7.94,9,1,82,30,21,133,19,9,6,73,37,55,15
8473453,2019,8.35,7.97,4,2,91,34,23,148,11,5,12,86,45,68,11
8473463,2019,4.9,4.73,4,6,46,9,10,65,14,4,4,42,34,123,13
8473473,2019,10.64,10.19,7,6,83,27,34,144,21,8,7,75,20,197,19
8473485,2019,1.31,1.31,1,0,5,4,3,12,1,0,0,5,0,35,3
8473504,2019,3.54,3.45,2,1,35,15,5,55,6,3,3,32,4,127,12
8473507,2019,8.31,7.82,15,14,158,82,137,377,40,11,11,147,0,177,30
8473512,2019,17.66,17.07,18,14,195,64,59,318,52,20,11,175,657,45,37
8473533,2019,16.01,15.47,11,8,124,44,33,201,27,8,7,116,701,149,30
8473544,2019,9.34,9.19,8,14,110,26,45,181,32,10,6,100,197,115,26
8473546,2019,7.54,7.56,2,1,61,20,17,98,11,8,5,53,0,21,31
8473548,2019,14.03,13.87,14,10,154,55,61,270,38,14,11,140,2,11,18
8473560,2019,1.72,1.71,0,3,39,19,17,75,4,1,4,38,0,97,2
8473563,2019,13.89,13.2,17,26,132,40,47,219,55,12,9,120,515,29,34
8473564,2019,5.51,5.42,4,4,70,28,37,135,14,6,2,64,6,32,32
8473573,2019,11.64,10.85,4,1,87,48,42,177,20,15,12,72,185,6,19
8473604,2019,17.84,17.12,23,19,172,54,59,285,60,18,11,154,854,56,58
8473618,2019,8.17,7.58,2,7,71,25,23,119,16,7,5,64,13,69,17
8473914,2019,0.57,0.58,0,0,5,3,0,8,0,0,0,5,25,3,0
8473986,2019,18.1,17.8,11,11,129,44,35,208,48,26,10,103,5,59,27
8473991,2019,0.11,0.11,0,0,4,0,2,6,0,0,1,4,0,1,0
8473994,2019,20.83,19.64,12,8,162,66,50,278,38,18,12,144,248,167,52
8474000,2019,0.43,0.43,1,1,13,4,11,28,2,0,1,13,0,15,4
8474008,2019,0,0,0,0,0,0,0,0,0,0,0,0,0,0,0
8474009,2019,13.18,12.19,10,7,104,38,26,168,35,18,13,86,487,17,46
8474013,2019,3.9,3.9,9,12,95,40,58,193,25,4,15,91,0,83,18
8474027,2019,2.4,2.36,7,9,70,26,51,147,19,3,1,67,0,91,10
8474031,2019,5.69,5.46,12,13,131,41,74,246,33,8,6,123,0,62,32
8474034,2019,9.77,9.23,5,8,79,26,17,122,22,9,13,70,6,103,14
8474037,2019,19.74,18.91,14,7,150,43,42,235,39,18,19,132,8,25,17
8474038,2019,4.18,4.13,4,2,29,12,5,46,10,4,2,25,1,42,11
8474040,2019,7.03,6.61,4,3,79,30,22,131,13,6,8,73,45,22,12
8474053,2019,13.52,12.78,15,8,126,36,58,220,39,16,17,110,195,55,28
8474056,2019,5.42,5.29,4,7,149,58,84,291,18,7,11,142,0,88,19
8474062,2019,5.48,5.26,6,3,64,10,20,94,14,5,9,59,245,69,25
8474068,2019,7.9,7.63,13,9,88,31,42,161,31,9,8,79,246,18,21
8474090,2019,3.83,3.78,4,1,45,21,21,87,8,3,2,42,1,90,18
8474091,2019,6.89,6.74,7,3,75,22,14,111,17,7,5,68,185,18,15
8474098,2019,9.39,9.31,7,3,110,35,21,166,16,6,14,104,64,90,25
8474102,2019,14.78,14.42,19,15,165,71,83,319,59,25,8,140,3,67,39
8474125,2019,1.08,1.03,3,1,32,5,15,52,6,2,1,30,0,28,3
8474134,2019,1.31,1.3,0,2,45,22,27,94,3,1,0,44,0,37,11
8474141,2019,23.24,22.59,35,17,275,65,124,464,85,33,20,242,1,24,43
8474145,2019,1.77,1.73,2,2,36,14,14,64,6,2,2,34,0,62,2
8474149,2019,23.41,22.71,13,8,165,47,60,272,45,24,16,141,0,29,29
8474150,2019,20.15,18.8,17,10,157,66,62,285,43,16,18,141,371,44,64
8474151,2019,2.13,2.12,7,4,49,34,50,133,12,1,6,48,0,36,25
8474157,2019,24.61,23.57,23,11,306,132,114,552,66,32,20,274,51,90,32
8474161,2019,11.67,11.13,27,15,130,51,69,250,54,12,12,118,7,17,28
8474162,2019,4.05,3.98,7,10,99,35,57,191,23,6,7,93,0,109,25
8474166,2019,2.95,2.84,4,10,76,35,66,177,17,3,4,73,0,43,14
8474176,2019,11.57,11.41,13,4,107,31,16,154,25,8,10,99,13,24,25
8474189,2019,17.55,17,15,8,151,72,48,271,39,16,16,135,536,59,44
8474190,2019,14.86,14.37,10,7,119,31,44,194,25,8,9,111,28,145,27
8474207,2019,3.74,3.62,2,6,101,39,64,204,14,6,3,95,1,129,26
8474218,2019,1.87,1.88,4,7,52,24,28,104,11,0,1,52,0,76,15
8474230,2019,1.19,1.13,0,0,9,4,1,14,1,1,2,8,7,36,1
8474250,2019,3.7,3.62,5,2,43,14,19,76,11,4,4,39,88,112,21
8474291,2019,5.44,5.27,4,2,48,18,6,72,8,2,5,46,399,69,14
8474563,2019,7.96,7.4,12,17,141,61,99,301,36,7,13,134,0,106,15
8474564,2019,21.12,20.22,22,12,173,68,73,314,62,28,14,145,363,69,23
8474565,2019,13.14,12.91,17,17,224,74,111,409,49,15,11,209,0,46,43
8474567,2019,1.86,1.82,4,2,29,10,16,55,7,1,1,28,0,30,4
8474568,2019,0.95,0.93,1,1,31,11,14,56,3,1,2,30,0,83,5
8474569,2019,1.1,1.02,1,3,12,5,3,20,4,0,1,12,3,8,1
8474571,2019,2.13,2.12,1,1,29,5,10,44,4,2,4,27,1,12,1
8474573,2019,11.28,11.12,19,8,94,28,39,161,41,14,3,80,128,20,38
8474574,2019,6.13,6.08,12,3,132,51,78,261,21,6,9,126,0,99,42
8474578,2019,4.95,4.78,20,15,120,43,80,243,41,6,12,114,0,26,52
8474579,2019,1.58,1.55,1,7,49,15,34,98,10,2,3,47,0,91,4
8474581,2019,3.47,3.19,7,12,87,30,82,199,23,4,5,83,0,43,32
8474584,2019,2.57,2.5,6,7,55,31,37,123,15,2,4,53,0,100,9
8474586,2019,16.26,15.76,10,14,136,54,54,244,40,16,11,120,3,37,34
8474589,2019,20.01,18.71,15,6,159,68,45,272,37,16,21,143,7,96,26
8474590,2019,11.4,9.56,39,20,189,83,98,370,74,15,16,174,0,55,42
8474597,2019,0.64,0.6,0,1,18,11,14,43,2,1,0,17,0,45,3
8474600,2019,11.72,11.37,29,21,260,95,170,525,66,16,16,244,0,52,34
8474602,2019,3.89,3.76,3,6,86,40,52,178,12,3,8,83,0,36,6
8474604,2019,0.4,0.39,1,0,11,8,8,27,1,0,0,11,0,17,1
8474611,2019,0.15,0.15,2,1,5,1,1,7,4,1,3,4,0,5,0
8474612,2019,3.52,3.47,5,3,83,36,49,168,11,3,5,80,0,39,21
8474613,2019,14.15,13.79,8,10,160,54,46,260,28,10,7,150,569,43,37
8474618,2019,3.07,3,3,5,75,30,62,167,13,5,2,70,0,77,18
8474628,2019,1.51,1.52,3,2,57,21,32,110,7,2,2,55,0,53,6
8474641,2019,20.02,19.17,10,6,169,71,40,280,42,26,14,143,502,74,26
8474668,2019,1.6,1.58,3,1,15,4,3,22,5,1,2,14,0,70,8
8474673,2019,3.06,2.88,4,11,65,32,68,165,19,4,5,61,0,20,34
8474679,2019,15.11,14.69,18,9,150,35,43,228,42,15,12,135,17,37,28
8474683,2019,12.89,12.42,8,2,94,34,24,152,25,15,8,79,361,54,20
8474685,2019,7.95,7.84,8,5,89,15,37,141,25,12,14,77,12,58,21
8474688,2019,0.54,0.52,0,3,22,13,18,53,3,0,2,22,0,25,3
8474697,2019,3.17,3.11,1,9,63,26,28,117,17,7,6,56,0,199,10
8474709,2019,5.38,5.36,3,0,49,23,22,94,8,5,2,44,3,242,11
8474715,2019,11.27,10.94,9,5,148,31,41,220,26,12,10,136,27,18,26
8474716,2019,8,7.58,10,10,112,50,71,233,32,12,13,100,0,61,10
8474717,2019,0.85,0.82,2,0,29,3,14,46,2,0,1,29,0,13,6
8474722,2019,0.88,0.8,1,1,10,2,1,13,3,1,0,9,0,38,2
8474736,2019,2.41,2.34,1,1,19,6,3,28,5,3,1,16,0,69,5
8474774,2019,0.02,0.02,0,0,2,1,1,4,0,0,0,2,0,3,2
8474818,2019,1.27,1.23,4,2,57,17,40,114,7,1,3,56,0,44,7
8474849,2019,7.76,6.98,3,2,55,22,15,92,12,7,7,48,6,43,7
8474870,2019,12.33,11.64,10,7,113,38,38,189,31,14,17,99,172,62,14
8474873,2019,0.2,0.19,0,1,6,4,1,11,1,0,2,6,0,16,0
8474884,2019,18.67,17.8,15,13,214,73,126,413,57,29,20,185,7,33,31
8475098,2019,10.99,9.86,10,6,108,22,28,158,29,13,6,95,361,32,29
8475149,2019,8.22,7.75,12,8,87,35,31,153,29,9,7,78,195,39,15
8475151,2019,19,18.42,8,11,154,81,49,284,44,25,8,129,11,74,29
8475158,2019,14.36,14.07,26,22,118,37,28,183,60,12,5,106,867,16,68
8475160,2019,10.21,9.97,7,3,110,48,30,188,17,7,14,103,6,133,11
8475163,2019,12.68,11.88,7,6,97,35,26,158,24,11,8,86,0,56,14
8475164,2019,14.43,14.12,13,5,150,65,51,266,39,21,8,129,8,27,40
8475166,2019,23.94,23.04,23,10,197,90,70,357,59,26,21,171,615,32,35
8475167,2019,8.57,8.27,27,17,155,66,84,305,55,11,14,144,0,73,46
8475168,2019,17.14,16.43,16,13,136,49,43,228,42,13,14,123,386,40,31
8475169,2019,28.73,26.87,14,6,215,65,65,345,46,26,20,189,106,134,45
8475170,2019,15.61,15.14,21,13,136,35,49,220,59,25,8,111,345,120,26
8475171,2019,6.55,6.15,7,14,133,55,81,269,30,9,8,124,0,129,19
8475172,2019,11.87,11.82,8,9,133,50,44,227,36,19,9,114,407,60,21
8475176,2019,7.02,6.86,16,13,114,38,77,229,37,8,7,106,0,48,24
8475177,2019,0.85,0.86,2,3,42,14,39,95,6,1,1,41,0,93,9
8475178,2019,11.62,11.44,10,9,99,32,33,164,34,15,8,84,1,157,26
8475179,2019,2.34,2.27,3,5,54,32,55,141,10,2,1,52,0,104,16
8475181,2019,3.26,3.2,9,9,72,46,62,180,21,3,7,69,0,62,17
8475184,2019,19.16,18.52,12,8,156,61,41,258,44,24,13,132,51,116,22
8475186,2019,1.24,1.24,1,0,33,12,23,68,3,2,1,31,0,36,2
8475188,2019,4.42,4.18,4,3,74,46,56,176,9,2,6,72,0,201,32
8475191,2019,22.19,21.22,15,12,169,59,38,266,54,27,16,142,3,55,58
8475193,2019,18.08,17.83,19,21,161,48,54,263,61,21,13,140,9,79,31
8475197,2019,7.94,7.84,16,18,169,65,139,373,39,5,9,164,0,47,16
8475200,2019,5.43,5.34,15,9,105,52,67,224,28,4,6,101,0,106,49
8475204,2019,2.84,2.71,1,1,24,13,16,53,2,0,2,24,6,16,8
8475208,2019,2.22,2.23,4,3,35,18,27,80,8,1,2,34,0,44,13
8475209,2019,6.59,6.55,5,8,67,27,30,124,21,8,1,59,11,75,21
8475218,2019,6.59,6.41,17,8,154,62,81,297,33,8,9,146,0,49,51
8475220,2019,10.74,10.34,8,5,86,29,18,133,24,11,4,75,9,184,31
8475222,2019,3.36,3.25,5,13,95,37,68,200,23,5,4,90,0,50,14
8475224,2019,0.32,0.31,0,0,2,0,0,2,0,0,0,2,4,6,0
8475225,2019,17.93,17.42,5,8,184,66,30,280,31,18,24,166,14,59,26
8475231,2019,8.35,8.31,4,1,67,21,25,113,15,10,5,57,367,133,38
8475233,2019,2.53,2.48,5,6,97,38,58,193,11,0,4,97,0,129,18
8475235,2019,5.32,5.16,4,2,61,24,28,113,13,7,9,54,0,137,10
8475236,2019,7.54,7.28,6,4,61,23,14,98,15,5,6,56,312,49,23
8475246,2019,0.43,0.4,0,0,4,5,3,12,0,0,0,4,0,6,0
8475254,2019,0.49,0.48,0,0,3,2,0,5,0,0,0,3,6,9,1
8475268,2019,2.73,2.62,1,2,33,20,10,63,5,2,2,31,2,125,5
8475279,2019,6.58,6.17,7,5,130,56,108,294,21,9,6,121,0,151,17
8475287,2019,14.08,13.38,4,8,92,42,20,154,24,12,10,80,381,27,21
8475314,2019,23.13,22.56,11,11,193,65,43,301,42,20,9,173,89,102,24
8475324,2019,2.4,2.37,4,4,61,27,60,148,8,0,1,61,0,59,26
8475343,2019,4.9,4.81,2,6,52,19,9,80,15,7,4,45,274,117,22
8475413,2019,2.48,2.44,3,0,29,11,10,50,6,3,2,26,41,25,15
8475430,2019,0.29,0.28,0,0,8,5,3,16,1,1,0,7,0,10,1
8475455,2019,2.96,2.84,6,7,58,27,58,143,14,1,1,57,0,194,16
8475461,2019,0.77,0.77,2,1,10,4,4,18,4,1,2,9,38,25,5
8475462,2019,2.41,2.35,2,10,91,36,63,190,15,3,2,88,0,164,22
8475625,2019,2.2,2.08,1,3,56,28,39,123,4,0,4,56,0,77,7
8475690,2019,2.11,2.1,9,10,45,22,30,97,21,2,3,43,0,32,20
8475692,2019,9.48,9.26,11,11,96,30,38,164,37,15,6,81,9,13,33
8475714,2019,12.1,11.81,10,7,137,44,51,232,33,16,11,121,32,28,19
8475716,2019,1.64,1.6,1,2,28,18,25,71,4,1,1,27,0,22,9
8475718,2019,4.1,4.05,6,10,88,36,60,184,18,2,9,86,0,89,21
8475722,2019,15.25,14.87,13,8,111,42,20,173,41,20,10,91,12,53,31
8475726,2019,20.03,18.89,11,8,203,66,81,350,43,24,25,179,4,48,35
8475728,2019,7.28,7.07,8,5,60,23,16,99,19,6,4,54,323,85,24
8475730,2019,0.93,0.9,1,2,30,13,22,65,5,2,1,28,0,50,5
8475735,2019,5.45,5.09,1,3,39,12,13,64,9,5,4,34,105,69,14
8475738,2019,10.62,9.85,1,6,86,22,29,137,15,8,8,78,96,32,22
8475744,2019,15.1,14.65,20,13,129,36,22,187,52,19,7,110,348,35,22
8475745,2019,17.21,16.94,17,4,145,55,40,240,37,16,10,129,326,82,48
8475747,2019,4.49,4.2,5,3,89,39,44,172,9,1,6,88,0,79,10
8475748,2019,0,0,0,0,0,0,0,0,0,0,0,0,0,0,0
8475750,2019,1.79,1.76,1,4,37,31,29,97,7,2,3,35,0,51,14
8475752,2019,8.27,8.3,9,2,77,26,25,128,20,9,9,68,5,132,28
8475753,2019,6.72,6.55,5,5,143,40,74,257,15,5,9,138,0,81,24
8475754,2019,20.94,20.5,14,13,175,37,60,272,53,26,11,149,611,49,26
8475760,2019,1.7,1.7,1,1,18,10,11,39,3,1,0,17,38,19,3
8475762,2019,0.63,0.6,0,1,22,14,19,55,1,0,1,22,0,35,2
8475763,2019,21.17,20.57,9,9,175,60,46,281,41,23,14,152,412,88,43
8475764,2019,5.76,5.64,7,13,117,26,60,203,29,9,5,108,0,25,21
8475765,2019,3.08,2.95,3,4,26,10,11,47,10,3,2,23,0,17,3
8475766,2019,5.26,5.25,4,4,50,25,14,89,14,6,1,44,6,131,18
8475768,2019,24.58,24.11,21,15,160,66,54,280,57,21,13,139,9,58,50
8475772,2019,9.92,9.84,5,3,69,23,15,107,16,8,4,61,403,25,36
8475780,2019,10.11,10.06,3,1,78,38,23,139,10,6,5,72,115,192,16
8475784,2019,16.15,15.82,6,3,182,51,57,290,23,14,15,168,31,29,28
8475786,2019,20.13,19.27,8,8,104,41,42,187,36,20,8,84,71,52,32
8475790,2019,2.42,2.37,4,2,77,35,50,162,9,3,4,74,0,89,0
8475791,2019,21.91,21.23,28,8,232,78,78,388,52,16,18,216,20,49,41
8475792,2019,9.85,9.34,4,9,117,28,47,192,32,19,8,98,6,55,27
8475793,2019,12,10.79,7,15,101,36,21,158,36,14,12,87,550,39,39
8475794,2019,22.86,22.07,19,13,245,60,90,395,49,17,26,228,537,90,34
8475795,2019,0.48,0.45,0,0,14,7,12,33,0,0,0,14,0,48,4
8475796,2019,6.1,5.95,5,3,63,14,27,104,17,9,6,54,3,44,26
8475797,2019,0.71,0.71,3,1,20,12,20,52,5,1,0,19,0,71,1
8475798,2019,17.12,16.48,6,6,129,47,39,215,28,16,7,113,73,42,24
8475799,2019,15.27,14.42,9,9,115,59,42,216,29,11,14,104,1,52,35
8475807,2019,4.54,4.5,2,1,49,19,20,88,7,4,2,45,1,91,12
8475808,2019,0.17,0.18,0,0,2,0,0,2,0,0,1,2,7,3,0
8475810,2019,21.31,20.24,15,13,151,50,43,244,55,27,17,124,2,71,29
8475820,2019,14.29,13.84,10,7,110,31,40,181,33,16,7,94,9,25,28
8475825,2019,0.13,0.13,0,0,3,3,4,10,0,0,1,3,0,11,0
8475832,2019,2.42,2.47,2,1,28,8,10,46,6,3,2,25,0,31,4
8475834,2019,8.95,8.7,8,3,77,23,23,123,18,7,12,70,3,56,28
8475841,2019,1.34,1.31,1,3,44,20,30,94,5,1,5,43,0,16,10
8475842,2019,0.89,0.89,0,1,16,7,3,26,2,1,0,15,33,13,1
8475848,2019,26.64,25.52,12,9,228,82,85,395,44,23,26,205,12,53,39
8475855,2019,10.59,10.18,8,10,84,34,12,130,30,12,10,72,9,125,24
8475857,2019,0.03,0.03,0,0,2,0,1,3,0,0,0,2,0,2,0
8475868,2019,1.38,1.36,2,5,54,24,27,105,7,0,3,54,0,145,16
8475869,2019,0.77,0.77,0,0,17,6,12,35,0,0,2,17,0,24,3
8475902,2019,0.41,0.39,0,0,11,6,12,29,0,0,0,11,0,21,0
8475906,2019,5.65,5.35,15,10,121,53,116,290,32,7,10,114,0,28,24
8475907,2019,1.04,1.06,3,1,15,2,2,19,5,1,1,14,2,40,2
8475913,2019,17.78,17.28,28,14,169,59,47,275,63,21,16,148,16,56,77
8475958,2019,0.1,0.1,0,0,1,2,1,4,0,0,0,1,3,3,2
8476043,2019,0.19,0.18,0,1,4,0,2,6,1,0,0,4,5,3,0
8476166,2019,1.68,1.66,5,2,40,17,25,82,9,2,3,38,0,16,2
8476195,2019,0.69,0.66,0,1,5,3,3,11,1,0,0,5,0,3,5
8476207,2019,0.61,0.59,0,0,9,4,3,16,0,0,0,9,0,7,8
8476278,2019,2.59,2.52,5,2,31,11,11,53,10,3,3,28,37,43,6
8476285,2019,1.12,1.07,1,1,7,7,8,22,2,0,1,7,43,15,0
8476288,2019,13.1,12.64,14,6,98,39,41,178,28,8,4,90,9,36,15
8476292,2019,17.01,16.53,15,10,126,43,49,218,42,17,7,109,7,144,41
8476293,2019,0.43,0.43,1,0,8,3,1,12,2,1,0,7,0,3,5
8476312,2019,2.54,2.44,2,6,59,29,39,127,9,1,2,58,0,108,20
8476326,2019,8.12,8.14,8,1,63,33,22,118,21,12,1,51,0,164,25
8476329,2019,2.51,2.49,5,2,27,8,2,37,10,3,2,24,50,14,7
8476331,2019,2.02,1.97,6,5,74,27,46,147,11,0,8,74,0,105,9
8476344,2019,1.57,1.57,0,0,5,1,3,9,2,2,0,3,8,6,1
8476346,2019,18.1,17.72,25,15,209,63,77,349,58,18,15,191,1,1,40
8476356,2019,10.39,9.53,5,1,77,32,20,129,10,4,10,73,11,30,17
8476368,2019,0.03,0.03,1,0,1,0,1,2,2,1,0,0,0,5,1
8476372,2019,0.53,0.48,0,1,5,6,6,17,1,0,0,5,0,19,1
8476374,2019,7.78,7.41,9,7,96,40,31,167,22,6,5,90,255,145,28
8476381,2019,5.01,4.53,3,4,46,15,8,69,10,3,7,43,42,74,12
8476389,2019,13.93,13.57,17,10,140,49,47,236,38,11,8,129,427,101,52
8476391,2019,0.77,0.79,1,1,7,3,3,13,2,0,1,7,3,7,5
8476392,2019,9.06,8.24,3,3,67,23,21,111,9,3,4,64,345,137,31
8476393,2019,11.71,11.2,10,5,115,30,35,180,25,10,13,105,35,90,29
8476396,2019,0.15,0.16,0,0,2,1,1,4,0,0,0,2,4,4,2
8476399,2019,20.86,20.43,5,6,201,51,54,306,33,22,3,179,47,190,48
8476400,2019,2.18,2.21,2,0,20,10,6,36,5,3,2,17,11,24,2
8476404,2019,1.23,1.23,1,0,14,3,2,19,1,0,1,14,4,20,1
8476406,2019,3.12,3.08,2,1,45,18,14,77,6,3,2,42,210,55,14
8476409,2019,0.91,0.88,0,0,12,2,4,18,1,1,0,11,1,6,2
8476410,2019,6.9,6.72,6,7,68,36,38,142,19,6,5,62,10,17,10
8476419,2019,18.55,17.71,9,7,152,55,38,245,42,26,13,126,615,128,33
8476422,2019,3.76,3.64,6,10,85,47,58,190,17,1,8,84,0,39,9
8476428,2019,11.22,11.36,12,9,122,39,32,193,31,10,14,112,1,23,27
8476429,2019,3.76,3.67,5,4,97,48,92,237,14,5,4,92,0,93,21
8476430,2019,0.89,0.87,2,0,7,9,4,20,2,0,2,7,2,4,6
8476432,2019,15.97,15.03,7,6,179,50,43,272,24,11,16,168,642,109,24
8476437,2019,3.07,2.96,3,5,38,13,12,63,13,5,1,33,119,26,13
8476438,2019,21.27,19.44,8,4,140,41,33,214,33,21,13,119,22,36,40
8476439,2019,2.89,2.98,3,1,34,12,11,57,6,2,1,32,2,89,3
8476440,2019,3.89,3.79,0,1,26,8,9,43,4,3,4,23,25,14,11
8476441,2019,5.04,4.83,5,8,97,31,51,179,20,7,11,90,0,118,23
8476442,2019,8.72,8.64,8,5,85,30,26,141,21,8,5,77,2,37,19
8476443,2019,0.35,0.34,2,1,8,7,13,28,3,0,0,8,0,24,1
8476447,2019,0.16,0.17,0,0,2,1,2,5,1,1,0,1,0,9,1
8476448,2019,18.01,17.12,19,12,138,55,59,252,46,15,11,123,492,40,54
8476449,2019,1.61,1.57,3,4,37,20,16,73,8,1,1,36,0,46,5
8476453,2019,19.63,19.51,27,23,209,90,85,384,82,32,14,177,0,37,30
8476454,2019,18.13,17.57,23,16,172,56,76,304,61,22,16,150,205,33,54
8476455,2019,20,19.48,16,8,144,68,41,253,44,20,13,124,272,86,39
8476456,2019,15.76,14.8,37,16,149,61,60,270,75,22,10,127,24,51,40
8476457,2019,2.4,2.34,2,3,58,33,33,124,6,1,4,57,0,112,16
8476458,2019,18.35,17.9,27,14,155,51,36,242,59,18,18,137,496,45,27
8476459,2019,22.63,21.65,21,12,208,77,66,351,74,41,5,167,593,51,42
8476460,2019,26.8,25.15,27,16,169,66,51,286,72,29,17,140,605,34,57
8476461,2019,22.78,22.04,16,21,183,65,57,305,59,22,19,161,541,59,39
8476462,2019,10.23,9.25,13,13,170,72,98,340,40,14,19,156,0,52,22
8476463,2019,3.71,3.66,12,14,103,38,53,194,28,2,6,101,0,41,14
8476466,2019,1.15,1.05,2,0,7,4,4,15,2,0,1,7,0,5,1
8476467,2019,2.93,2.82,4,3,76,30,43,149,10,3,6,73,0,153,24
8476468,2019,18.91,17.88,25,20,164,77,46,287,72,27,12,137,420,123,52
8476469,2019,18.89,18.13,9,5,155,52,58,265,30,16,15,139,4,146,47
8476470,2019,1.35,1.24,4,3,38,17,20,75,8,1,4,37,0,62,6
8476472,2019,5.75,5.44,9,19,159,62,93,314,33,5,6,154,0,45,36
8476473,2019,3.87,3.8,8,6,117,34,85,236,19,5,6,112,0,128,17
8476474,2019,6.71,6.31,1,1,67,23,10,100,9,7,5,60,7,74,16
8476479,2019,16.87,16.23,16,18,131,40,38,209,47,13,9,118,728,119,34
8476480,2019,15.14,14.72,8,5,98,35,35,168,30,17,10,81,22,108,25
8476483,2019,19.53,19.11,15,12,184,74,53,311,42,15,15,169,10,81,29
8476525,2019,2.8,2.73,6,4,79,36,59,174,11,1,7,78,0,87,9
8476539,2019,22.21,20.88,19,6,235,52,100,387,47,22,17,213,58,99,37
8476624,2019,13,12.48,9,9,102,30,29,161,26,8,9,94,394,161,44
8476779,2019,4.37,4.29,7,4,106,32,45,183,19,8,8,98,0,12,15
8476792,2019,7.75,7.53,21,16,145,43,86,274,47,10,6,135,0,36,22
8476807,2019,0.62,0.6,0,3,14,7,5,26,3,0,0,14,0,27,2
8476822,2019,9.4,9.04,3,0,76,29,18,123,9,6,5,70,393,147,10
8476826,2019,13.42,12.99,9,10,110,32,34,176,29,10,11,100,94,77,48
8476850,2019,2.07,2.05,4,3,32,8,24,64,9,2,3,30,0,12,6
8476851,2019,8.49,7.91,12,4,86,24,31,141,24,8,10,78,67,51,5
8476853,2019,4.72,4.67,13,12,122,67,70,259,27,2,3,120,0,38,17
8476854,2019,3.48,3.41,9,12,109,44,84,237,23,2,5,107,0,34,20
8476856,2019,7.55,7.23,10,8,167,82,121,370,24,6,10,161,0,98,20
8476857,2019,0.19,0.18,0,0,4,0,1,5,0,0,0,4,0,1,1
8476858,2019,1.78,1.72,2,3,35,3,12,50,6,1,2,34,0,38,3
8476867,2019,0.05,0.05,1,0,0,1,0,1,1,0,0,0,0,2,0
8476869,2019,5.81,5.61,3,12,139,38,61,238,23,8,6,131,0,103,36
8476870,2019,1.87,1.66,0,1,18,9,2,29,3,2,1,16,0,27,2
8476871,2019,16.95,16.37,11,11,162,47,42,251,42,20,11,142,4,96,37
8476872,2019,7.61,7.01,8,7,73,16,32,121,27,12,3,61,146,108,22
8476873,2019,5.25,5.21,1,1,38,26,17,81,7,5,6,33,190,14,32
8476874,2019,2.93,2.77,6,7,80,26,63,169,17,4,8,76,0,119,22
8476875,2019,5.17,5.01,4,8,102,45,67,214,20,8,12,94,0,43,41
8476878,2019,10.56,10.2,4,3,84,28,31,143,19,12,5,72,30,110,13
8476879,2019,2.5,2.44,3,3,48,34,35,117,7,1,3,47,0,92,13
8476880,2019,22.87,21.7,12,11,152,49,51,252,44,21,16,131,18,254,25
8476881,2019,17.93,16.87,12,8,117,39,42,198,36,16,19,101,431,29,25
8476882,2019,16.81,16.23,30,16,183,66,68,317,61,15,12,168,26,18,44
8476884,2019,0.01,0.01,0,0,1,0,2,3,0,0,0,1,0,2,0
8476885,2019,9.23,8.98,8,12,167,66,100,333,27,7,11,160,0,173,43
8476886,2019,2.27,2.28,3,6,47,27,43,117,10,1,1,46,0,64,9
8476887,2019,20.04,19.67,19,7,200,74,94,368,48,22,12,178,1,82,58
8476889,2019,13.86,13.16,6,3,109,47,41,197,20,11,13,98,405,84,34
8476891,2019,4.89,4.87,9,8,112,38,59,209,21,4,4,108,0,56,22
8476892,2019,6.24,6.03,3,14,158,58,63,279,27,10,8,148,0,87,33
8476894,2019,5.24,5.08,4,4,50,24,26,100,11,3,2,47,9,57,8
8476897,2019,12.87,12.41,7,4,95,36,33,164,23,12,10,83,104,60,36
8476902,2019,5.06,4.92,10,10,98,33,70,201,23,3,8,95,0,89,31
8476905,2019,8.28,8.17,9,6,72,41,18,131,26,11,5,61,234,51,37
8476906,2019,3.08,2.95,0,7,73,32,42,147,12,5,6,68,0,14,9
8476907,2019,6.05,5.7,1,2,62,12,12,86,10,7,9,55,1,82,14
8476913,2019,4.33,4.23,4,2,50,20,10,80,11,5,5,45,47,52,12
8476915,2019,6.27,6.13,4,1,70,21,29,120,11,6,6,64,34,136,15
8476917,2019,2.1,2.01,2,6,50,21,45,116,9,1,1,49,0,81,32
8476918,2019,11.25,10.95,4,7,93,44,26,163,20,9,7,84,0,43,26
8476919,2019,13.15,12.87,16,10,102,41,38,181,37,11,10,91,521,44,32
8476921,2019,4.66,4.53,9,3,44,28,23,95,14,2,2,42,66,72,24
8476922,2019,0.11,0.12,0,0,2,2,3,7,0,0,0,2,14,3,1
8476923,2019,8.7,7.86,13,11,114,35,72,221,31,7,5,107,0,81,35
8476924,2019,2.66,2.57,1,1,26,21,11,58,8,6,1,20,0,14,2
8476925,2019,5.79,5.67,5,1,52,28,12,92,15,9,3,43,283,84,15
8476927,2019,8.42,8.3,7,5,102,24,31,157,21,9,8,93,402,83,29
8476931,2019,2.43,2.41,5,5,75,27,46,148,13,3,6,72,1,91,19
8476934,2019,9.28,9.01,7,2,93,34,31,158,16,7,4,86,15,80,19
8476941,2019,0.99,0.97,1,3,25,9,17,51,5,1,2,24,0,27,5
8476947,2019,5.78,5.52,7,2,63,18,32,113,13,4,10,59,101,38,19
8476948,2019,1.49,1.46,0,1,22,9,11,42,2,1,2,21,1,25,5
8476952,2019,5.08,4.63,4,2,38,13,10,61,10,4,6,34,126,57,17
8476953,2019,0.02,0.02,0,0,1,1,1,3,0,0,0,1,0,1,0
8476958,2019,6.14,5.91,14,15,145,61,86,292,35,6,3,139,0,43,81
8476960,2019,13.84,13.34,9,7,129,46,33,208,27,11,10,118,43,36,15
8476966,2019,0.52,0.51,0,0,1,0,0,1,1,1,0,0,13,1,1
8476967,2019,3.33,3.32,3,3,101,26,62,189,6,0,4,101,0,59,13
8476974,2019,0.04,0.04,0,0,2,1,0,3,0,0,1,2,0,4,0
8476975,2019,10.23,9.89,6,5,77,31,26,134,18,7,6,70,306,172,17
8476979,2019,7.06,6.76,11,12,103,55,96,254,29,6,5,97,0,86,21
8476981,2019,6.61,6.41,2,1,63,20,15,98,4,1,4,62,7,68,9
8476983,2019,0.06,0.06,0,1,2,1,3,6,1,0,0,2,0,2,1
8476987,2019,0.11,0.11,0,0,6,1,3,10,0,0,0,6,0,8,0
8476988,2019,1.21,1.16,5,2,38,20,23,81,8,1,2,37,0,78,12
8476994,2019,8.69,8.66,5,12,132,30,47,209,22,5,5,127,26,52,30
8477003,2019,0.54,0.48,0,0,6,1,4,11,0,0,0,6,1,15,0
8477010,2019,1.36,1.43,3,0,12,4,5,21,5,2,0,10,33,26,8
8477015,2019,18.62,17.77,13,14,172,65,49,286,43,16,18,156,29,39,52
8477018,2019,4.09,3.94,4,8,114,39,71,224,16,4,9,110,0,51,12
8477021,2019,12.73,12.41,11,8,87,40,24,151,28,9,7,78,191,48,28
8477038,2019,14.82,14.35,18,13,157,51,61,269,44,13,10,144,1,12,22
8477043,2019,0.35,0.33,1,1,12,4,9,25,3,1,1,11,0,2,2
8477046,2019,1.94,1.89,2,2,53,19,26,98,5,1,3,52,0,24,6
8477073,2019,1.77,1.72,1,3,51,22,35,108,7,3,5,48,0,95,5
8477085,2019,0.01,0.01,0,0,1,0,0,1,0,0,0,1,0,0,0
8477126,2019,0.13,0.14,0,0,4,1,2,7,0,0,1,4,0,10,0
8477149,2019,2.54,2.47,2,2,29,14,6,49,6,2,1,27,0,74,5
8477210,2019,1,0.92,0,0,6,3,5,14,1,1,1,5,0,14,2
8477213,2019,5.08,4.99,0,1,49,18,18,85,6,5,4,44,7,51,13
8477215,2019,0.77,0.76,1,3,12,7,4,23,4,0,2,12,0,6,0
8477220,2019,5.09,4.94,12,12,112,31,82,225,31,7,6,105,0,25,33
8477240,2019,7.31,7.29,9,1,63,31,19,113,18,8,5,55,47,189,24
8477244,2019,1.37,1.26,0,4,44,15,25,84,6,2,1,42,0,74,7
8477290,2019,7.83,7.64,8,2,67,16,11,94,19,9,3,58,99,72,19
8477320,2019,0.43,0.45,0,0,9,4,0,13,0,0,0,9,0,20,2
8477330,2019,19.16,18.59,11,6,156,55,59,270,47,30,11,126,6,79,23
8477337,2019,0.48,0.48,0,0,5,2,3,10,0,0,0,5,0,3,0
8477341,2019,9.74,9.4,6,7,79,21,28,128,22,9,5,70,0,43,13
8477343,2019,0.03,0.03,0,0,2,0,4,6,0,0,0,2,0,13,1
8477346,2019,4.26,4.09,5,6,77,21,34,132,18,7,7,70,0,75,24
8477353,2019,3.2,3.1,3,1,37,20,18,75,8,4,2,33,7,117,15
8477355,2019,3.25,3.17,7,11,62,42,44,148,22,4,6,58,0,31,10
8477359,2019,2.82,2.67,5,7,64,40,45,149,16,4,1,60,0,58,14
8477365,2019,1.03,1.03,0,0,20,11,23,54,2,2,0,18,0,90,12
8477366,2019,0.02,0.02,0,0,1,0,0,1,0,0,0,1,16,6,0
8477369,2019,2.79,2.74,6,2,61,24,27,112,15,7,1,54,1,69,17
8477380,2019,0.33,0.3,1,0,5,0,1,6,1,0,0,5,0,3,0
8477384,2019,2.3,1.97,1,4,46,21,28,95,8,3,3,43,0,77,10
8477401,2019,2.73,2.75,0,1,39,13,16,68,4,3,0,36,4,87,13
8477402,2019,16.36,15.88,15,14,149,55,52,256,46,17,12,132,4,80,38
8477404,2019,14.7,14.34,17,8,126,31,38,195,45,20,13,106,22,46,21
8477406,2019,8.65,8.43,7,8,87,32,33,152,21,6,5,81,30,22,27
8477407,2019,20.63,20.15,11,6,184,59,71,314,40,23,13,161,3,53,18
8477409,2019,5.62,5.39,2,2,50,24,16,90,11,7,2,43,14,28,18
8477416,2019,16.08,15.35,11,5,162,58,55,275,37,21,13,141,6,43,32
8477417,2019,0.02,0.02,1,0,0,1,1,2,1,0,0,0,1,2,3
8477425,2019,14.14,13.76,10,3,141,41,39,221,24,11,11,130,0,102,15
8477426,2019,9.46,9.11,6,5,104,41,40,185,20,9,12,95,189,122,27
8477429,2019,13.41,12.52,8,7,122,37,45,204,26,11,5,111,310,59,38
8477435,2019,6.66,6.47,6,11,135,46,81,262,26,9,11,126,0,112,19
8477444,2019,8.89,8.63,14,12,102,32,48,182,45,19,3,83,5,26,27
8477447,2019,10.1,9.84,12,21,218,95,144,457,46,13,23,205,0,20,56
8477448,2019,0.14,0.13,0,0,2,1,0,3,0,0,0,2,0,5,1
8477450,2019,9.69,9.56,7,5,85,28,30,143,21,9,6,76,193,89,47
8477451,2019,10.72,10.53,7,4,113,34,41,188,20,9,13,104,83,44,34
8477454,2019,4.99,4.84,3,0,63,18,25,106,5,2,3,61,20,142,5
8477455,2019,4.17,3.82,4,3,46,13,11,70,9,2,4,44,118,120,13
8477456,2019,9.23,8.97,12,8,106,33,39,178,31,11,5,95,340,36,22
8477458,2019,1.72,1.65,1,2,19,5,7,31,4,1,1,18,0,20,5
8477462,2019,2.01,2,4,6,36,25,35,96,13,3,3,33,0,136,6
8477463,2019,0.01,0.01,0,0,1,1,0,2,0,0,0,1,0,3,0
8477464,2019,1.75,1.79,2,1,19,12,8,39,3,0,2,19,1,7,4
8477467,2019,0.08,0.08,0,0,2,2,2,6,0,0,0,2,0,1,0
8477472,2019,0.43,0.41,0,1,9,5,17,31,1,0,1,9,0,5,4
8477473,2019,0.03,0.03,0,0,1,0,0,1,0,0,0,1,0,4,0
8477474,2019,3.15,2.96,6,8,70,30,33,133,17,3,5,67,0,53,14
8477476,2019,15.79,15.36,11,3,140,55,55,250,27,13,12,127,12,120,30
8477478,2019,9.65,9.39,11,1,99,31,27,157,19,7,11,92,9,213,22
8477479,2019,20.12,18.74,18,9,129,55,38,222,48,21,11,108,4,71,25
8477482,2019,10.96,10.76,7,7,91,37,30,158,29,15,9,76,1,106,18
8477488,2019,5.69,5.24,8,6,104,48,70,222,18,4,4,100,0,22,42
8477492,2019,24.76,24.57,36,21,319,88,145,552,93,36,22,283,363,51,38
8477493,2019,19.01,18.01,22,21,170,56,39,265,63,20,15,150,643,21,51
8477494,2019,4.22,4.16,5,3,52,17,14,83,15,7,2,45,4,25,12
8477495,2019,5.35,5.24,13,11,125,43,75,243,30,6,3,119,0,62,29
8477496,2019,16.74,16.04,13,11,170,46,56,272,53,29,8,141,395,92,38
8477497,2019,23.01,22.18,13,13,166,58,53,277,48,22,15,144,549,65,43
8477498,2019,7.1,6.96,12,16,169,62,97,328,33,5,6,164,0,170,26
8477499,2019,7.67,7.38,17,9,129,38,48,215,33,7,5,122,0,203,17
8477500,2019,26.22,25.09,19,12,176,45,47,268,53,22,16,154,842,54,28
8477501,2019,11.69,11.71,5,8,114,36,31,181,27,14,7,100,2,84,38
8477502,2019,0,0,0,0,0,0,0,0,0,0,0,0,0,2,1
8477503,2019,18.8,18.24,21,7,179,62,81,322,45,17,14,162,383,32,42
8477504,2019,5.36,5.16,11,14,120,51,87,258,30,5,10,115,0,34,22
8477505,2019,6.27,6.21,7,9,72,22,17,111,21,5,4,67,310,21,20
8477506,2019,5.49,5.27,12,14,163,52,99,314,36,10,10,153,0,110,15
8477507,2019,3.06,3.08,2,8,64,46,51,161,13,3,5,61,0,175,22
8477508,2019,5.87,5.53,4,1,33,19,8,60,10,5,3,28,185,70,13
8477509,2019,1.94,1.93,1,4,29,22,22,73,7,2,3,27,0,63,9
8477511,2019,14.06,13.64,15,7,136,54,45,235,38,16,12,120,16,49,22
8477512,2019,4.84,4.64,3,2,42,8,13,63,12,7,2,35,209,66,7
8477520,2019,0.01,0.01,0,0,0,1,0,1,0,0,0,0,1,3,0
8477527,2019,3.37,3.06,1,0,16,6,3,25,4,3,2,13,1,93,2
8477529,2019,0.55,0.56,0,0,5,3,4,12,1,1,0,4,36,17,3
8477541,2019,0.38,0.37,1,2,17,2,14,33,4,1,2,16,0,20,1
8477573,2019,0.59,0.58,1,0,6,2,2,10,2,1,0,5,1,10,0
8477810,2019,0.09,0.09,1,1,4,3,3,10,2,0,0,4,0,3,0
8477839,2019,9.73,9.56,8,5,102,38,27,167,23,10,6,92,2,28,19
8477845,2019,1.62,1.57,2,5,58,20,35,113,8,1,5,57,0,21,13
8477846,2019,9.92,9.82,7,5,80,31,16,127,15,3,5,77,265,117,29
8477850,2019,0.44,0.34,0,1,13,4,14,31,2,1,0,12,0,38,1
8477851,2019,2.63,2.56,7,3,70,35,55,160,13,3,3,67,0,48,11
8477887,2019,0.33,0.22,0,0,2,0,1,3,1,1,0,1,0,6,0
8477901,2019,1.1,1.08,0,0,14,5,3,22,1,1,0,13,0,10,8
8477903,2019,11.16,11.11,5,3,80,28,30,138,17,9,11,71,9,189,21
8477922,2019,6.77,6.57,2,4,56,18,22,96,12,6,5,50,14,38,26
8477930,2019,6.26,6.23,9,5,85,22,31,138,23,9,2,76,419,43,53
8477931,2019,11.02,10.74,2,5,92,28,33,153,15,8,11,84,215,91,22
8477932,2019,6.65,6.54,22,13,147,40,78,265,40,5,6,142,0,32,36
8477933,2019,16.65,16.24,17,11,143,82,44,269,49,21,9,122,40,36,21
8477934,2019,30.47,29.51,39,27,218,83,98,399,109,43,16,175,661,27,60
8477935,2019,8.99,8.75,4,0,83,37,30,150,12,8,10,75,89,101,19
8477936,2019,5.92,5.73,4,2,59,14,9,82,10,4,4,55,5,81,10
8477937,2019,14.56,14.03,11,6,149,55,36,240,35,18,19,131,5,102,36
8477938,2019,3.44,3.26,6,4,66,30,56,152,14,4,8,62,0,48,17
8477939,2019,22.66,21.92,18,11,196,54,44,294,59,30,16,166,106,9,42
8477940,2019,18.25,16.56,21,12,202,60,82,344,58,25,11,177,0,36,33
8477941,2019,10.9,10.53,8,3,78,41,19,138,20,9,7,69,1,102,11
8477942,2019,16.98,16.68,19,10,175,57,80,312,52,23,11,152,2,25,33
8477943,2019,4.67,4.53,2,1,48,24,27,99,4,1,3,47,0,22,7
8477944,2019,17.47,16.84,19,8,187,75,50,312,52,25,14,162,6,29,31
8477946,2019,21.34,20.59,16,16,223,67,95,385,51,19,15,204,711,52,43
8477947,2019,5.83,5.63,9,7,73,15,18,106,23,7,2,66,0,26,22
8477948,2019,7.01,6.67,9,8,108,35,81,224,25,8,9,100,0,40,22
8477949,2019,8.84,8.63,6,3,99,41,30,170,17,8,7,91,8,58,27
8477950,2019,7.25,6.95,19,19,149,49,67,265,53,15,15,134,0,48,16
8477951,2019,10.51,10.25,20,14,95,37,56,188,45,11,8,84,159,12,52
8477952,2019,10.2,9.85,10,7,111,28,31,170,32,15,6,96,27,75,13
8477953,2019,11.28,10.99,11,12,120,41,52,213,36,13,6,107,2,73,36
8477955,2019,12.46,12.16,10,11,150,50,49,249,35,14,9,136,265,90,33
8477956,2019,29.94,29.28,30,17,278,100,128,506,95,48,16,230,7,47,49
8477958,2019,0,0,0,0,0,0,0,0,0,0,0,0,0,1,0
8477960,2019,14.23,13.78,13,6,149,60,54,263,31,12,10,137,92,71,24
8477961,2019,1.18,1.15,0,0,14,3,2,19,0,0,1,14,3,21,2
8477962,2019,10.74,10.49,8,4,86,43,39,168,18,6,6,80,19,164,15
8477963,2019,3.11,3.1,4,3,26,8,5,39,10,3,4,23,4,65,11
8477964,2019,10.32,10.04,12,3,74,37,20,131,26,11,7,63,146,141,32
8477969,2019,2.96,2.9,9,11,79,38,76,193,22,2,3,77,0,105,17
8477971,2019,0.36,0.35,3,0,10,3,10,23,3,0,1,10,0,58,4
8477972,2019,0.11,0.12,0,0,3,1,0,4,0,0,1,3,0,3,1
8477973,2019,2.32,2.26,6,1,32,10,22,64,8,1,3,31,57,34,18
8477974,2019,0.99,0.91,0,1,13,1,1,15,1,0,2,13,10,8,3
8477979,2019,4.67,4.49,6,2,48,20,20,88,15,7,5,41,1,81,13
8477983,2019,0.6,0.61,0,0,3,1,0,4,1,1,0,2,3,0,2
8477986,2019,3.99,3.91,6,7,85,33,34,152,18,5,3,80,0,60,12
8477987,2019,10.95,10.69,2,7,96,52,38,186,23,14,6,82,40,53,21
8477989,2019,21.44,20.64,15,5,134,41,45,220,38,18,16,116,523,38,20
8477998,2019,15.38,14.45,10,7,129,40,39,208,30,13,18,116,18,64,39
8478010,2019,19.11,18.57,27,12,138,68,68,274,62,23,13,115,395,24,30
8478013,2019,0.02,0.02,0,0,1,0,0,1,0,0,0,1,0,0,0
8478017,2019,0.03,0.03,1,0,2,0,4,6,1,0,0,2,0,8,1
8478020,2019,10.14,9.77,5,6,99,23,42,164,17,6,11,93,233,21,31
8478021,2019,0.19,0.19,0,0,8,4,7,19,0,0,0,8,0,4,0
8478027,2019,10.08,9.8,7,6,84,32,27,143,25,12,6,72,377,57,22
8478029,2019,0.12,0.14,0,0,1,1,0,2,0,0,0,1,0,1,0
8478036,2019,3.86,3.54,2,0,36,11,10,57,4,2,4,34,96,59,6
8478038,2019,5.18,5.08,7,15,123,39,98,260,28,6,7,117,0,55,33
8478040,2019,0,0,0,0,0,0,0,0,0,0,0,0,0,0,0
8478042,2019,12.84,12.29,8,6,126,71,65,262,28,14,10,112,11,27,15
8478043,2019,4.76,4.6,5,3,55,18,11,84,13,5,11,50,118,94,17
8478046,2019,11.53,10.89,7,9,108,30,44,182,26,10,3,98,5,35,19
8478056,2019,0.51,0.49,1,0,4,1,1,6,1,0,1,4,13,5,1
8478058,2019,0.06,0.06,0,0,0,1,0,1,0,0,0,0,1,1,0
8478067,2019,8.84,8.65,5,1,73,23,28,124,17,11,5,62,13,31,15
8478073,2019,0.02,0.02,0,1,1,1,2,4,1,0,0,1,0,5,0
8478074,2019,0.29,0.29,0,0,5,1,1,7,1,1,0,4,0,13,1
8478075,2019,7.53,7.58,5,5,66,36,32,134,19,9,6,57,2,43,21
8478099,2019,15.93,15.43,9,10,176,67,61,304,33,14,16,162,2,46,33
8478104,2019,5.91,5.65,4,2,54,19,11,84,12,6,7,48,0,154,12
8478106,2019,0.71,0.73,1,1,10,2,0,12,3,1,1,9,0,0,2
8478109,2019,13.86,13.53,11,11,127,57,44,228,42,20,8,107,1,10,12
8478115,2019,8.61,8.45,6,1,71,33,29,133,15,8,4,63,41,29,15
8478131,2019,9.65,9.38,11,6,144,54,52,250,24,7,9,137,6,13,41
8478133,2019,1.4,1.32,0,1,14,5,6,25,3,2,0,12,29,16,5
8478136,2019,0.28,0.27,2,0,9,4,3,16,2,0,1,9,0,18,1
8478146,2019,3.61,3.57,2,2,35,9,17,61,6,2,4,33,1,38,15
8478176,2019,0.11,0.11,0,2,6,2,4,12,2,0,0,6,0,14,2
8478211,2019,2.16,2.11,2,2,33,7,8,48,4,0,6,33,0,37,4
8478233,2019,16.53,16.18,13,2,109,51,45,205,32,17,7,92,12,73,38
8478366,2019,16.14,15.74,9,9,159,37,39,235,34,16,10,143,12,100,31
8478367,2019,1.12,1.1,1,0,10,3,2,15,2,1,0,9,21,21,4
8478396,2019,6.17,6.05,9,8,132,74,63,269,22,5,6,127,0,82,38
8478397,2019,4.91,4.78,8,9,123,42,52,217,22,5,12,118,0,51,19
8478398,2019,31.92,30.64,23,12,239,63,66,368,73,38,16,201,2,18,43
8478399,2019,1.33,1.29,5,2,49,17,44,110,9,2,1,47,0,51,13
8478400,2019,8.75,7.98,6,10,82,32,35,149,23,7,10,75,275,47,23
8478401,2019,10.72,10.58,17,7,97,32,25,154,32,8,7,89,283,62,34
8478402,2019,24.76,24.14,38,25,211,52,74,337,97,34,13,177,319,37,53
8478403,2019,22.76,22.27,19,24,227,79,90,396,79,36,11,191,615,40,44
8478407,2019,6.41,6.35,9,5,135,35,95,265,23,9,2,126,0,50,12
8478408,2019,2.66,2.57,1,6,65,22,35,122,11,4,4,61,0,76,23
8478409,2019,0.14,0.14,0,0,2,0,0,2,0,0,0,2,0,0,0
8478413,2019,7.82,7.55,15,5,93,27,42,162,28,8,11,85,15,95,41
8478414,2019,20.77,19.71,15,12,198,72,70,340,49,22,21,176,12,155,39
8478416,2019,4.86,4.81,3,3,125,36,46,207,11,5,5,120,0,171,18
8478420,2019,12.17,11.87,16,7,107,34,41,182,42,19,6,88,44,28,34
8478424,2019,2.42,2.36,2,2,29,6,9,44,6,2,1,27,0,8,7
8478425,2019,1.25,1.24,1,3,39,20,31,90,8,4,4,35,0,21,6
8478427,2019,32.75,31.68,16,10,207,61,65,333,64,38,16,169,409,55,71
8478430,2019,1.39,1.35,3,2,37,24,35,96,7,2,1,35,0,36,8
8478431,2019,0.74,0.7,0,0,7,1,2,10,0,0,1,7,0,5,0
8478432,2019,8.25,8.1,3,0,83,19,14,116,9,6,5,77,3,140,6
8478434,2019,0.04,0.04,0,0,1,0,0,1,0,0,0,1,1,2,0
8478436,2019,0.44,0.42,0,0,5,3,2,10,1,1,0,4,1,4,2
8478439,2019,16.44,16.06,19,17,139,53,44,236,60,24,8,115,24,63,29
8478440,2019,11.39,11.06,16,10,97,27,23,147,38,12,7,85,275,23,30
8478443,2019,4.31,4.23,5,9,110,30,39,179,18,4,6,106,0,126,31
8478444,2019,17.07,16.44,14,15,167,49,64,280,45,16,9,151,11,28,20
8478445,2019,18.45,18.1,31,12,170,53,71,294,62,19,10,151,230,22,70
8478447,2019,0.89,0.81,1,0,8,1,0,9,2,1,1,7,0,9,2
8478449,2019,14.47,13.94,9,6,120,43,45,208,34,19,10,101,172,74,23
8478451,2019,3.71,3.69,7,9,99,25,56,180,21,5,7,94,0,59,44
8478452,2019,1.41,1.41,4,1,37,9,32,78,9,4,2,33,0,33,8
8478455,2019,14.07,13.5,2,3,124,55,23,202,11,6,12,118,3,145,20
8478458,2019,12.44,11.33,13,4,117,42,47,206,29,12,5,105,72,58,24
8478460,2019,11.76,11.44,9,12,188,56,90,334,41,20,12,168,0,36,32
8478462,2019,5.37,5.15,3,2,42,12,11,65,10,5,4,37,93,39,10
8478463,2019,15.54,15.2,15,5,130,57,46,233,38,18,8,112,9,86,29
8478466,2019,1.31,1.13,1,0,17,8,6,31,2,1,0,16,0,4,1
8478468,2019,0.84,0.8,0,1,20,7,6,33,2,1,0,19,0,32,3
8478469,2019,8.5,8.18,17,16,187,78,153,418,39,6,17,181,0,79,42
8478472,2019,4.69,4.57,1,2,35,20,17,72,7,4,3,31,4,47,17
8478474,2019,12.17,11.76,8,1,109,33,28,170,24,15,6,94,24,201,28
8478476,2019,0.25,0.24,0,0,10,1,8,19,1,1,2,9,0,14,1
8478477,2019,4.15,4.07,1,1,43,23,15,81,5,3,6,40,181,36,6
8478483,2019,15.23,14.92,31,19,155,56,66,277,67,17,18,138,8,24,64
8478485,2019,0.28,0.28,0,0,1,1,2,4,0,0,0,1,1,2,1
8478488,2019,2.57,2.52,1,2,27,15,9,51,6,3,1,24,12,71,8
8478491,2019,1.44,1.43,4,5,58,18,48,124,11,2,2,56,0,34,6
8478493,2019,8.38,8.03,13,9,102,22,29,153,30,8,3,94,369,93,19
8478495,2019,14.36,14.24,5,4,132,58,60,250,29,20,9,112,0,63,26
8478498,2019,17.56,17.24,9,7,161,54,45,260,35,19,12,142,9,35,26
8478500,2019,9.47,9.22,13,12,149,40,83,272,37,12,16,137,0,84,16
8478502,2019,0.32,0.31,0,2,12,3,4,19,3,1,0,11,0,74,2
8478506,2019,0.07,0.07,0,0,3,1,3,7,0,0,0,3,0,5,0
8478507,2019,3.31,3.27,11,8,61,30,66,157,25,6,5,55,0,72,37
8478508,2019,2.02,2.01,2,2,25,11,9,45,6,2,5,23,3,46,7
8478512,2019,0.43,0.41,0,1,9,2,2,13,3,2,0,7,2,1,6
8478519,2019,17.05,16.5,17,9,113,47,44,204,43,17,17,96,431,89,52
8478542,2019,6.8,6.6,1,3,75,18,19,112,10,6,7,69,120,24,14
8478550,2019,19,18.89,34,29,208,88,106,402,95,32,14,176,1,25,56
8478567,2019,1.7,1.66,3,1,51,16,23,90,5,1,4,50,0,24,7
8478569,2019,12.76,12.31,3,3,106,34,47,187,25,19,10,87,375,119,30
8478585,2019,9.88,9.54,11,8,102,34,33,169,29,10,14,92,383,12,34
8478831,2019,4.8,4.66,2,2,57,13,30,100,10,6,5,51,52,19,6
8478833,2019,1.44,1.38,0,1,18,6,4,28,1,0,1,18,62,51,1
8478838,2019,0.94,0.86,0,0,7,1,2,10,1,1,0,6,1,8,2
8478839,2019,1.33,1.25,2,0,15,6,3,24,4,2,0,13,6,1,6
8478841,2019,0.08,0.08,0,0,2,2,0,4,0,0,0,2,0,3,2
8478843,2019,5.88,5.93,6,2,50,23,24,97,12,4,1,46,64,35,26
8478844,2019,0.86,0.87,1,1,15,6,7,28,3,1,2,14,78,4,5
8478846,2019,0.17,0.18,0,0,4,2,1,7,0,0,0,4,0,0,0
8478851,2019,0.1,0.11,0,0,4,0,0,4,0,0,0,4,0,3,0
8478856,2019,15.57,15.15,9,7,158,63,36,257,38,22,14,136,4,26,30
8478857,2019,2.56,2.42,3,2,37,13,16,66,9,4,1,33,0,93,5
8478859,2019,0.17,0.17,0,1,10,1,2,13,1,0,1,10,0,5,0
8478866,2019,8.99,8.9,8,7,102,38,40,180,22,7,4,95,15,57,41
8478868,2019,0.24,0.23,2,1,5,5,6,16,3,0,0,5,0,14,1
8478870,2019,2.93,2.86,2,0,23,10,9,42,3,1,3,22,0,19,7
8478873,2019,6.49,6.42,9,2,73,32,36,141,15,4,8,69,3,3,32
8478874,2019,9.34,8.9,6,14,76,41,33,150,33,13,5,63,183,29,23
8478881,2019,0.17,0.16,0,0,1,0,1,2,0,0,0,1,0,2,1
8478882,2019,4.72,4.52,4,10,80,27,51,158,19,5,2,75,0,79,16
8478888,2019,0.01,0.01,0,0,0,1,0,1,0,0,0,0,0,1,0
8478891,2019,5.14,5.01,2,1,55,21,16,92,8,5,2,50,5,20,11
8478906,2019,2.39,2.36,1,5,47,18,24,89,9,3,2,44,0,34,6
8478911,2019,3.73,3.55,6,8,112,53,77,242,18,4,11,108,0,132,7
8478915,2019,0.6,0.58,3,2,27,5,11,43,5,0,2,27,0,16,2
8478949,2019,0.55,0.52,0,0,6,0,0,6,0,0,0,6,0,10,2
8478975,2019,0.4,0.39,1,0,3,2,1,6,1,0,0,3,1,3,1
8478996,2019,0.38,0.38,2,1,2,2,1,5,3,0,1,2,5,0,2
8479026,2019,3.11,3.06,6,6,77,37,63,177,16,4,0,73,0,80,21
8479291,2019,5.65,5.57,4,0,59,20,18,97,8,4,3,55,175,64,17
8479293,2019,9.35,9.21,4,10,96,32,34,162,25,11,6,85,6,244,33
8479314,2019,22.07,21.13,22,17,188,74,61,323,62,23,24,165,0,122,40
8479315,2019,2.86,2.74,1,2,21,8,10,39,7,4,2,17,3,16,4
8479316,2019,14.4,13.77,8,8,128,54,54,236,31,15,15,113,207,64,9
8479318,2019,28.69,28.06,19,14,290,108,104,502,80,47,16,243,502,40,78
8479320,2019,0.04,0.04,0,0,3,0,2,5,0,0,0,3,0,2,0
8479323,2019,6.48,6.4,20,13,125,48,70,243,41,8,10,117,0,35,57
8479324,2019,1.88,1.84,5,7,47,14,31,92,13,1,1,46,0,94,28
8479325,2019,6.51,6.34,15,12,100,51,67,218,32,5,5,95,0,131,37
8479328,2019,1.57,1.66,1,2,10,10,7,27,3,0,0,10,1,15,3
8479333,2019,0.74,0.74,2,3,23,12,13,48,5,0,0,23,0,24,8
8479335,2019,2.62,2.6,1,1,36,6,2,44,3,1,2,35,49,20,5
8479336,2019,1.7,1.59,3,1,16,13,8,37,4,0,3,16,0,29,0
8479337,2019,20.48,19.73,19,6,207,63,92,362,43,18,10,189,7,58,41
8479339,2019,23.58,22.57,17,17,225,91,99,415,62,28,17,197,10,97,41
8479343,2019,17.49,17.13,19,8,182,57,55,294,44,17,10,165,9,20,34
8479345,2019,7.93,7.7,7,7,150,66,91,307,26,12,6,138,0,74,27
8479346,2019,6.59,6.43,5,5,58,21,28,107,16,6,1,52,0,59,17
8479347,2019,0.53,0.41,1,0,6,2,6,14,1,0,0,6,1,3,2
8479348,2019,0.04,0.04,0,0,2,2,2,6,0,0,0,2,0,1,0
8479351,2019,10.05,9.63,10,5,85,45,39,169,22,7,11,78,367,24,25
8479353,2019,8.69,8.39,6,4,63,18,18,99,19,9,6,54,252,69,25
8479356,2019,0.8,0.78,0,1,11,6,4,21,3,2,0,9,0,12,2
8479358,2019,0.96,0.95,0,0,14,2,2,18,1,1,1,13,0,40,6
8479359,2019,0.42,0.43,0,0,4,2,0,6,0,0,1,4,0,5,1
8479364,2019,0.46,0.34,0,1,3,1,1,5,1,0,1,3,0,5,0
8479365,2019,0.01,0.01,0,0,1,0,0,1,0,0,0,1,0,8,0
8479366,2019,2.65,2.57,5,2,23,9,10,42,8,1,4,22,55,13,10
8479368,2019,11.77,11.48,3,1,101,39,33,173,12,8,4,93,11,82,18
8479369,2019,1.13,1.06,1,1,23,14,16,53,3,1,1,22,0,25,3
8479370,2019,10.89,10.59,7,7,116,28,46,190,23,9,12,107,85,58,17
8479371,2019,3.29,3.19,3,4,92,39,60,191,12,5,4,87,0,54,23
8479372,2019,0.51,0.51,1,2,15,8,9,32,4,1,0,14,0,5,2
8479376,2019,3.18,3.11,5,2,57,21,44,122,11,4,5,53,0,20,8
8479379,2019,2.96,2.72,1,0,22,2,4,28,3,2,4,20,0,42,2
8479381,2019,1.29,1.31,0,1,13,8,2,23,2,1,0,12,1,17,1
8479382,2019,1.13,1.09,0,1,17,3,1,21,2,1,3,16,36,29,0
8479385,2019,3.05,3.05,3,1,39,11,15,65,9,5,1,34,2,8,13
8479388,2019,1.85,1.76,2,3,39,22,21,82,5,0,2,39,0,59,13
8479393,2019,3.2,3.07,1,1,33,14,17,64,5,3,1,30,6,50,6
8479395,2019,1.96,1.9,2,4,51,25,25,101,8,2,5,49,0,15,4
8479398,2019,4.27,4.2,14,16,96,47,104,247,34,4,10,92,0,46,38
8479400,2019,16.01,15.29,18,13,159,61,54,274,49,18,13,141,359,85,27
8479404,2019,0.23,0.24,0,0,3,1,0,4,0,0,0,3,13,1,3
8479407,2019,10.06,9.58,14,2,101,35,19,155,32,16,5,85,3,29,18
8479410,2019,6.97,6.8,9,14,117,53,103,273,33,10,11,107,0,105,18
8479411,2019,0.2,0.19,0,0,3,0,1,4,1,1,0,2,0,0,0
8479415,2019,0.69,0.7,2,0,11,1,4,16,2,0,0,11,39,19,4
8479420,2019,0.05,0.06,0,0,0,1,1,2,0,0,0,0,0,2,1
8479423,2019,6.62,6.65,9,6,94,28,29,151,25,10,4,84,4,29,25
8479424,2019,0.1,0.11,0,0,1,0,0,1,0,0,0,1,6,4,1
8479425,2019,7.01,6.64,10,12,125,53,79,257,31,9,9,116,0,105,18
8479442,2019,2.65,2.6,3,10,86,34,57,177,18,5,8,81,0,68,16
8479458,2019,3.7,3.58,7,4,64,40,61,165,12,1,3,63,0,108,20
8479465,2019,6.5,6.34,5,1,57,17,11,85,15,9,4,48,4,81,19
8479466,2019,6.2,6.18,4,1,57,27,9,93,5,0,4,57,2,64,9
8479482,2019,3.4,3.3,8,6,73,36,61,170,17,3,6,70,0,42,13
8479510,2019,0.03,0.02,0,0,1,0,0,1,1,1,0,0,0,1,1
8479511,2019,0,0,0,0,0,0,0,0,0,0,0,0,0,3,0
8479523,2019,0.31,0.31,0,1,3,5,1,9,1,0,0,3,0,11,1
8479526,2019,0.22,0.23,0,0,4,0,1,5,0,0,0,4,23,12,2
8479542,2019,0.18,0.18,0,0,4,0,1,5,0,0,0,4,0,1,1
8479557,2019,0.05,0.05,0,0,1,2,0,3,0,0,0,1,2,5,0
8479571,2019,0.26,0.25,0,0,3,2,1,6,0,0,0,3,0,3,2
8479580,2019,5.23,5.11,2,5,43,20,22,85,12,5,1,38,170,40,11
8479587,2019,0.26,0.26,0,0,8,1,2,11,0,0,0,8,25,8,1
8479644,2019,2.35,2.3,2,2,25,17,5,47,5,1,2,24,0,16,4
8479671,2019,0.42,0.44,1,0,6,2,1,9,1,0,1,6,0,17,0
8479675,2019,7.94,7.55,3,1,60,23,17,100,10,6,1,54,4,60,21
8479734,2019,0.07,0.07,0,0,4,1,5,10,0,0,0,4,0,2,2
8479748,2019,0.46,0.42,1,0,2,2,0,4,1,0,1,2,8,2,0
8479772,2019,1.96,1.92,1,0,17,9,5,31,6,5,1,12,1,40,4
8479933,2019,1.57,1.56,0,0,16,3,10,29,2,2,1,14,3,11,4
8479944,2019,11.54,10.98,4,3,98,34,25,157,13,6,9,92,7,137,20
8479977,2019,8.48,8.11,11,4,44,15,14,73,26,11,4,33,1,45,18
8479980,2019,2.33,2.25,5,5,54,23,59,136,11,1,6,53,0,69,13
8479982,2019,0.08,0.08,0,0,1,2,1,4,0,0,0,1,0,0,1
8479983,2019,2.46,2.41,3,6,63,32,47,142,11,2,6,61,0,119,15
8479985,2019,1.45,1.43,0,0,45,22,37,104,1,1,1,44,0,104,5
8479987,2019,0.8,0.85,0,1,4,0,1,5,4,3,0,1,12,1,1
8479994,2019,0.05,0.05,0,0,2,0,1,3,0,0,0,2,5,3,0
8479996,2019,4.73,4.61,5,2,51,17,16,84,12,5,0,46,60,15,18
8479998,2019,0.17,0.16,0,0,9,1,6,16,1,1,0,8,0,10,0
8479999,2019,3.76,3.7,4,1,34,18,6,58,9,4,2,30,86,11,6
8480001,2019,0.12,0.13,0,0,2,2,5,9,0,0,0,2,0,8,1
8480002,2019,15.92,14.93,13,9,123,50,24,197,36,14,14,109,505,48,42
8480003,2019,3.69,3.63,0,0,41,16,13,70,4,4,1,37,5,37,13
8480011,2019,0.61,0.58,0,0,5,1,1,7,1,1,0,4,0,6,0
8480012,2019,20.43,19.55,25,13,160,88,78,326,66,28,13,132,59,63,36
8480014,2019,1.5,1.45,2,2,19,5,5,29,7,3,0,16,49,1,1
8480018,2019,13.54,13.1,18,10,137,42,42,221,40,12,11,125,303,64,31
8480021,2019,0.28,0.3,1,0,3,1,0,4,1,0,1,3,9,2,0
8480023,2019,9.34,9.14,21,11,84,27,32,143,42,10,9,74,134,12,46
8480027,2019,0.14,0.14,0,1,4,0,2,6,1,0,0,4,0,1,1
8480028,2019,3.45,3.35,3,2,31,14,11,56,7,2,2,29,44,4,10
8480031,2019,5.22,5.18,3,3,32,26,14,72,11,5,1,27,3,61,5
8480035,2019,2.61,2.55,6,6,78,23,51,152,16,4,3,74,0,74,7
8480036,2019,10.13,9.57,16,12,163,46,124,333,36,8,12,155,0,40,42
8480039,2019,9.55,9.4,12,8,89,38,35,162,36,16,6,73,13,65,23
8480043,2019,0.07,0.07,0,1,2,2,5,9,1,0,0,2,0,8,0
8480064,2019,0.59,0.53,0,0,9,0,5,14,0,0,1,9,30,3,1
8480068,2019,3.51,3.49,1,0,26,8,10,44,2,1,1,25,3,38,7
8480069,2019,8.92,8.78,22,16,121,65,86,272,50,12,8,109,0,45,34
8480072,2019,1.16,1.1,0,1,13,1,0,14,1,0,0,13,40,20,8
8480073,2019,1.76,1.6,3,1,38,15,37,90,4,0,0,38,0,15,5
8480074,2019,4.02,3.89,4,3,49,16,20,85,13,6,4,43,23,20,16
8480078,2019,11.16,10.8,7,3,112,37,24,173,23,13,9,99,199,13,33
8480113,2019,15.62,14.7,16,9,141,45,44,230,42,17,15,124,11,49,18
8480144,2019,12.42,11.9,6,2,90,28,22,140,16,8,12,82,313,52,37
8480145,2019,9.19,8.57,20,19,178,66,95,339,45,6,16,172,0,165,31
8480147,2019,1.21,1.2,1,3,45,21,32,98,5,1,3,44,0,66,7
8480157,2019,0.41,0.4,0,3,14,8,14,36,3,0,1,14,0,3,2
8480160,2019,3.32,2.76,4,3,40,21,27,88,9,2,4,38,0,91,20
8480172,2019,2.03,2.02,4,2,43,15,23,81,7,1,7,42,0,19,2
8480184,2019,0.39,0.38,1,0,9,7,9,25,1,0,0,9,0,19,3
8480185,2019,0.5,0.48,1,0,9,2,1,12,1,0,0,9,33,9,2
8480186,2019,0.65,0.65,1,0,7,4,2,13,1,0,0,7,1,10,4
8480205,2019,8.07,7.89,8,2,97,25,27,149,20,10,4,87,4,52,10
8480208,2019,3.09,2.95,3,4,32,20,13,65,10,3,6,29,4,51,5
8480247,2019,0.26,0.25,1,0,3,2,1,6,1,0,1,3,0,5,0
8480314,2019,0.17,0.18,0,0,3,1,2,6,0,0,0,3,0,2,0
8480326,2019,0.12,0.12,0,0,2,1,3,6,0,0,0,2,4,16,0
8480336,2019,6.17,5.85,10,8,128,59,82,269,24,6,11,122,0,81,25
8480341,2019,0.39,0.38,1,0,5,0,1,6,2,1,0,4,0,4,1
8480384,2019,0.99,1.01,2,2,12,3,3,18,4,0,0,12,32,23,2
8480727,2019,0.61,0.62,0,1,9,10,11,30,1,0,1,9,0,10,9
8480748,2019,0.98,0.98,1,0,16,8,7,31,1,0,1,16,1,22,4
8480762,2019,6.52,6.52,3,2,69,24,25,118,12,7,5,62,4,79,13
8480769,2019,0.17,0.17,0,0,2,2,0,4,1,1,0,1,0,1,1
8480780,2019,0.66,0.64,0,0,12,2,5,19,0,0,0,12,1,16,4
8480789,2019,0.78,0.77,0,0,9,4,3,16,0,0,0,9,0,10,1
8480796,2019,0.13,0.12,0,1,7,3,6,16,1,0,0,7,0,14,2
8480797,2019,9.78,9.58,7,6,80,37,24,141,21,8,6,72,3,31,20
8480800,2019,5.84,5.64,23,22,125,59,127,311,53,8,12,117,0,7,35
8480801,2019,32.57,30.92,19,3,258,101,70,429,43,21,31,237,144,302,35
8480806,2019,1.17,1.19,3,1,10,5,6,21,4,0,0,10,65,5,4
8480814,2019,0.07,0.06,0,0,2,1,2,5,0,0,0,2,0,2,0
8480821,2019,6.22,6,4,3,60,21,26,107,15,8,6,52,1,11,12
8480822,2019,1.43,1.45,1,0,13,7,5,25,3,2,0,11,1,9,2
8480829,2019,5.38,5.21,1,1,55,11,21,87,8,6,3,49,124,51,14
8480830,2019,23.23,22.44,18,19,183,70,66,319,61,24,25,159,0,116,29
8480839,2019,5.38,5.14,19,16,90,41,89,220,39,4,5,86,0,72,16
8480849,2019,2.88,2.71,2,1,27,6,11,44,4,1,3,26,23,14,8
8480853,2019,0.14,0.13,0,1,3,1,2,6,1,0,1,3,0,3,1
8480865,2019,1.61,1.57,4,2,37,10,32,79,7,1,2,36,0,25,8
8480871,2019,2.07,2,5,4,50,19,38,107,13,4,4,46,1,33,10
8480873,2019,0.8,0.77,4,3,22,10,16,48,8,1,2,21,0,33,2
8480901,2019,4.21,4.29,4,1,45,16,14,75,6,1,2,44,1,36,2
8480913,2019,0.03,0.03,0,1,3,0,2,5,1,0,0,3,0,0,1
8480935,2019,0.28,0.28,0,0,6,6,5,17,0,0,0,6,0,10,2
8480940,2019,0.4,0.39,0,2,17,9,7,33,2,0,0,17,0,6,2
8480944,2019,3.28,3.24,2,1,35,15,10,60,6,3,0,32,132,23,14
8480945,2019,1.98,1.93,3,3,37,21,25,83,7,1,6,36,0,74,8
8480946,2019,6.86,6.65,12,7,87,12,23,122,31,12,4,75,29,5,18
8480950,2019,1.55,1.5,3,1,41,19,30,90,4,0,5,41,0,150,13
8480965,2019,1.86,1.83,2,3,18,6,5,29,6,1,2,17,51,27,6
8481019,2019,0.32,0.32,0,0,4,3,3,10,1,1,0,3,33,5,0
8481105,2019,0.04,0.04,0,0,2,1,3,6,0,0,0,2,0,13,1
8481186,2019,1.83,1.88,0,0,15,4,9,28,2,2,1,13,0,20,5
8481433,2019,1.6,1.58,3,2,21,10,8,39,7,2,2,19,0,13,6
8481477,2019,0.13,0.13,0,2,2,1,1,4,2,0,1,2,27,6,1
8481481,2019,9.7,9.4,9,7,87,34,36,157,22,6,9,81,310,42,22
8481515,2019,0.21,0.2,0,0,2,3,3,8,0,0,0,2,0,3,2
8481516,2019,2.53,2.53,3,1,31,9,10,50,7,3,1,28,112,28,8
8481523,2019,11.46,11.24,6,10,101,35,26,162,24,8,8,93,74,33,38
8481554,2019,8.34,8.29,9,3,109,31,57,197,22,10,6,99,2,20,35
8481559,2019,14.04,13.78,9,5,123,41,44,208,21,7,10,116,168,12,41
8481572,2019,0.21,0.2,0,4,10,2,6,18,5,1,0,9,0,3,3
8481600,2019,0,0,0,0,0,0,0,0,0,0,0,0,0,0,0
8481624,2019,9.67,9.68,8,7,96,48,27,171,23,8,10,88,3,26,24
8481630,2019,0.06,0.06,0,0,2,3,2,7,0,0,0,2,0,13,0
8481637,2019,0.13,0.13,0,0,2,1,0,3,0,0,0,2,0,5,1
8481638,2019,4.44,4.42,3,3,39,11,8,58,9,3,4,36,3,18,14
8481640,2019,0.69,0.65,1,0,11,5,1,17,1,0,0,11,0,29,3
8481641,2019,1.56,1.55,0,0,13,5,7,25,1,1,1,12,0,17,5
8481642,2019,0.21,0.21,0,0,1,0,0,1,0,0,0,1,0,1,0
8481649,2019,0.52,0.55,0,0,9,5,3,17,0,0,0,9,0,10,3
8481650,2019,2.29,2.27,2,1,23,12,8,43,5,2,3,21,2,18,9
8481812,2019,0.01,0.01,0,0,0,1,2,3,0,0,0,0,0,4,1
8481813,2019,5.34,5.44,3,2,54,18,21,93,10,5,4,49,170,58,21
8464989,2018,8.16,7.95,9,4,87,21,20,128,20,7,3,80,320,32,24
8465009,2018,3.83,3.64,4,5,99,38,62,199,14,5,7,94,0,81,28
8466138,2018,10.92,10.43,23,12,89,27,32,148,51,16,8,73,356,17,43
8466139,2018,19.84,18.91,13,6,161,57,42,260,35,16,10,145,104,74,31
8468001,2018,0,0,0,0,0,0,1,1,0,0,0,0,2,0,0
8468493,2018,2.94,2.88,5,11,82,41,54,177,22,6,4,76,1,91,31
8468498,2018,1.02,0.98,2,5,43,18,38,99,9,2,5,41,0,131,5
8468508,2018,28.96,27.57,18,12,238,80,60,378,53,23,23,215,92,55,63
8468509,2018,3.2,3.09,11,13,71,15,38,124,27,3,5,68,0,86,12
8468611,2018,1.16,1.16,3,0,23,5,12,40,3,0,2,23,42,40,5
8468674,2018,2.96,2.9,6,4,105,39,71,215,12,2,5,103,0,165,26
8469454,2018,13.71,13.27,12,6,141,48,62,251,34,16,11,125,16,28,21
8469455,2018,9.64,9.27,11,9,121,43,51,215,28,8,5,113,469,16,26
8469459,2018,9.61,9.24,15,6,89,35,30,154,29,8,11,81,488,13,35
8469465,2018,1.72,1.65,1,4,39,10,33,82,5,0,2,39,0,38,12
8469501,2018,0,0,0,0,0,0,0,0,0,0,0,0,0,1,0
8469506,2018,12.69,11.96,8,7,133,34,30,197,31,16,9,117,18,18,13
8469521,2018,0.46,0.45,0,0,8,2,4,14,1,1,1,7,19,1,0
8470047,2018,9.12,9.1,10,4,78,20,23,121,31,17,4,61,397,12,36
8470110,2018,3.02,2.96,4,2,47,17,19,83,8,2,3,45,0,14,10
8470144,2018,9.07,8.95,10,14,120,28,37,185,34,10,6,110,450,79,18
8470151,2018,3.67,3.61,10,4,82,31,55,168,17,3,5,79,0,61,24
8470187,2018,5.7,5.46,8,9,157,69,98,324,20,3,18,154,0,144,10
8470257,2018,10.39,10.21,8,8,114,32,40,186,27,11,8,103,11,55,34
8470281,2018,5.43,5.33,13,21,141,46,95,282,40,6,7,135,0,41,33
8470318,2018,1.54,1.5,1,1,48,20,38,106,5,3,4,45,0,98,9
8470543,2018,5.25,5.15,3,2,44,17,26,87,10,5,5,39,2,85,13
8470595,2018,25.75,24.77,17,12,212,63,72,347,51,22,18,190,640,42,49
8470598,2018,11.83,11.38,12,8,108,43,44,195,36,16,8,92,7,38,20
8470600,2018,7.38,6.9,16,24,133,73,109,315,46,6,15,127,1,77,25
8470601,2018,4.63,4.48,6,12,113,47,65,225,22,4,5,109,0,96,17
8470602,2018,2.66,2.59,1,4,80,42,75,197,6,1,5,79,0,128,6
8470604,2018,20.6,19.36,9,9,174,85,70,329,31,13,21,161,607,80,23
8470606,2018,18.16,17.36,19,10,180,51,65,296,51,22,13,158,1,150,31
8470607,2018,6.14,5.91,10,13,165,41,97,303,28,5,6,160,0,124,19
8470610,2018,29.27,27.68,17,16,228,61,55,344,61,28,18,200,9,49,22
8470611,2018,9.24,9.03,3,5,67,35,26,128,15,7,2,60,361,38,32
8470612,2018,10.09,9.79,13,21,133,75,63,271,48,14,7,119,551,150,60
8470613,2018,13.97,13.73,39,27,300,135,254,689,82,16,20,284,0,90,88
8470616,2018,9.12,8.55,3,0,86,37,26,149,8,5,9,81,582,93,18
8470619,2018,14.54,13.69,4,2,122,39,34,195,23,17,9,105,170,145,22
8470621,2018,6.37,6.26,4,0,60,23,22,105,10,6,4,54,0,21,12
8470622,2018,1.07,1.03,0,0,6,6,0,12,0,0,1,6,0,14,1
8470626,2018,13.39,12.86,8,8,107,38,25,170,27,11,6,96,3,3,29
8470638,2018,24.95,23.88,26,20,205,94,70,369,78,32,14,173,786,43,41
8470642,2018,7.54,7.3,8,10,166,85,88,339,32,14,13,152,0,129,17
8470655,2018,9.51,9.42,5,8,129,38,32,199,20,7,10,122,176,140,33
8470740,2018,0,0,0,0,0,0,2,2,0,0,0,0,0,2,3
8470755,2018,12.5,11.79,7,1,128,37,49,214,27,19,7,109,575,63,26
8470760,2018,0.15,0.15,0,0,3,2,1,6,0,0,0,3,0,15,0
8470775,2018,7.05,6.87,1,7,71,16,23,110,13,5,6,66,409,87,31
8470794,2018,27.22,26.05,17,9,187,63,46,296,64,38,26,149,526,69,41
8470803,2018,6.96,6.84,2,1,74,32,23,129,9,6,7,68,397,92,33
8470834,2018,5.32,5.25,7,19,115,52,61,228,30,4,10,111,0,77,21
8470966,2018,12.68,11.55,25,29,221,113,156,490,71,17,18,204,0,58,73
8471214,2018,36.46,35.32,26,12,338,164,167,669,89,51,18,287,1,223,47
8471215,2018,21.54,21.09,31,20,188,57,79,324,72,21,19,167,381,54,64
8471217,2018,2.81,2.84,3,4,34,8,13,55,10,3,3,31,2,37,9
8471218,2018,19.73,19.6,46,23,231,73,74,378,89,20,13,211,31,81,43
8471226,2018,6.75,6.65,5,2,77,29,30,136,12,5,6,72,16,50,15
8471228,2018,23.15,21.78,23,21,210,65,93,368,73,29,22,181,6,60,43
8471233,2018,15.86,15.09,8,18,120,36,41,197,45,19,11,101,841,66,63
8471242,2018,4.64,4.49,7,14,92,41,40,173,26,5,7,87,0,60,16
8471260,2018,10.44,10.16,5,6,102,37,39,178,18,7,13,95,25,208,39
8471262,2018,20.56,19.58,14,10,189,53,72,314,48,24,13,165,527,99,49
8471273,2018,7.64,7.15,5,3,63,14,19,96,14,6,3,57,428,147,16
8471274,2018,3.69,3.61,12,12,101,43,86,230,27,3,4,98,1,79,18
8471276,2018,15.08,14.77,31,21,140,64,38,242,72,20,7,120,530,28,54
8471284,2018,0.83,0.81,1,4,28,12,27,67,5,0,1,28,0,17,6
8471303,2018,3.93,3.8,15,6,128,53,73,254,31,10,4,118,0,127,13
8471339,2018,7.92,7.95,8,2,76,20,15,111,17,7,7,69,6,88,22
8471392,2018,3.57,3.39,3,5,77,39,39,155,9,1,6,76,0,191,18
8471426,2018,8.39,8.24,8,1,86,26,24,136,21,12,4,74,19,176,23
8471436,2018,0.32,0.29,2,0,10,3,5,18,2,0,0,10,0,6,2
8471490,2018,0.21,0.2,0,0,3,0,1,4,0,0,0,3,0,6,0
8471657,2018,2.34,2.33,0,0,22,7,6,35,1,1,5,21,0,112,5
8471669,2018,15.88,14.8,17,11,101,39,19,159,41,13,15,88,463,35,36
8471675,2018,31.56,30.53,49,17,220,70,58,348,101,35,23,185,1011,85,54
8471676,2018,18.27,17.65,18,9,160,69,71,300,42,15,9,145,8,77,50
8471677,2018,3.9,3.78,5,7,86,40,86,212,13,1,6,85,0,233,14
8471685,2018,19.46,18.55,27,12,156,71,71,298,61,22,20,134,1003,59,57
8471686,2018,3.49,3.44,3,7,84,24,62,170,13,3,9,81,0,94,28
8471691,2018,1.7,1.59,1,0,14,2,3,19,2,1,1,13,45,14,2
8471698,2018,19.56,19.14,14,15,143,75,44,262,54,25,16,118,84,133,46
8471699,2018,10.85,10.37,8,3,106,37,29,172,17,6,11,100,11,68,22
8471702,2018,4.78,4.68,8,9,143,42,71,256,25,8,13,135,0,167,40
8471707,2018,11.42,11.32,8,4,141,51,43,235,19,7,9,134,5,46,11
8471709,2018,4.87,4.74,13,8,100,52,84,236,24,3,10,97,0,23,24
8471716,2018,11.87,11.24,6,7,95,40,24,159,19,6,7,89,52,185,9
8471717,2018,1.4,1.37,2,2,27,22,23,72,7,3,2,24,0,122,11
8471724,2018,10.48,10.33,24,15,207,59,114,380,56,17,15,190,0,116,63
8471729,2018,2.86,2.68,4,9,63,29,50,142,16,3,4,60,0,93,21
8471735,2018,8.58,8.34,34,18,199,80,128,407,61,9,9,190,0,47,26
8471743,2018,6.36,6.23,4,4,71,25,31,127,13,5,1,66,317,87,12
8471761,2018,0.31,0.3,1,0,10,10,11,31,2,1,1,9,0,17,3
8471768,2018,2.87,2.75,1,1,29,12,12,53,2,0,1,29,56,15,4
8471769,2018,1.49,1.41,3,7,57,18,34,109,10,0,7,57,0,45,32
8471794,2018,10.35,10.17,8,2,107,38,46,191,17,7,7,100,16,50,33
8471817,2018,12.36,12.01,7,3,95,32,33,160,19,9,9,86,40,305,37
8471873,2018,2.15,2.14,6,9,57,21,43,121,17,2,6,55,0,59,25
8471887,2018,24.56,23.78,7,12,196,53,52,301,36,17,20,179,9,150,25
8471958,2018,4.27,3.98,0,12,75,21,35,131,16,4,8,71,0,151,8
8472382,2018,4.96,4.79,12,8,104,50,53,207,25,5,5,99,0,67,40
8472410,2018,0.49,0.47,0,0,4,3,1,8,0,0,0,4,20,14,0
8473412,2018,12.19,11.79,16,10,126,38,33,197,41,15,6,111,525,62,36
8473415,2018,2.73,2.68,7,7,91,37,54,182,16,2,2,89,0,101,4
8473419,2018,27.56,26.9,35,29,231,96,102,429,100,36,13,195,45,46,59
8473422,2018,16.13,15.37,7,11,140,43,35,218,35,17,14,123,133,175,37
8473446,2018,5.77,5.5,7,12,144,46,93,283,26,7,9,137,0,124,31
8473449,2018,11.83,11.35,9,6,148,39,46,233,29,14,5,134,63,87,17
8473453,2018,6.8,6.55,6,3,87,24,23,134,12,3,4,84,57,53,12
8473463,2018,9.56,9.53,11,10,77,39,25,141,26,5,4,72,84,203,28
8473465,2018,2.62,2.53,3,0,23,6,13,42,7,4,1,19,1,34,4
8473468,2018,0.27,0.25,0,0,11,5,7,23,0,0,1,11,0,21,4
8473473,2018,10.04,9.74,10,3,74,52,43,169,19,6,11,68,25,259,27
8473492,2018,0.19,0.2,0,0,3,2,1,6,1,1,0,2,1,7,0
8473504,2018,13.82,13.45,8,7,94,52,41,187,23,8,7,86,15,209,20
8473507,2018,8.45,8.22,16,16,172,109,156,437,45,13,8,159,0,190,39
8473512,2018,17.79,17.34,39,23,230,88,101,419,84,22,17,208,675,28,45
8473533,2018,14.48,13.89,8,10,121,37,37,195,29,11,15,110,570,121,39
8473534,2018,3.22,3.22,1,1,25,13,7,45,4,2,2,23,68,25,6
8473544,2018,11.58,11.34,4,5,110,31,49,190,23,14,7,96,283,102,36
8473546,2018,9.18,8.99,3,2,66,19,16,101,15,10,8,56,5,28,31
8473548,2018,24.03,23.49,33,21,215,66,89,370,81,27,19,188,4,12,33
8473560,2018,0.74,0.68,0,3,15,7,11,33,4,1,0,14,0,61,7
8473563,2018,19.45,18.85,30,22,171,57,61,289,74,22,13,149,701,54,53
8473564,2018,13.02,12.54,11,7,132,45,40,217,34,16,8,116,13,57,33
8473573,2018,18.82,18.4,13,8,139,63,66,268,36,15,11,124,332,25,50
8473584,2018,1.79,1.69,3,6,41,24,38,103,9,0,3,41,0,30,3
8473588,2018,0.6,0.6,0,0,10,3,1,14,1,1,0,9,0,3,0
8473604,2018,26.6,25.7,29,16,236,56,64,356,80,35,15,201,1058,42,72
8473618,2018,10.32,9.61,5,12,94,41,34,169,32,15,3,79,26,127,31
8473673,2018,0.9,0.91,1,1,29,13,33,75,2,0,1,29,0,29,4
8473914,2018,0.02,0.02,0,0,1,1,0,2,0,0,1,1,5,3,0
8473933,2018,2.67,2.61,3,4,95,32,56,183,9,2,6,93,0,76,23
8473986,2018,17.12,16.45,15,7,153,60,74,287,40,18,15,135,2,88,30
8473991,2018,0.15,0.15,1,0,8,4,7,19,1,0,1,8,0,13,1
8473992,2018,0.28,0.28,0,0,7,4,4,15,0,0,0,7,0,36,1
8473994,2018,27.03,25.31,15,11,189,66,74,329,53,27,11,162,205,142,44
8474000,2018,2.2,2.2,1,2,40,22,25,87,6,3,0,37,0,44,12
8474008,2018,0.22,0.22,0,0,4,0,3,7,0,0,1,4,1,3,3
8474009,2018,12.57,11.84,12,7,118,36,48,202,36,17,9,101,585,24,30
8474013,2018,2.98,2.88,3,10,82,38,61,181,15,2,5,80,0,107,27
8474025,2018,0.5,0.49,1,0,10,0,5,15,1,0,2,10,3,11,3
8474027,2018,4.17,4.04,6,8,105,51,68,224,16,2,11,103,0,121,34
8474031,2018,5.46,5.21,12,13,148,45,98,291,27,2,8,146,0,73,39
8474034,2018,14.25,13.76,10,6,118,46,39,203,26,10,14,108,2,135,25
8474037,2018,20.8,20.13,8,11,167,39,56,262,46,27,21,140,6,34,25
8474038,2018,10.81,10.76,10,6,94,20,18,132,31,15,5,79,12,114,12
8474040,2018,6.12,5.7,5,2,68,24,27,119,13,6,3,62,59,21,5
8474053,2018,21.27,20.79,26,17,205,84,73,362,70,27,13,178,282,65,71
8474056,2018,6.08,5.92,12,10,168,58,79,305,31,9,15,159,0,56,22
8474061,2018,0.01,0.01,0,0,1,0,0,1,0,0,0,1,0,4,2
8474062,2018,8.5,8.11,6,2,79,20,24,123,11,3,8,76,150,72,39
8474066,2018,1.64,1.61,2,0,47,23,40,110,2,0,3,47,0,40,9
8474068,2018,6.16,5.92,13,3,78,36,32,146,23,7,4,71,281,24,19
8474089,2018,0.95,0.9,0,0,13,5,1,19,0,0,0,13,32,35,1
8474090,2018,4.98,4.7,6,3,66,32,49,147,13,4,4,62,0,100,32
8474091,2018,3.4,3.3,1,1,43,15,16,74,6,4,4,39,223,33,8
8474098,2018,9.95,9.51,8,2,117,30,26,173,15,5,11,112,39,89,18
8474102,2018,10.71,10.48,13,10,111,38,54,203,46,23,9,88,15,52,41
8474125,2018,1.14,1.13,0,5,21,10,17,48,8,3,0,18,0,11,6
8474131,2018,4.99,5.06,3,2,56,25,24,105,9,4,1,52,125,105,11
8474134,2018,1.86,1.82,3,3,67,16,39,122,8,2,2,65,0,64,7
8474141,2018,31.3,30.48,40,24,340,113,143,596,108,44,16,296,1,21,42
8474145,2018,2.84,2.82,6,3,75,21,31,127,11,2,6,73,0,93,11
8474149,2018,26.94,26.09,23,19,195,85,78,358,70,28,13,167,2,33,45
8474150,2018,22.51,21.55,19,7,205,63,72,340,47,21,18,184,511,52,78
8474151,2018,6.45,6.24,17,20,127,45,70,242,46,9,7,118,0,98,46
8474157,2018,21.1,20.01,13,5,191,70,74,335,40,22,22,169,22,119,39
8474161,2018,21.79,20.39,28,17,210,75,98,383,66,21,22,189,12,17,32
8474162,2018,5.43,5.19,12,17,141,63,118,322,38,9,9,132,0,172,20
8474166,2018,4.06,3.81,6,8,78,35,57,170,18,4,6,74,0,78,12
8474176,2018,8.75,8.5,6,8,99,41,38,178,19,5,7,94,6,64,30
8474189,2018,17.34,16.78,13,9,162,62,49,273,35,13,18,149,543,69,59
8474190,2018,20.4,19.16,10,3,155,58,54,267,30,17,16,138,4,137,28
8474207,2018,3.7,3.66,6,6,78,46,65,189,15,3,7,75,0,104,26
8474218,2018,1.26,1.18,4,2,39,18,24,81,8,2,2,37,0,49,14
8474230,2018,5.05,4.89,2,2,34,21,16,71,6,2,5,32,13,76,3
8474250,2018,10.48,9.83,12,6,101,38,35,174,27,9,8,92,403,136,42
8474291,2018,5.02,4.93,5,4,45,15,11,71,12,3,5,42,427,102,13
8474520,2018,0.43,0.42,0,0,16,7,8,31,1,1,1,15,0,13,2
8474563,2018,8.72,8.27,20,17,153,64,99,316,45,8,16,145,0,168,23
8474564,2018,26.24,25.4,37,16,234,93,97,424,98,45,11,189,506,71,28
8474565,2018,9.3,8.61,9,19,168,65,123,356,41,13,14,155,0,61,55
8474567,2018,4.05,3.86,5,11,93,31,57,181,19,3,6,90,0,83,17
8474568,2018,1.14,1.13,0,2,30,10,24,64,2,0,3,30,0,105,2
8474569,2018,11.13,10.99,5,10,104,36,31,171,27,12,1,92,20,55,16
8474571,2018,8.32,8.06,15,13,87,26,36,149,34,6,5,81,7,54,25
8474573,2018,13.14,12.88,26,13,126,36,59,221,55,16,12,110,140,19,41
8474574,2018,7.52,7.35,11,9,156,57,88,301,29,9,9,147,0,97,32
8474578,2018,5.55,5.5,21,21,169,81,139,389,45,3,13,166,1,44,59
8474579,2018,0.16,0.17,0,1,5,3,9,17,1,0,2,5,0,17,1
8474581,2018,3.15,3.18,13,15,78,58,100,236,31,3,7,75,0,61,25
8474584,2018,2.25,2.18,2,7,45,27,40,112,10,1,4,44,0,129,7
8474586,2018,20.52,19.25,12,6,160,53,42,255,37,19,10,141,9,36,34
8474589,2018,8.81,8.49,5,1,81,27,15,123,18,12,4,69,1,49,19
8474590,2018,10.16,9.7,35,22,185,83,129,397,70,13,7,172,0,54,55
8474597,2018,0.06,0.06,0,0,3,1,2,6,0,0,0,3,0,13,0
8474600,2018,15.77,15.45,20,20,274,90,144,508,55,15,22,259,0,53,36
8474602,2018,3.62,3.48,5,8,47,26,26,99,15,2,4,45,0,25,5
8474610,2018,0.03,0.03,1,0,1,0,1,2,1,0,0,1,0,0,0
8474611,2018,0.1,0.1,0,0,2,0,2,4,0,0,0,2,0,4,2
8474612,2018,4.57,4.5,7,5,128,66,92,286,19,7,6,121,0,44,37
8474613,2018,18.54,16.71,15,5,194,55,60,309,35,15,18,179,651,50,49
8474618,2018,2.88,2.73,2,5,83,25,48,156,13,6,4,77,0,53,16
8474627,2018,1.31,1.22,1,1,17,1,5,23,3,1,0,16,78,29,6
8474628,2018,0.39,0.38,2,3,12,16,21,49,5,0,1,12,0,27,6
8474641,2018,18.2,17.06,15,9,122,68,34,224,42,18,12,104,572,78,39
8474659,2018,0.02,0.02,1,0,1,0,0,1,1,0,1,1,0,0,0
8474668,2018,6.84,6.66,3,3,58,21,15,94,11,5,5,53,6,88,9
8474673,2018,5.53,5.38,13,13,102,45,86,233,35,9,6,93,0,21,68
8474679,2018,19.06,18.61,19,19,204,69,77,350,60,22,14,182,11,36,42
8474683,2018,6.44,6.35,6,4,74,23,21,118,14,4,6,70,271,92,19
8474685,2018,13.12,12.74,11,4,141,27,44,212,26,11,11,130,40,115,43
8474688,2018,2.39,2.34,5,1,100,45,60,205,7,1,6,99,0,143,14
8474697,2018,3.2,3.04,2,2,59,50,38,147,5,1,5,58,0,212,14
8474709,2018,6.51,6.48,3,4,62,28,18,108,13,6,2,56,6,274,13
8474715,2018,31.99,31.09,11,17,295,116,76,487,69,41,23,254,24,27,47
8474716,2018,9.05,8.71,13,16,152,59,92,303,43,14,8,138,1,91,30
8474717,2018,0.4,0.39,0,0,11,7,8,26,1,1,0,10,0,13,3
8474722,2018,0.52,0.52,2,0,14,7,7,28,2,0,1,14,0,67,3
8474736,2018,0.79,0.8,2,0,11,9,4,24,3,1,1,10,1,47,4
8474749,2018,0.05,0.05,0,0,2,0,3,5,1,1,0,1,0,1,0
8474774,2018,0.58,0.6,1,0,14,12,16,42,2,1,0,13,0,36,4
8474818,2018,3.01,2.95,6,11,93,39,66,198,22,5,5,88,0,124,19
8474849,2018,8.97,8.86,17,4,83,42,27,152,30,9,5,74,17,87,20
8474870,2018,21.57,21.28,9,9,163,57,48,268,47,29,11,134,229,50,13
8474873,2018,0.02,0.02,0,1,2,0,0,2,1,0,0,2,0,3,0
8474884,2018,23.42,22.68,15,19,252,80,107,439,69,35,14,217,13,42,48
8475098,2018,16.03,15.12,10,15,138,47,35,220,38,13,9,125,451,51,30
8475149,2018,12.13,11.27,11,6,115,34,38,187,30,13,8,102,16,28,27
8475151,2018,19.56,18.77,15,7,224,76,83,383,49,27,11,197,24,98,36
8475158,2018,24.63,23.8,28,19,234,71,63,368,75,28,21,206,1084,31,94
8475160,2018,14.11,13.58,6,4,115,49,31,195,21,11,11,104,3,115,11
8475163,2018,19.4,18.24,13,3,123,52,32,207,38,22,13,101,7,85,28
8475164,2018,18.71,18.13,11,8,163,65,60,288,43,24,5,139,19,38,27
8475166,2018,39.02,37.4,25,15,286,114,83,483,87,47,28,239,833,59,53
8475167,2018,10.88,10.38,21,21,183,72,73,328,54,12,10,171,0,59,32
8475168,2018,23.07,22.04,24,14,172,54,48,274,69,31,12,141,676,28,50
8475169,2018,26.69,25.53,13,13,268,83,92,443,56,30,31,238,92,173,48
8475170,2018,25.4,24.52,24,13,159,67,37,263,54,17,10,142,324,111,51
8475171,2018,10.04,9.79,19,11,175,103,149,427,44,14,13,161,0,162,32
8475172,2018,20.49,19.24,14,13,184,103,78,365,43,16,20,168,403,85,42
8475175,2018,11.09,10.57,2,6,119,35,23,177,19,11,12,108,7,65,18
8475176,2018,8.12,7.85,17,16,149,69,90,308,40,7,15,142,0,71,54
8475177,2018,5.09,4.91,6,5,102,73,108,283,12,1,15,101,0,186,59
8475178,2018,14.58,13.82,7,4,111,27,32,170,26,15,10,96,0,192,35
8475179,2018,1.57,1.54,3,3,40,23,33,96,6,0,4,40,0,88,19
8475181,2018,5.93,5.77,15,6,116,54,90,260,25,4,12,112,0,77,18
8475184,2018,25.19,24.27,12,13,202,78,44,324,53,28,18,174,27,159,31
8475186,2018,4.37,4.28,4,5,97,29,59,185,13,4,1,93,0,77,10
8475188,2018,3.73,3.64,7,5,84,32,68,184,16,4,7,80,0,200,37
8475191,2018,22.93,22.25,22,12,178,61,63,302,53,19,5,159,5,39,67
8475193,2018,21.89,21.78,21,12,196,67,78,341,58,25,16,171,10,77,52
8475197,2018,10.88,10.43,27,16,218,81,143,442,58,15,20,203,0,48,28
8475200,2018,5.33,5.27,11,14,101,49,82,232,28,3,6,98,0,137,53
8475204,2018,9.7,9.27,4,2,82,31,30,143,18,12,4,70,15,29,14
8475206,2018,0.04,0.04,1,0,3,0,5,8,1,0,1,3,0,2,0
8475208,2018,4.04,4,3,17,99,57,70,226,23,3,5,96,0,141,39
8475209,2018,16.8,16.12,11,9,136,50,62,248,33,13,11,123,5,137,46
8475218,2018,7.26,6.88,17,19,146,62,98,306,44,8,11,138,0,68,32
8475220,2018,11.08,10.63,6,5,88,34,27,149,18,7,11,81,13,203,30
8475222,2018,3.89,3.81,9,4,107,30,67,204,17,4,5,103,0,68,16
8475225,2018,18.27,17.74,13,4,205,71,61,337,38,21,19,184,26,77,43
8475227,2018,1.31,1.21,3,2,27,16,23,66,7,2,0,25,0,35,3
8475231,2018,14.22,14.11,10,3,112,28,31,171,34,21,7,91,498,129,44
8475233,2018,6.71,6.25,7,9,124,49,61,234,24,8,8,116,0,122,17
8475235,2018,4.51,4.33,1,2,48,19,18,85,5,2,2,46,1,135,11
8475236,2018,14.92,14.57,13,6,120,47,42,209,41,22,13,98,479,88,51
8475246,2018,2.72,2.65,3,4,75,39,54,168,8,1,6,74,0,106,5
8475253,2018,5.73,5.49,4,2,54,15,11,80,8,2,6,52,3,114,5
8475260,2018,1.27,1.27,1,2,15,4,5,24,4,1,1,14,63,9,6
8475263,2018,1.77,1.74,1,0,16,2,4,22,1,0,1,16,27,4,2
8475268,2018,3.13,3.08,5,1,34,19,7,60,8,2,4,32,7,100,11
8475279,2018,3.56,3.49,10,5,111,40,80,231,20,5,5,106,0,171,20
8475287,2018,4.12,3.91,3,2,26,18,20,64,7,2,2,24,78,11,12
8475314,2018,30.03,28.52,14,8,204,79,49,332,50,28,19,176,75,103,22
8475321,2018,3.47,3.37,3,1,34,5,15,54,7,3,2,31,81,23,5
8475323,2018,5.99,5.91,4,4,73,15,9,97,11,3,5,70,188,51,17
8475324,2018,3.25,3.09,9,8,94,36,62,192,19,2,5,92,0,82,27
8475325,2018,0.81,0.8,1,1,17,7,4,28,2,0,1,17,0,22,1
8475343,2018,6.18,6.21,10,4,47,25,17,89,22,8,0,39,245,97,29
8475413,2018,1.34,1.37,1,0,9,6,9,24,1,0,1,9,31,11,6
8475423,2018,0.75,0.8,0,1,10,1,0,11,2,1,0,9,0,10,1
8475430,2018,1.27,1.2,1,1,33,12,28,73,4,2,2,31,0,63,7
8475455,2018,2.36,2.2,11,10,71,42,68,181,22,1,7,70,0,199,16
8475461,2018,0.59,0.6,0,1,11,2,1,14,2,1,2,10,16,14,1
8475462,2018,3.73,3.57,7,9,137,70,84,291,20,4,11,133,0,255,23
8475613,2018,0.19,0.18,0,0,10,3,9,22,0,0,1,10,0,17,1
8475625,2018,1.13,1.12,4,2,50,22,40,112,7,1,5,49,0,80,8
8475690,2018,1.84,1.83,6,5,52,19,28,99,13,2,3,50,0,29,20
8475692,2018,10.93,10.48,16,11,104,43,35,182,39,12,10,92,10,57,38
8475714,2018,10.67,10.41,6,9,106,40,51,197,25,10,7,96,166,56,25
8475715,2018,9.23,8.85,8,3,91,34,33,158,20,9,7,82,101,104,22
8475716,2018,1.39,1.37,1,3,34,15,30,79,5,1,2,33,0,21,11
8475718,2018,0.15,0.14,0,1,6,3,5,14,1,0,0,6,0,9,2
8475722,2018,25.67,24.97,12,8,215,104,79,398,42,22,14,193,2,87,47
8475726,2018,23.6,22.87,12,8,226,81,95,402,33,13,21,213,24,39,44
8475727,2018,5.76,5.33,3,3,67,18,24,109,9,3,3,64,59,39,10
8475728,2018,8.84,8.68,4,5,79,45,36,160,15,6,1,73,503,112,29
8475729,2018,0.04,0.04,0,0,2,0,2,4,0,0,0,2,0,0,0
8475735,2018,3.68,3.67,4,1,27,14,9,50,11,6,2,21,146,30,14
8475736,2018,2.18,2.09,2,0,18,5,0,23,3,1,2,17,0,35,3
8475738,2018,7.51,7.45,8,5,75,29,33,137,21,8,7,67,333,28,19
8475744,2018,20,19.46,25,26,194,87,54,335,72,21,12,173,397,46,46
8475745,2018,16.34,15.77,11,10,155,54,49,258,33,12,14,143,319,77,41
8475747,2018,1.97,1.97,7,2,57,24,31,112,10,1,4,56,1,137,4
8475750,2018,3.25,3.12,5,7,72,36,51,159,15,3,4,69,0,71,16
8475752,2018,6.02,5.85,3,1,75,24,25,124,12,8,3,67,5,93,11
8475753,2018,13.86,13.36,14,9,217,89,133,439,34,11,12,206,0,156,47
8475754,2018,23.23,22.57,13,15,181,55,58,294,53,25,6,156,594,51,54
8475755,2018,1.83,1.81,0,2,47,23,41,111,2,0,1,47,0,116,9
8475758,2018,8.26,7.12,3,1,60,29,25,114,8,4,4,56,16,78,7
8475760,2018,14.45,13.85,2,10,154,41,38,233,26,14,16,140,260,126,37
8475762,2018,2.75,2.71,4,8,75,43,65,183,14,2,5,73,0,105,15
8475763,2018,18.91,18.29,19,17,156,60,82,298,55,19,12,137,483,58,61
8475764,2018,4.45,4.16,8,10,88,30,87,205,23,5,7,83,0,32,24
8475765,2018,27.06,26.43,16,18,274,81,135,490,67,33,23,241,4,88,34
8475766,2018,8.11,7.74,6,3,64,33,16,113,16,7,3,57,7,109,12
8475768,2018,18.7,18.52,17,9,182,70,68,320,37,11,14,171,18,61,46
8475772,2018,12.71,12.33,5,5,110,34,20,164,19,9,8,101,361,72,49
8475780,2018,15.37,14.98,4,3,134,44,37,215,19,12,10,122,54,247,21
8475784,2018,31.91,30.86,15,9,268,87,76,431,64,40,22,228,157,32,56
8475786,2018,25.31,24.58,12,8,145,52,46,243,41,21,13,124,112,102,30
8475790,2018,2.69,2.6,3,5,94,37,59,190,10,2,3,92,0,184,10
8475791,2018,10.91,10.6,16,9,113,40,54,207,36,11,8,102,26,22,31
8475792,2018,15.22,14.96,13,11,139,48,56,243,46,22,7,117,9,53,33
8475793,2018,14.95,14.3,29,21,136,38,51,225,64,14,11,122,783,95,43
8475794,2018,35.54,34.07,32,14,334,98,133,565,79,33,34,301,677,74,47
8475795,2018,0.07,0.07,0,0,6,1,6,13,0,0,0,6,0,19,2
8475796,2018,2.48,2.39,4,6,64,29,36,129,11,1,1,63,0,133,35
8475798,2018,17.38,17.11,26,11,187,63,77,327,53,16,20,171,129,46,47
8475799,2018,23.19,22.47,16,15,185,72,70,327,54,23,20,162,37,94,51
8475807,2018,8.68,8.45,2,2,102,32,27,161,11,7,5,95,48,86,26
8475808,2018,3.14,3.11,3,2,31,16,12,59,5,0,0,31,124,53,7
8475810,2018,17.1,16.41,10,7,141,57,34,232,35,18,13,123,8,119,30
8475820,2018,13.36,12.88,12,11,115,37,35,187,37,14,9,101,1,36,24
8475832,2018,3.55,3.44,4,1,30,13,14,57,9,4,2,26,0,48,8
8475834,2018,11.87,11.45,7,6,100,38,31,169,30,17,10,83,12,87,33
8475841,2018,1.44,1.43,5,6,41,16,35,92,13,2,4,39,0,16,11
8475842,2018,0.46,0.45,1,0,5,0,0,5,1,0,0,5,19,15,1
8475844,2018,6.93,6.78,8,8,79,41,24,144,22,6,6,73,15,143,25
8475848,2018,32.88,31.58,9,10,302,102,152,556,52,33,22,269,23,125,57
8475855,2018,12.08,11.33,4,8,79,19,20,118,20,8,7,71,7,120,25
8475857,2018,1.52,1.45,2,1,44,20,33,97,3,0,1,44,0,31,7
8475868,2018,1.57,1.5,1,2,29,18,21,68,3,0,1,29,0,80,6
8475869,2018,0.34,0.33,0,1,7,5,12,24,1,0,0,7,0,17,2
8475902,2018,0.74,0.69,1,0,16,5,12,33,1,0,0,16,0,20,2
8475906,2018,7.77,7.36,11,23,154,65,127,346,45,11,12,143,0,42,26
8475907,2018,19.7,19.02,18,5,156,51,44,251,40,17,22,139,23,182,36
8475913,2018,24.73,23.85,24,15,198,75,72,345,72,33,19,165,28,72,122
8475982,2018,0.06,0.06,0,0,2,0,1,3,0,0,0,2,0,16,0
8476043,2018,1.31,1.3,2,0,19,9,18,46,5,3,0,16,16,19,4
8476166,2018,2.58,2.5,5,2,86,14,53,153,11,4,1,82,0,19,14
8476177,2018,1.03,1.02,0,0,14,3,6,23,1,1,0,13,2,11,5
8476191,2018,0.97,0.96,4,3,32,16,33,81,7,0,1,32,0,73,18
8476195,2018,0.01,0.01,0,0,1,0,0,1,0,0,0,1,0,0,0
8476207,2018,5.01,4.93,8,3,50,22,19,91,19,8,3,42,13,40,26
8476278,2018,0.7,0.69,0,0,5,4,3,12,0,0,1,5,13,10,2
8476285,2018,2.39,2.32,5,2,35,7,20,62,10,3,1,32,80,33,12
8476288,2018,16.88,16.24,19,12,159,35,55,249,57,26,13,133,39,54,25
8476292,2018,11.35,10.89,11,15,100,35,49,184,34,8,8,92,2,104,18
8476293,2018,1.82,1.76,2,1,25,4,9,38,3,0,2,25,1,29,4
8476310,2018,5.59,5.35,1,1,43,17,10,70,6,4,5,39,43,69,6
8476312,2018,3.9,3.75,11,2,95,28,61,184,16,3,2,92,0,177,34
8476323,2018,2.16,2.07,0,0,12,8,5,25,1,1,1,11,0,21,1
8476326,2018,11.85,11.85,6,4,91,36,36,163,22,12,7,79,12,161,18
8476329,2018,4.15,4.17,9,6,35,23,19,77,20,5,1,30,75,13,14
8476331,2018,3.99,3.79,10,8,109,43,63,215,22,4,12,105,0,122,16
8476346,2018,27.36,26.51,39,25,245,93,98,436,100,36,18,209,1,12,58
8476356,2018,8.54,8.48,7,4,92,26,43,161,11,0,4,92,5,69,35
8476368,2018,1.65,1.6,3,1,44,31,32,107,6,2,2,42,0,76,9
8476370,2018,1.73,1.68,1,0,22,12,11,45,1,0,0,22,36,36,9
8476372,2018,2.53,2.49,2,3,67,30,56,153,7,2,3,65,0,78,5
8476374,2018,10.57,10.16,8,5,134,29,46,209,21,8,9,126,285,129,34
8476381,2018,18.24,17.76,18,10,135,40,48,223,47,19,17,116,181,128,16
8476389,2018,12.29,12.04,11,10,158,77,46,281,31,10,14,148,497,112,55
8476392,2018,12.98,12.67,4,6,105,41,32,178,22,12,11,93,643,223,42
8476393,2018,13.47,12.86,12,8,145,35,55,235,27,7,13,138,244,115,39
8476396,2018,0.35,0.36,0,0,9,1,1,11,0,0,0,9,8,6,4
8476399,2018,22.84,22.02,9,5,213,69,59,341,36,22,16,191,109,225,50
8476407,2018,1.27,1.23,2,1,32,19,25,76,4,1,3,31,0,47,6
8476409,2018,1.24,1.29,0,1,11,3,6,20,4,3,0,8,13,14,3
8476410,2018,12.57,11.99,9,2,150,63,62,275,25,14,11,136,15,44,37
8476415,2018,0.53,0.54,0,1,6,3,1,10,1,0,0,6,3,9,1
8476419,2018,7.07,6.84,5,3,83,23,23,129,12,4,8,79,258,63,21
8476422,2018,4.35,4.21,3,6,101,50,74,225,12,3,6,98,0,48,12
8476423,2018,0,0,0,0,0,0,0,0,0,0,0,0,0,1,0
8476427,2018,10.49,10.01,6,1,84,20,20,124,11,4,9,80,1,57,22
8476428,2018,6.71,6.5,3,4,81,22,26,129,12,5,7,76,4,32,27
8476429,2018,4.82,4.74,5,11,103,58,112,273,20,4,8,99,0,118,10
8476431,2018,0.08,0.08,0,0,3,0,5,8,0,0,0,3,0,1,2
8476432,2018,17.31,16.71,16,6,170,66,47,283,38,16,12,154,626,158,42
8476436,2018,4.98,4.88,1,5,48,27,17,92,8,2,3,46,0,87,13
8476437,2018,4.43,4.32,3,3,55,22,23,100,9,3,4,52,204,40,13
8476438,2018,23.93,23.26,17,7,195,65,58,318,47,23,13,172,24,52,35
8476439,2018,4.74,4.6,0,2,57,22,27,106,6,4,2,53,2,126,7
8476440,2018,12.81,12.32,6,4,123,38,38,199,22,12,3,111,149,46,32
8476441,2018,4.22,4.22,8,1,100,36,65,201,11,2,4,98,0,128,9
8476442,2018,8.88,8.61,11,6,85,31,23,139,20,3,8,82,9,50,19
8476443,2018,1.37,1.35,1,2,32,18,19,69,3,0,2,32,0,32,5
8476447,2018,5.83,5.6,1,3,51,12,10,73,7,3,3,48,2,72,6
8476448,2018,21.45,20.98,20,12,169,75,72,316,56,24,11,145,588,51,74
8476449,2018,2.9,2.81,6,9,54,31,27,112,17,2,5,52,0,73,9
8476453,2018,27.57,27.29,52,34,246,117,136,499,127,41,12,205,0,44,58
8476454,2018,22.34,21.39,15,24,208,65,84,357,67,28,19,180,380,69,59
8476455,2018,28.52,27.57,23,18,241,77,43,361,73,32,15,209,360,120,46
8476456,2018,24.57,23.84,40,22,226,73,59,358,92,30,20,196,12,57,44
8476457,2018,4.07,4,9,9,117,53,73,243,21,3,7,114,0,256,25
8476458,2018,13.41,12.82,11,5,111,37,43,191,35,19,6,92,365,76,37
8476459,2018,22.02,21.1,25,18,236,80,76,392,73,30,13,206,831,134,69
8476460,2018,28.11,26.83,26,18,200,74,62,336,82,38,17,162,803,54,74
8476461,2018,26.47,25.58,27,17,221,95,67,383,76,32,16,189,755,40,47
8476462,2018,13.12,12.71,12,9,259,108,174,541,39,18,25,241,0,160,35
8476463,2018,4.19,4.15,6,8,109,32,69,210,18,4,5,105,0,61,29
8476465,2018,0.03,0.03,1,0,1,1,3,5,1,0,0,1,0,1,1
8476466,2018,6.4,6.32,3,2,43,23,4,70,14,9,4,34,1,18,10
8476467,2018,2.41,2.34,3,5,55,26,36,117,12,4,3,51,0,135,10
8476468,2018,14.52,13.92,16,18,108,50,33,191,47,13,9,95,259,115,42
8476469,2018,12.03,12.01,7,3,134,34,54,222,23,13,12,121,5,112,46
8476470,2018,2.07,1.99,4,5,60,19,27,106,12,3,5,57,0,60,9
8476472,2018,7.23,6.82,9,14,167,60,104,331,28,5,9,162,0,44,26
8476473,2018,2.39,2.37,2,6,84,18,53,155,13,5,3,79,0,119,14
8476474,2018,8.09,7.74,2,2,64,26,12,102,7,3,4,61,23,95,17
8476476,2018,1.41,1.4,4,2,40,32,47,119,7,1,1,39,0,37,5
8476477,2018,1.65,1.68,0,0,10,5,5,20,1,1,1,9,0,4,0
8476479,2018,16.41,15.51,25,15,132,49,55,236,52,12,13,120,881,95,49
8476480,2018,13.97,13.52,14,6,119,28,59,206,31,11,9,108,22,140,32
8476483,2018,17.9,17.54,17,6,194,62,89,345,41,18,13,176,17,82,41
8476525,2018,4.69,4.43,13,13,131,52,135,318,29,3,13,128,0,122,22
8476539,2018,28.01,27.19,16,18,278,100,108,486,59,25,17,253,92,98,51
8476545,2018,0.54,0.54,2,0,7,4,2,13,4,2,0,5,0,78,2
8476617,2018,3.05,2.98,1,2,22,12,13,47,4,1,1,21,1,6,9
8476624,2018,7.44,7.33,3,6,84,36,25,145,16,7,6,77,296,125,35
8476779,2018,4.21,4.17,3,4,72,28,36,136,12,5,2,67,0,18,22
8476792,2018,7.51,7.2,25,22,151,74,93,318,53,6,12,145,0,53,20
8476799,2018,0.05,0.05,0,1,2,2,2,6,1,0,0,2,0,3,0
8476806,2018,4.85,4.73,3,2,56,15,25,96,8,3,7,53,5,98,16
8476807,2018,0.07,0.07,0,0,4,1,3,8,0,0,0,4,0,10,0
8476822,2018,13.18,12.91,9,4,102,44,23,169,23,10,9,92,658,198,23
8476826,2018,18.71,17.98,16,10,130,40,39,209,48,22,17,108,150,83,50
8476850,2018,4.6,4.42,13,15,71,28,41,140,29,1,1,70,0,27,22
8476851,2018,20.37,19.39,12,10,161,71,59,291,41,19,11,142,188,62,28
8476853,2018,9.27,9.14,25,25,224,85,181,490,70,20,14,204,0,61,60
8476854,2018,8.03,7.85,7,15,125,54,90,269,28,6,7,119,0,81,23
8476856,2018,4.98,4.8,5,4,93,37,70,200,21,12,4,81,0,60,10
8476857,2018,9.11,8.74,7,6,101,49,61,211,25,12,10,89,2,45,15
8476858,2018,2.74,2.72,1,2,31,18,9,58,4,1,1,30,3,54,9
8476867,2018,0.15,0.15,1,1,2,0,0,2,3,1,0,1,8,4,0
8476869,2018,5.65,5.52,9,8,126,43,60,229,25,8,9,118,1,178,32
8476871,2018,14.8,14.41,7,2,147,44,57,248,27,18,9,129,5,128,21
8476872,2018,15.34,14.58,11,9,128,43,38,209,32,12,14,116,344,146,42
8476873,2018,11.81,11.31,12,6,99,54,41,194,32,14,8,85,426,30,49
8476874,2018,2.82,2.75,7,6,74,38,56,168,14,1,6,73,0,97,16
8476875,2018,5.6,5.52,10,8,129,32,75,236,26,8,2,121,0,63,64
8476877,2018,0.36,0.35,2,0,11,2,6,19,2,0,0,11,0,10,1
8476878,2018,8.61,8.53,6,7,78,34,20,132,18,5,1,73,28,144,21
8476879,2018,6.36,6.22,14,5,132,54,97,283,26,7,13,125,0,120,20
8476880,2018,18.82,17.62,9,9,130,59,40,229,40,22,9,108,29,200,43
8476881,2018,27.31,26.36,24,15,175,74,59,308,74,35,14,140,609,53,57
8476882,2018,19.35,18.09,36,19,167,78,73,318,76,21,17,146,18,35,55
8476884,2018,2.35,2.19,4,5,58,42,50,150,12,3,3,55,0,76,19
8476885,2018,7.89,7.78,17,25,162,89,116,367,50,8,13,154,0,112,48
8476886,2018,1.26,1.21,2,2,36,10,23,69,6,2,3,34,0,54,4
8476887,2018,24.79,23.83,16,6,217,101,117,435,50,28,20,189,1,100,69
8476889,2018,17.71,16.25,12,3,113,48,36,197,29,14,6,99,570,103,42
8476891,2018,3.5,3.42,7,8,89,45,48,182,18,3,3,86,0,46,28
8476892,2018,6.13,5.87,8,10,174,80,96,350,27,9,10,165,0,127,33
8476894,2018,7.77,7.43,11,5,92,35,31,158,23,7,9,85,7,56,22
8476897,2018,15.06,15.08,10,7,113,51,41,205,31,14,4,99,227,101,40
8476902,2018,7.28,7.08,8,13,132,43,82,257,32,11,9,121,0,143,30
8476905,2018,5.42,5.25,4,2,36,14,15,65,11,5,2,31,47,38,18
8476906,2018,9.54,8.97,13,16,180,66,127,373,38,9,17,171,0,46,20
8476907,2018,3.65,3.55,1,1,33,8,7,48,5,3,1,30,0,49,6
8476913,2018,9.59,9.16,11,7,83,34,46,163,28,10,3,73,86,94,29
8476915,2018,6.41,6.16,11,4,64,20,22,106,18,3,4,61,55,123,22
8476917,2018,4.67,4.62,7,9,110,48,60,218,21,5,8,105,0,149,37
8476918,2018,20.05,18.5,14,4,153,49,63,265,35,17,15,136,8,79,50
8476919,2018,12.82,12.34,22,15,117,32,42,191,47,10,11,107,532,30,53
8476921,2018,21.61,20.69,7,3,146,72,52,270,25,15,18,131,151,199,53
8476922,2018,2.97,2.87,3,3,34,8,11,53,10,4,2,30,88,33,12
8476923,2018,8.1,7.75,18,10,146,44,72,262,39,11,10,135,0,83,25
8476924,2018,2.96,2.88,4,1,28,15,15,58,6,1,3,27,0,35,3
8476925,2018,16.21,15.62,8,7,110,49,37,196,30,15,4,95,421,109,35
8476927,2018,3.33,3.23,3,1,33,6,12,51,10,6,1,27,41,51,6
8476931,2018,3.08,2.98,3,7,64,31,42,137,14,4,2,60,0,102,20
8476934,2018,16.64,16.15,7,8,123,64,65,252,25,10,7,113,26,138,54
8476941,2018,2.31,2.21,4,5,42,16,24,82,11,2,6,40,0,25,15
8476948,2018,5.15,4.98,1,1,50,18,19,87,5,3,1,47,4,73,9
8476952,2018,0.3,0.23,0,0,1,0,0,1,1,1,0,0,0,0,0
8476953,2018,0.02,0.02,0,0,0,1,1,2,0,0,0,0,0,1,0
8476958,2018,8.69,8.34,8,14,146,65,93,304,30,8,21,138,0,70,86
8476960,2018,22.47,22.1,17,7,216,88,83,387,54,30,6,186,171,33,26
8476966,2018,1.09,1.06,1,0,14,0,2,16,3,2,0,12,2,13,5
8476967,2018,3.96,3.84,3,7,101,35,66,202,16,6,2,95,0,107,15
8476971,2018,0.3,0.31,0,0,2,2,1,5,0,0,0,2,0,0,1
8476975,2018,11.2,11.13,3,1,86,31,24,141,17,13,4,73,404,269,21
8476979,2018,7.6,7.34,23,19,160,68,116,344,59,17,6,143,0,100,34
8476981,2018,25.31,24.73,10,10,231,74,78,383,47,27,12,204,12,214,46
8476982,2018,0.63,0.62,0,0,2,2,0,4,0,0,1,2,1,0,0
8476983,2018,1.22,1.19,1,2,33,16,26,75,5,2,1,31,0,51,2
8476988,2018,2.87,2.77,5,6,94,35,52,181,16,5,5,89,0,109,10
8476994,2018,17.01,16.25,13,11,151,45,67,263,40,16,18,135,39,69,28
8477009,2018,0.25,0.25,1,0,7,5,13,25,1,0,0,7,0,54,4
8477010,2018,0.61,0.57,0,0,8,3,4,15,0,0,1,8,0,10,3
8477015,2018,9.37,9.22,13,7,84,49,27,160,27,7,6,77,20,35,31
8477018,2018,4.24,4.19,6,10,112,42,99,253,21,5,3,107,0,55,27
8477021,2018,14.67,14.22,13,14,115,35,44,194,41,14,13,101,274,22,22
8477034,2018,1.24,1.22,2,1,31,12,22,65,4,1,4,30,0,32,11
8477043,2018,1.16,1.16,5,3,32,13,29,74,9,1,4,31,0,18,10
8477046,2018,1.05,1.02,0,7,36,13,32,81,7,0,5,36,0,43,11
8477073,2018,0.43,0.41,1,0,5,5,7,17,1,0,3,5,0,26,0
8477085,2018,0.58,0.58,0,1,21,7,9,37,1,0,1,21,0,25,3
8477205,2018,0.08,0.08,0,0,6,1,2,9,0,0,0,6,0,3,0
8477213,2018,4.53,4.14,6,1,44,14,13,71,10,3,7,41,1,66,14
8477215,2018,2.91,2.86,13,2,59,28,45,132,20,5,2,54,0,79,14
8477220,2018,7.01,6.89,10,12,113,41,78,232,31,9,11,104,0,37,45
8477240,2018,7.15,6.95,8,5,53,20,15,88,20,7,6,46,171,178,22
8477244,2018,0.54,0.52,0,1,22,8,16,46,2,1,1,21,0,40,7
8477290,2018,8.01,7.86,6,6,65,29,30,124,18,6,6,59,14,96,28
8477320,2018,0,0,0,0,0,0,0,0,0,0,0,0,0,6,1
8477337,2018,0.19,0.17,0,0,9,4,6,19,0,0,0,9,0,3,1
8477341,2018,16.05,14.81,12,9,130,49,36,215,41,20,9,110,7,60,25
8477343,2018,0.1,0.11,0,1,3,0,1,4,2,1,0,2,0,4,0
8477346,2018,2.86,2.63,5,6,79,28,49,156,15,4,3,75,1,127,34
8477353,2018,11.45,10.85,4,3,114,41,39,194,16,9,11,105,15,200,34
8477355,2018,5.79,5.6,12,15,108,56,57,221,31,4,11,104,0,38,17
8477357,2018,3.69,3.68,4,1,36,11,9,56,9,4,1,32,6,45,12
8477365,2018,0.88,0.88,0,1,22,6,23,51,1,0,5,22,0,40,10
8477366,2018,1.2,1.16,0,1,19,4,4,27,1,0,2,19,51,31,6
8477380,2018,1.92,1.84,1,0,17,11,7,35,3,2,3,15,1,23,3
8477384,2018,1.34,1.33,0,0,28,14,23,65,1,1,1,27,0,79,12
8477399,2018,0.17,0.16,0,0,3,1,0,4,0,0,0,3,0,6,1
8477401,2018,4.39,4.25,1,1,42,25,23,90,5,3,3,39,6,97,14
8477402,2018,14.6,14.07,9,8,119,45,48,212,38,21,12,98,7,60,29
8477404,2018,28.04,26.71,17,19,227,75,73,375,76,40,19,187,10,105,45
8477406,2018,11.94,11.85,13,5,106,36,34,176,25,7,10,99,10,28,30
8477407,2018,14.54,14.43,5,9,132,42,48,222,33,19,10,113,2,32,33
8477413,2018,7.2,6.95,6,4,96,35,45,176,17,7,4,89,3,29,22
8477416,2018,14.97,14.78,12,1,161,51,49,261,36,23,12,138,5,43,30
8477417,2018,3.99,3.88,1,1,30,17,10,57,6,4,2,26,0,5,13
8477425,2018,14.02,13.6,10,4,159,54,40,253,24,10,6,149,0,97,19
8477426,2018,2.98,2.82,0,1,30,6,9,45,2,1,2,29,16,28,5
8477429,2018,10.55,10.22,7,7,81,28,29,138,25,11,10,70,198,71,22
8477433,2018,2.46,2.42,3,1,50,20,29,99,5,1,2,49,0,89,16
8477435,2018,0.99,0.92,1,1,26,15,21,62,5,3,0,23,0,32,5
8477444,2018,9.1,9.08,8,5,100,33,45,178,25,12,6,88,7,34,28
8477447,2018,11.24,11.02,15,9,202,75,145,422,36,12,23,190,1,27,82
8477448,2018,0.24,0.24,0,0,3,3,3,9,0,0,0,3,0,16,3
8477450,2018,9.99,9.37,9,7,94,32,28,154,22,6,5,88,201,106,30
8477451,2018,15.2,14.68,6,8,145,45,55,245,26,12,10,133,4,107,35
8477452,2018,0.62,0.62,0,1,15,12,6,33,2,1,0,14,0,41,5
8477454,2018,7.49,7.38,6,7,70,33,32,135,20,7,4,63,11,159,16
8477455,2018,4.55,4.31,3,3,55,14,26,95,9,3,2,52,161,72,17
8477456,2018,16.86,16.08,9,8,118,37,42,197,33,16,15,102,300,33,23
8477458,2018,4.04,3.68,1,2,29,16,12,57,5,2,4,27,2,26,9
8477460,2018,0.5,0.49,0,0,2,1,1,4,0,0,1,2,0,0,0
8477461,2018,1.28,1.3,0,1,9,11,3,23,1,0,0,9,1,30,3
8477462,2018,4.29,4.17,10,4,86,49,63,198,19,5,9,81,0,258,4
8477463,2018,1.61,1.62,1,2,41,19,16,76,4,1,0,40,0,80,9
8477464,2018,0.88,0.88,1,1,15,4,7,26,3,1,1,14,11,2,4
8477471,2018,0.32,0.3,1,0,5,2,1,8,1,0,2,5,0,6,0
8477472,2018,1.13,1.14,2,4,42,13,23,78,6,0,1,42,0,33,9
8477473,2018,0.29,0.27,1,0,5,2,7,14,1,0,0,5,0,9,3
8477474,2018,2.28,2.23,4,4,48,30,35,113,10,2,3,46,0,72,9
8477476,2018,18.22,17.48,14,7,177,49,66,292,33,12,11,165,5,119,46
8477478,2018,9.48,9.02,1,0,84,23,26,133,9,8,10,76,0,277,30
8477479,2018,16.2,15.59,11,15,131,61,57,249,47,21,3,110,10,76,34
8477482,2018,8.92,8.81,8,4,76,32,32,140,20,8,4,68,8,48,31
8477488,2018,4.35,4.22,12,10,98,36,61,195,29,7,9,91,1,52,54
8477492,2018,33.78,33.41,31,25,366,90,134,590,98,42,24,324,517,54,47
8477493,2018,25.75,24.93,37,25,206,71,41,318,97,35,14,171,1040,27,99
8477494,2018,14.79,14.3,26,9,189,57,78,324,53,18,11,171,37,55,50
8477495,2018,9.06,8.61,19,17,183,93,101,377,45,9,14,174,0,106,59
8477496,2018,20.66,19.82,26,25,182,64,65,311,78,27,19,155,509,82,50
8477497,2018,33.56,32.52,30,18,211,67,81,359,82,34,19,177,455,36,78
8477498,2018,8.81,8.63,12,19,196,71,128,395,41,10,14,186,0,162,30
8477499,2018,8.95,8.69,22,16,182,63,87,332,43,5,11,177,0,236,23
8477500,2018,26.51,25.82,15,17,227,65,63,355,59,27,18,200,1081,62,28
8477501,2018,5.52,5.44,3,7,64,19,26,109,10,0,3,64,3,71,24
8477502,2018,0.05,0.05,0,0,5,0,4,9,0,0,1,5,0,9,1
8477503,2018,21,20.32,27,17,202,70,89,361,72,28,24,174,447,53,47
8477504,2018,5.59,5.4,8,15,96,36,57,189,30,7,5,89,1,55,33
8477505,2018,6.82,6.57,13,10,64,26,21,111,25,2,2,62,341,34,34
8477506,2018,9.6,9.2,15,12,179,62,140,381,36,9,14,170,0,143,35
8477507,2018,4.07,3.96,6,1,100,42,67,209,14,7,4,93,0,228,21
8477508,2018,0,0,0,0,0,0,0,0,0,0,0,0,3,0,0
8477509,2018,1.18,1.14,5,5,39,18,37,94,11,1,3,38,0,75,22
8477510,2018,0.01,0.01,0,0,1,0,0,1,0,0,0,1,0,3,0
8477511,2018,19.23,18.34,15,8,198,56,81,335,48,25,12,173,22,67,37
8477512,2018,4.76,4.73,5,6,46,18,23,87,14,3,5,43,240,98,12
8477520,2018,3.54,3.53,0,2,29,10,11,50,6,4,1,25,53,21,13
8477527,2018,1.92,1.69,2,1,12,2,3,17,4,1,1,11,0,43,2
8477529,2018,7.17,7.09,2,3,58,22,20,100,8,3,4,55,200,73,22
8477541,2018,0,0,0,0,0,0,0,0,0,0,0,0,0,0,0
8477573,2018,0.28,0.28,1,0,2,2,1,5,1,0,0,2,0,5,0
8477680,2018,1.93,1.83,2,1,19,5,10,34,5,2,0,17,2,39,3
8477810,2018,0.41,0.41,0,0,9,8,7,24,0,0,0,9,0,16,3
8477839,2018,15.16,14.71,10,10,147,50,51,248,34,14,9,133,19,29,35
8477845,2018,4,3.57,5,6,102,43,59,204,14,3,11,99,0,42,28
8477846,2018,10.56,10.49,5,8,102,39,34,175,18,5,3,97,161,126,30
8477850,2018,2.01,1.92,1,5,47,28,37,112,6,0,2,47,1,125,4
8477851,2018,5.09,5.05,6,7,77,58,78,213,19,6,7,71,0,58,23
8477865,2018,0.11,0.11,0,0,5,3,5,13,0,0,0,5,0,7,2
8477901,2018,0.95,0.99,0,0,11,3,4,18,1,1,0,10,0,9,3
8477903,2018,9.21,9.04,2,6,76,31,28,135,19,11,4,65,7,200,23
8477919,2018,5.03,4.9,1,0,43,21,11,75,4,3,5,40,156,25,13
8477922,2018,8.35,8.36,1,3,79,28,21,128,16,12,5,67,14,67,30
8477930,2018,12.31,11.81,7,2,108,34,44,186,15,6,16,102,394,71,38
8477931,2018,12.83,12.62,7,2,116,37,36,189,17,8,16,108,82,75,32
8477932,2018,9.67,9.46,7,16,181,50,85,316,37,14,17,167,0,114,47
8477933,2018,23.24,21.21,29,14,181,95,49,325,65,22,8,159,31,38,39
8477934,2018,30.43,29.18,33,22,231,80,93,404,105,50,19,181,678,57,71
8477935,2018,16.29,15.62,11,3,115,48,43,206,27,13,9,102,50,121,25
8477936,2018,3.79,3.75,4,0,34,7,11,52,7,3,0,31,0,10,7
8477937,2018,15.48,15.35,7,2,155,68,68,291,25,16,9,139,5,154,46
8477938,2018,0.66,0.65,1,0,17,10,13,40,1,0,1,17,0,25,3
8477939,2018,13.62,13.37,10,10,130,60,55,245,27,7,9,123,203,16,28
8477940,2018,15.02,14.71,8,8,159,48,59,266,37,21,9,138,1,27,28
8477941,2018,11.18,10.82,16,6,96,53,28,177,31,9,8,87,4,123,20
8477942,2018,18.99,18.05,15,10,174,73,69,316,38,13,14,161,3,42,44
8477943,2018,11.72,11.28,4,3,117,46,54,217,21,14,7,103,1,51,11
8477944,2018,16.41,16.18,15,8,161,70,46,277,47,24,10,137,4,47,41
8477945,2018,1.49,1.46,4,0,38,10,17,65,4,0,4,38,0,16,4
8477946,2018,30.28,28.51,25,14,285,95,112,492,71,32,21,253,865,80,69
8477947,2018,0.54,0.52,0,0,5,2,1,8,1,1,0,4,0,5,0
8477948,2018,7.45,6.71,13,13,121,41,80,242,35,9,11,112,0,45,20
8477949,2018,20.07,19.11,13,19,180,70,77,327,52,20,25,160,43,92,69
8477950,2018,3.89,3.77,11,14,110,30,66,206,29,4,6,106,0,54,21
8477951,2018,8.21,7.99,9,9,63,19,40,122,25,7,9,56,104,5,35
8477952,2018,4.28,4.2,2,1,43,17,22,82,5,2,3,41,4,30,5
8477953,2018,18.76,17.96,12,12,175,78,72,325,44,20,7,155,5,92,44
8477955,2018,12.41,12.37,12,4,150,37,53,240,35,19,10,131,275,77,35
8477956,2018,25.02,24.03,28,15,235,104,93,432,81,38,6,197,1,57,36
8477957,2018,1.36,1.3,0,0,12,4,1,17,1,1,2,11,0,9,0
8477958,2018,10.04,9.73,10,10,106,54,24,184,26,6,4,100,0,15,20
8477959,2018,0.81,0.79,1,0,10,3,2,15,2,1,0,9,0,0,3
8477960,2018,11.25,11.08,8,8,118,42,55,215,28,12,9,106,315,86,20
8477961,2018,1.6,1.55,0,0,16,15,9,40,1,1,2,15,4,21,5
8477962,2018,6.33,6.18,3,3,66,19,22,107,17,11,3,55,7,129,13
8477963,2018,4.15,4.15,2,3,35,15,9,59,12,7,2,28,14,101,10
8477964,2018,9.89,9.53,7,4,60,24,25,109,25,14,7,46,200,86,36
8477969,2018,4.42,4.08,12,11,87,59,75,221,25,2,5,85,1,101,24
8477971,2018,0.03,0.03,0,0,2,0,0,2,0,0,1,2,0,5,0
8477972,2018,0.02,0.02,0,0,1,1,0,2,0,0,0,1,0,2,0
8477973,2018,1.91,1.9,1,2,22,7,13,42,5,2,0,20,59,20,2
8477979,2018,0.09,0.09,0,0,2,2,4,8,0,0,0,2,0,14,2
8477986,2018,8.1,7.87,10,16,181,83,98,362,34,8,8,173,0,99,31
8477987,2018,13.45,12.92,6,9,139,55,58,252,25,10,10,129,11,24,30
8477989,2018,4.43,4.18,4,1,25,9,9,43,7,2,2,23,127,16,12
8477994,2018,0.07,0.06,0,0,2,0,3,5,0,0,0,2,8,3,1
8477996,2018,3.32,3.25,5,1,39,15,20,74,6,0,4,39,143,45,12
8477998,2018,13.94,13.33,3,2,106,49,42,197,15,10,12,96,10,126,36
8478010,2018,35.39,33.91,27,22,192,59,61,312,90,41,12,151,436,31,35
8478011,2018,0,0,0,0,0,0,1,1,0,0,0,0,0,1,0
8478017,2018,0.01,0.01,0,0,1,0,0,1,0,0,0,1,0,1,0
8478020,2018,4.24,4.03,2,5,37,19,27,83,13,6,2,31,95,16,19
8478027,2018,15.89,15.02,9,9,131,46,47,224,28,10,15,121,574,83,33
8478029,2018,0.28,0.31,0,0,4,1,0,5,0,0,1,4,0,1,0
8478031,2018,0.01,0.01,0,0,1,0,1,2,0,0,0,1,0,0,0
8478036,2018,3.66,3.54,2,4,49,16,27,92,9,3,3,46,84,70,10
8478038,2018,3.83,3.77,8,6,81,24,51,156,19,5,8,76,0,24,14
8478042,2018,22.9,22.41,7,7,196,77,64,337,48,34,14,162,2,18,41
8478046,2018,11.47,11.31,18,5,114,46,49,209,34,11,8,103,2,54,43
8478047,2018,0.77,0.77,0,0,5,3,3,11,1,1,1,4,0,6,0
8478055,2018,2.1,2.01,2,4,57,14,39,110,9,3,2,54,0,38,15
8478056,2018,1.36,1.35,2,0,16,8,13,37,3,1,1,15,69,39,5
8478067,2018,18.14,17.19,11,4,162,45,47,254,32,17,13,145,3,68,26
8478073,2018,0.04,0.04,0,0,0,2,0,2,0,0,0,0,0,1,0
8478075,2018,1.78,1.8,1,1,18,10,9,37,3,1,0,17,1,9,11
8478078,2018,1.41,1.42,0,0,19,8,6,33,1,1,1,18,34,14,0
8478099,2018,13.07,12.66,19,20,130,61,62,253,56,17,7,113,9,66,22
8478104,2018,2.79,2.78,2,0,27,8,7,42,4,2,0,25,1,93,11
8478106,2018,3.29,3.25,7,1,52,7,29,88,8,0,2,52,0,3,23
8478109,2018,1.55,1.47,2,0,21,10,8,39,4,2,2,19,0,2,1
8478131,2018,8.82,8.53,5,4,95,34,36,165,20,11,2,84,9,17,15
8478136,2018,0.02,0.02,0,1,0,1,0,1,1,0,0,0,0,1,1
8478176,2018,0.43,0.42,0,0,16,4,5,25,0,0,0,16,0,17,2
8478211,2018,4.45,4.33,3,4,53,15,21,89,10,3,2,50,0,66,10
8478233,2018,6.88,6.88,3,2,65,13,19,97,13,8,5,57,6,43,16
8478268,2018,0.22,0.2,0,0,2,1,2,5,0,0,0,2,0,8,0
8478365,2018,1.28,1.26,2,0,16,6,4,26,2,0,2,16,1,12,3
8478366,2018,20.79,19.61,7,8,207,58,58,323,39,24,23,183,15,138,33
8478373,2018,0.07,0.07,0,0,1,1,3,5,0,0,0,1,0,5,0
8478396,2018,6.91,6.43,9,17,116,51,75,242,31,5,12,111,0,87,50
8478397,2018,3.43,3.37,6,11,115,33,75,223,19,2,6,113,0,52,24
8478398,2018,28.2,26.91,20,12,227,69,59,355,66,34,21,193,8,9,56
8478399,2018,0.53,0.52,2,2,12,12,16,40,4,0,2,12,0,31,3
8478400,2018,16.87,15.78,12,14,123,62,43,228,40,14,14,109,379,23,21
8478401,2018,10.43,10.08,5,8,100,44,28,172,26,13,4,87,349,68,28
8478402,2018,29.98,29.18,56,18,240,87,96,423,115,41,17,199,428,39,98
8478403,2018,29.31,28.36,31,22,303,89,93,485,81,28,25,275,599,70,38
8478407,2018,8.2,8.08,13,10,151,45,108,304,35,12,10,139,0,48,18
8478408,2018,3.45,3.31,5,9,98,43,66,207,18,4,4,94,0,100,26
8478409,2018,0,0,0,0,0,0,0,0,0,0,0,0,0,0,0
8478413,2018,13.58,12.5,7,6,107,48,49,204,25,12,14,95,31,57,33
8478414,2018,29.32,28.64,20,13,249,96,98,443,63,30,28,219,12,99,49
8478415,2018,0.04,0.04,0,0,1,1,0,2,0,0,0,1,0,3,0
8478416,2018,3.75,3.75,6,5,107,34,45,186,16,5,4,102,0,198,11
8478417,2018,2.5,2.2,3,3,21,3,10,34,9,3,4,18,95,14,9
8478420,2018,20.26,19.74,34,20,194,67,83,344,86,32,13,162,17,59,38
8478421,2018,1.37,1.39,1,0,9,2,3,14,2,1,1,8,2,20,4
8478425,2018,0.85,0.79,1,0,15,7,7,29,1,0,2,15,0,9,1
8478427,2018,30.63,29.54,29,24,243,124,99,466,83,30,24,213,585,65,81
8478430,2018,1.25,1.24,2,3,21,16,23,60,8,3,2,18,0,11,13
8478432,2018,11.17,10.91,4,3,116,38,39,193,18,11,11,105,2,124,12
8478439,2018,18.79,17.83,14,11,181,69,45,295,49,24,16,157,7,65,38
8478440,2018,13.66,13.24,19,17,146,41,49,236,56,20,7,126,435,13,47
8478442,2018,0.65,0.62,0,0,6,5,2,13,0,0,1,6,9,0,5
8478443,2018,5.24,5.12,5,3,116,48,54,218,10,2,6,114,1,134,43
8478444,2018,19.55,19.29,17,13,210,80,114,404,56,26,11,184,39,14,40
8478445,2018,19.93,19.27,24,20,179,51,63,293,62,18,16,161,241,25,66
8478449,2018,11.79,10.78,9,5,98,30,36,164,22,8,9,90,217,87,33
8478452,2018,0.71,0.7,2,3,21,8,15,44,6,1,0,20,0,19,13
8478454,2018,0.49,0.48,1,4,21,7,19,47,5,0,0,21,0,60,6
8478455,2018,8.23,7.87,6,3,67,25,27,119,21,12,5,55,2,142,8
8478458,2018,6.69,6.25,11,4,74,19,32,125,24,9,8,65,91,32,25
8478460,2018,9.5,8.93,20,13,168,78,101,347,44,11,7,157,0,67,40
8478462,2018,0.09,0.08,0,0,1,1,1,3,0,0,0,1,21,7,3
8478463,2018,17.74,17.39,4,6,156,48,43,247,28,18,10,138,26,87,34
8478465,2018,0.18,0.18,0,0,5,1,4,10,0,0,0,5,0,3,2
8478466,2018,8.85,8.39,6,3,125,52,50,227,23,14,8,111,4,35,18
8478468,2018,0.35,0.35,0,0,11,6,12,29,1,1,0,10,0,15,4
8478469,2018,9.33,9.03,13,27,185,59,133,377,54,14,12,171,0,71,31
8478472,2018,9.77,9.85,10,3,95,31,36,162,26,13,10,82,10,129,28
8478474,2018,12.66,12.05,11,3,131,52,31,214,25,11,11,120,24,288,25
8478476,2018,0.03,0.03,0,0,1,0,2,3,0,0,0,1,0,2,0
8478483,2018,22.46,21.9,52,17,233,86,130,449,95,26,20,207,7,29,78
8478485,2018,1.42,1.45,0,0,4,3,1,8,1,1,0,3,0,1,0
8478488,2018,1.1,1.02,0,0,9,3,1,13,1,1,1,8,8,1,2
8478491,2018,2.18,2.08,2,3,57,30,39,126,5,0,6,57,0,41,10
8478493,2018,11.09,10.51,7,0,109,26,28,163,14,7,12,102,247,115,18
8478495,2018,2.24,2.17,0,2,23,12,7,42,3,1,0,22,1,23,2
8478498,2018,18.53,18.24,7,7,156,58,46,260,41,27,5,129,8,45,42
8478500,2018,7.79,7.64,5,13,146,45,104,295,25,7,7,139,0,123,16
8478502,2018,0,0,0,0,0,0,0,0,0,0,0,0,0,6,0
8478506,2018,0.01,0.01,0,0,1,0,0,1,0,0,0,1,0,0,1
8478512,2018,7.45,7.2,5,6,65,27,28,120,17,6,2,59,30,10,24
8478519,2018,18.1,17.61,13,6,123,40,40,203,38,19,9,104,502,94,46
8478541,2018,5.26,5.16,3,1,52,18,18,88,8,4,4,48,0,63,15
8478542,2018,11.02,10.56,15,5,167,56,59,282,29,9,10,158,304,33,34
8478550,2018,17.67,17.28,44,15,191,66,103,360,87,28,11,163,1,14,31
8478561,2018,1.54,1.52,3,0,21,7,6,34,4,1,3,20,3,83,3
8478567,2018,0.66,0.67,3,2,16,5,15,36,5,0,0,16,0,16,4
8478569,2018,10.82,10.85,5,3,99,38,22,159,14,6,7,93,200,221,35
8478585,2018,10.76,10.62,14,10,103,38,38,179,37,13,2,90,440,19,54
8478831,2018,0.23,0.21,0,0,3,2,4,9,0,0,1,3,3,3,3
8478840,2018,0.04,0.03,0,0,2,0,2,4,0,0,0,2,0,12,0
8478841,2018,0.03,0.03,0,0,1,2,3,6,0,0,0,1,0,2,0
8478843,2018,5.49,5.38,6,3,65,26,26,117,16,7,5,58,36,40,16
8478844,2018,0.73,0.71,0,1,10,3,0,13,2,1,0,9,25,4,5
8478846,2018,1.5,1.48,3,5,36,8,25,69,12,4,2,32,0,11,15
8478856,2018,10.67,10.45,0,5,118,35,27,180,18,13,8,105,10,33,25
8478866,2018,11.15,10.97,12,8,121,40,45,206,28,8,11,113,6,89,33
8478868,2018,2.01,1.92,3,6,65,19,34,118,10,1,4,64,0,110,17
8478870,2018,7.17,7.03,4,5,48,25,15,88,14,5,10,43,1,18,11
8478873,2018,3.32,3.26,6,3,25,13,21,59,13,4,3,21,1,4,14
8478874,2018,4.85,4.77,4,3,55,28,27,110,12,5,3,50,150,48,9
8478881,2018,4.42,4.32,5,3,49,12,13,74,13,5,5,44,98,48,17
8478891,2018,2.38,2.31,6,0,29,12,12,53,9,3,1,26,0,28,4
8478906,2018,4.75,4.58,8,7,99,33,47,179,20,5,6,94,0,80,25
8478911,2018,1.28,1.22,0,4,34,21,21,76,6,2,4,32,0,38,4
8478915,2018,1.2,1.2,1,2,19,10,17,46,4,1,2,18,0,10,3
8478949,2018,0.08,0.07,0,0,2,0,1,3,0,0,0,2,0,10,1
8479026,2018,0.85,0.81,0,1,25,17,25,67,2,1,0,24,0,42,7
8479066,2018,0.12,0.12,0,0,1,1,1,3,0,0,0,1,0,12,1
8479206,2018,0.9,0.88,1,0,6,4,3,13,1,0,0,6,17,18,1
8479250,2018,0.86,0.82,0,0,11,6,6,23,0,0,1,11,5,16,3
8479268,2018,1.04,1.04,2,3,37,17,29,83,6,1,0,36,0,44,5
8479290,2018,0.52,0.51,0,0,11,1,5,17,1,1,0,10,30,5,0
8479291,2018,4.95,4.78,1,3,39,17,6,62,10,6,1,33,187,77,15
8479293,2018,12.47,12.21,11,4,127,46,46,219,29,14,11,113,3,278,22
8479314,2018,27.46,26.45,26,17,206,66,71,343,77,34,23,172,6,104,41
8479315,2018,4.99,4.63,2,0,49,10,13,72,6,4,5,45,9,42,12
8479316,2018,7.1,6.88,8,3,87,37,38,162,17,6,10,81,88,67,12
8479318,2018,30.55,29.18,23,13,252,109,88,449,73,37,19,215,475,28,57
8479320,2018,4.91,4.51,3,5,79,33,53,165,15,7,8,72,0,34,13
8479324,2018,0.33,0.29,0,0,8,0,1,9,0,0,0,8,0,11,0
8479325,2018,4.53,4.43,13,8,79,32,45,156,28,7,4,72,0,90,30
8479330,2018,0.01,0.01,0,0,1,0,0,1,0,0,0,1,0,0,0
8479333,2018,0.19,0.18,0,0,10,0,1,11,1,1,1,9,0,5,4
8479336,2018,5.56,5.38,0,1,27,24,8,59,6,5,7,22,0,38,8
8479337,2018,22.77,22.27,16,18,220,79,105,404,75,41,9,179,16,35,51
8479339,2018,24.44,24.07,16,3,245,109,116,470,49,30,16,215,11,70,28
8479343,2018,18.4,17.87,19,14,200,76,74,350,47,14,20,186,28,16,46
8479344,2018,4.38,4.26,3,2,53,26,32,111,9,4,3,49,2,45,20
8479345,2018,10.6,8.94,5,10,117,69,67,253,20,5,9,112,0,74,19
8479346,2018,3.06,2.98,0,4,22,8,13,43,5,1,1,21,15,11,6
8479351,2018,2.88,2.84,4,1,33,10,9,52,11,6,2,27,108,9,7
8479353,2018,8.97,8.72,11,5,74,37,15,126,22,6,4,68,353,64,28
8479364,2018,0.19,0.18,0,0,2,3,1,6,0,0,0,2,0,15,0
8479365,2018,1.41,1.36,0,0,19,3,2,24,0,0,2,19,41,18,5
8479366,2018,0.19,0.17,0,0,2,1,0,3,0,0,0,2,2,0,1
8479368,2018,6.83,6.47,2,1,57,27,25,109,5,2,4,55,1,30,12
8479370,2018,11.99,11.9,7,8,114,34,50,198,26,11,6,103,56,48,29
8479371,2018,0.07,0.06,0,0,5,0,2,7,1,1,0,4,0,3,2
8479372,2018,0.77,0.76,2,2,21,7,17,45,5,1,1,20,0,13,9
8479376,2018,4.77,4.38,4,7,65,30,69,164,11,0,9,65,0,21,10
8479385,2018,1.07,1.01,2,0,16,4,4,24,3,1,0,15,2,2,3
8479388,2018,0.01,0.01,0,0,1,0,1,2,0,0,0,1,0,5,0
8479395,2018,6.28,6.1,4,4,71,39,42,152,15,7,2,64,1,18,7
8479398,2018,4.06,3.94,13,10,116,37,126,279,27,4,11,112,1,65,25
8479400,2018,19.83,18.71,19,15,174,74,61,309,61,27,12,147,455,115,45
8479402,2018,0.01,0.01,0,0,1,0,1,2,0,0,0,1,0,1,1
8479404,2018,5.17,5.04,1,9,54,18,18,90,18,8,2,46,164,11,21
8479407,2018,6.96,6.57,13,12,92,29,20,141,34,9,12,83,4,36,17
8479410,2018,6.37,5.99,15,11,128,58,84,270,32,6,8,122,1,97,18
8479411,2018,0.28,0.27,0,0,0,3,2,5,0,0,0,0,0,0,4
8479414,2018,1.74,1.4,0,0,13,3,2,18,3,3,2,10,3,24,1
8479415,2018,2.21,2.1,1,2,21,7,7,35,3,0,0,21,70,41,12
8479416,2018,0.09,0.09,1,0,2,0,2,4,1,0,0,2,0,2,4
8479420,2018,9.37,9.15,4,1,108,48,49,205,12,7,7,101,10,65,24
8479423,2018,1.97,1.91,2,0,16,6,8,30,4,2,0,14,2,1,1
8479425,2018,3.92,3.8,8,11,74,35,56,165,24,5,1,69,0,66,10
8479439,2018,0.06,0.05,0,0,1,2,1,4,1,1,1,0,0,1,0
8479442,2018,3.68,3.63,12,9,105,48,97,250,23,2,11,103,0,91,42
8479447,2018,0.11,0.11,0,0,2,0,1,3,0,0,1,2,0,0,0
8479458,2018,2.37,2.35,3,9,71,51,107,229,15,3,4,68,0,139,18
8479465,2018,10.62,10.51,6,5,96,24,28,148,23,12,5,84,16,135,18
8479466,2018,0.77,0.61,0,0,6,2,3,11,0,0,1,6,0,9,3
8479482,2018,3.74,3.71,7,12,111,47,74,232,25,6,1,105,0,84,21
8479511,2018,0.53,0.52,0,0,6,3,3,12,0,0,0,6,0,0,2
8479514,2018,0,0,0,0,0,0,0,0,0,0,0,0,0,0,0
8479553,2018,0.45,0.46,0,0,8,4,2,14,0,0,0,8,0,10,1
8479580,2018,0.39,0.39,0,0,6,3,1,10,0,0,0,6,20,13,5
8479644,2018,5.04,4.97,2,1,45,21,20,86,11,8,5,37,1,17,4
8479657,2018,3.4,3.2,1,1,30,10,17,57,6,4,2,26,11,21,9
8479675,2018,2.58,2.55,2,4,26,14,8,48,8,2,3,24,0,15,8
8479772,2018,0.33,0.29,1,0,2,2,0,4,1,0,0,2,0,4,0
8479944,2018,7.26,7.23,3,6,76,26,22,124,17,8,3,68,8,138,17
8479945,2018,1.59,1.59,2,1,25,14,23,62,5,2,0,23,0,11,8
8479968,2018,3.61,3.45,1,1,40,18,12,70,3,1,1,39,7,41,7
8479970,2018,0.7,0.67,2,1,7,3,3,13,3,0,0,7,3,14,5
8479974,2018,14.01,12.96,7,11,115,48,40,203,31,13,13,102,400,72,40
8479976,2018,0.97,0.95,1,1,28,9,28,65,3,1,1,27,0,21,9
8479977,2018,1.7,1.66,1,0,13,6,3,22,2,1,2,12,0,18,3
8479992,2018,9.78,9.32,6,4,74,33,24,131,18,8,11,66,23,84,12
8479994,2018,0.41,0.39,1,0,6,2,2,10,1,0,0,6,4,5,2
8479999,2018,11.53,11.29,6,7,118,39,38,195,25,12,11,106,214,30,31
8480001,2018,0.03,0.03,0,0,2,0,2,4,0,0,0,2,0,0,0
8480002,2018,17.82,16.76,15,15,160,48,40,248,47,17,9,143,437,53,38
8480005,2018,0.53,0.53,0,1,1,1,0,2,1,0,0,1,0,1,0
8480009,2018,0.58,0.58,0,1,2,7,3,12,2,1,0,1,0,4,3
8480012,2018,15.57,15.06,24,14,144,58,65,267,66,28,7,116,257,42,41
8480023,2018,9.35,8.81,12,12,80,19,27,126,33,9,6,71,96,13,36
8480029,2018,1.46,1.45,0,0,16,6,3,25,1,1,1,15,1,11,4
8480031,2018,0.99,1.01,3,2,9,5,5,19,7,2,1,7,3,27,2
8480035,2018,2.18,2.13,7,4,62,25,51,138,11,0,4,62,0,48,7
8480036,2018,10.17,9.55,12,9,182,61,121,364,33,12,18,170,0,34,35
8480039,2018,0.38,0.38,0,1,6,3,1,10,2,1,0,5,16,3,3
8480068,2018,0.26,0.23,0,0,3,0,2,5,3,3,0,0,4,1,0
8480072,2018,3.09,3.04,2,2,41,9,13,63,6,2,2,39,84,60,14
8480073,2018,0.07,0.07,0,0,0,3,4,7,0,0,0,0,0,1,1
8480074,2018,0.58,0.62,0,0,6,2,0,8,1,1,1,5,0,2,0
8480078,2018,15.32,14.83,8,4,133,56,54,243,23,11,11,122,68,29,25
8480082,2018,0.14,0.15,0,0,2,0,1,3,0,0,0,2,0,2,1
8480083,2018,1.26,1.21,0,0,18,7,3,28,2,2,4,16,0,4,2
8480113,2018,13.78,13.41,10,8,148,50,39,237,33,15,8,133,7,87,26
8480143,2018,0.21,0.21,0,0,1,1,0,2,0,0,0,1,0,0,0
8480144,2018,7.8,7.63,10,5,72,25,27,124,19,4,3,68,276,39,31
8480145,2018,4.87,4.68,12,8,132,53,60,245,26,6,8,126,0,138,38
8480147,2018,2.29,2.19,2,0,70,29,48,147,4,2,3,68,0,91,12
8480157,2018,0.14,0.15,0,0,5,3,2,10,1,1,0,4,0,1,0
8480160,2018,1.29,1.31,3,5,41,11,28,80,9,1,0,40,0,67,13
8480161,2018,0.62,0.55,0,0,7,4,5,16,0,0,0,7,0,18,3
8480172,2018,1.13,1.11,2,4,42,14,26,82,8,2,2,40,0,24,1
8480208,2018,2.35,2.25,3,3,18,5,4,27,9,3,1,15,3,17,7
8480314,2018,1.18,1.17,0,2,15,4,4,23,4,2,1,13,0,0,1
8480326,2018,4.84,4.68,1,1,44,13,12,69,5,3,3,41,66,65,7
8480336,2018,2.06,2.01,4,3,55,21,42,118,10,3,3,52,0,43,14
8480341,2018,0.23,0.24,1,1,3,0,2,5,2,0,0,3,0,11,2
8480748,2018,5.72,5.74,1,5,60,29,22,111,12,6,7,54,7,79,17
8480762,2018,2.31,2.28,0,0,18,8,6,32,0,0,1,18,0,24,1
8480769,2018,3.22,3.18,0,0,24,9,12,45,2,2,4,22,26,22,6
8480771,2018,0.02,0.02,1,0,2,0,0,2,1,0,0,2,0,5,0
8480776,2018,0.21,0.2,0,0,3,3,0,6,0,0,0,3,0,0,0
8480780,2018,5.2,5.15,3,1,40,18,13,71,11,7,2,33,6,29,14
8480800,2018,0.23,0.23,3,0,6,2,4,12,3,0,1,6,0,1,3
8480801,2018,27.5,26.1,16,6,214,61,60,335,44,22,22,192,73,174,22
8480803,2018,0.37,0.37,0,0,10,6,9,25,1,1,0,9,0,6,3
8480806,2018,0.88,0.87,1,1,13,2,3,18,2,0,0,13,21,4,3
8480821,2018,1.63,1.6,0,1,18,8,12,38,2,1,2,17,3,6,5
8480829,2018,9.99,9.71,13,10,134,46,81,261,34,11,7,123,359,66,31
8480830,2018,24.19,23.1,8,9,189,65,56,310,37,20,26,169,1,123,34
8480839,2018,8.63,8.26,13,20,177,48,81,306,42,9,11,168,0,97,38
8480901,2018,0.98,1.06,1,1,15,6,10,31,5,3,1,12,1,6,3
8480935,2018,1.05,1.02,3,2,37,17,17,71,6,1,1,36,0,20,7
8480943,2018,1.26,1.24,2,2,43,30,58,131,7,3,3,40,0,57,11
8480944,2018,6.27,6.32,7,5,64,43,31,138,13,1,4,63,204,58,30
8480945,2018,2.51,2.49,1,2,43,16,38,97,5,2,1,41,0,86,13
8480946,2018,12.88,12.72,17,7,137,36,44,217,37,13,8,124,22,13,32
8480948,2018,1.34,1.3,3,2,24,10,20,54,7,2,2,22,0,12,3
8480950,2018,1.29,1.21,3,1,27,19,18,64,4,0,3,27,0,149,6
8480954,2018,0,0,0,0,0,0,1,1,0,0,0,0,3,1,1
8480955,2018,0.51,0.51,6,2,14,9,19,42,8,0,0,14,0,49,4
8480965,2018,5.34,5.04,3,2,42,21,10,73,8,3,7,39,102,10,5
8481186,2018,0.06,0.06,0,0,1,2,1,4,0,0,0,1,0,4,2
8481425,2018,0,0,0,0,0,0,0,0,0,0,0,0,0,4,1
8481426,2018,0.99,0.99,0,0,8,5,4,17,0,0,2,8,0,4,2
8481433,2018,1.01,1.02,3,3,15,2,5,22,7,1,2,14,1,1,5
8481442,2018,0.04,0.04,0,0,1,1,2,4,0,0,0,1,0,2,0
8481477,2018,0.61,0.6,0,0,7,0,1,8,0,0,1,7,5,3,0
8481479,2018,0.04,0.04,0,0,3,0,1,4,0,0,0,3,0,0,1
8481481,2018,0.26,0.25,0,0,1,0,1,2,0,0,0,1,4,0,1
8481486,2018,0.03,0.03,1,0,1,1,0,2,1,0,0,1,0,0,0
8448208,2017,2.98,2.86,4,2,32,9,12,53,7,1,1,31,0,1,11
8464989,2017,11.28,11.11,8,3,104,31,33,168,22,11,9,93,355,14,14
8465009,2017,6.08,5.87,7,10,144,66,113,323,24,7,9,137,0,141,42
8466138,2017,9.36,9.23,11,12,75,29,28,132,36,13,6,62,229,32,33
8466139,2017,27.59,27.13,10,10,204,67,52,323,47,27,9,177,157,85,28
8466251,2017,6.43,6.33,6,4,79,30,23,132,13,3,4,76,11,132,12
8467370,2017,1.03,1.04,2,0,14,4,5,23,4,2,0,12,107,25,8
8467400,2017,3.62,3.55,8,6,93,37,58,188,17,3,9,90,0,102,11
8467407,2017,3.39,3.18,3,2,42,8,9,59,7,2,3,40,6,17,5
8467875,2017,22.16,20.58,20,12,189,69,52,310,55,23,15,166,18,38,17
8467876,2017,6.29,5.93,13,34,67,29,29,125,50,3,4,64,438,18,10
8467967,2017,0.73,0.69,2,0,5,2,3,10,2,0,0,5,2,7,0
8468001,2017,7.1,6.99,8,3,85,22,12,119,14,3,4,82,312,122,24
8468083,2017,14.68,14.17,32,13,179,72,79,330,56,11,10,168,657,49,50
8468085,2017,6.57,6.39,5,4,88,28,28,144,14,5,6,83,7,15,22
8468208,2017,6.27,6.2,4,3,40,19,23,82,12,5,1,35,107,35,21
8468309,2017,0.04,0.04,0,0,3,0,1,4,0,0,0,3,0,2,0
8468483,2017,9.7,9.26,10,0,80,43,43,166,21,11,7,69,0,12,13
8468486,2017,8.47,8.35,8,3,82,25,26,133,24,13,2,69,3,82,14
8468493,2017,3.33,3.17,8,11,73,43,74,190,23,4,4,69,0,91,18
8468498,2017,1.63,1.61,3,7,54,21,58,133,10,0,3,54,0,218,17
8468508,2017,20.01,19.22,20,15,198,76,83,357,51,16,11,182,52,79,46
8468509,2017,3.78,3.64,8,15,73,21,53,147,27,4,4,69,0,81,14
8468535,2017,10.52,10.34,4,4,91,24,26,141,16,8,9,83,609,38,14
8468542,2017,0.21,0.21,2,0,6,5,5,16,2,0,1,6,0,8,9
8468575,2017,5.41,5.24,3,3,46,18,19,83,12,6,4,40,196,41,19
8468611,2017,3.88,3.95,7,1,56,17,14,87,13,5,3,51,226,123,16
8468674,2017,3.69,3.59,13,5,108,48,61,217,23,5,7,103,0,126,25
8469455,2017,13.49,12.72,13,5,137,63,73,273,26,8,8,129,413,16,12
8469459,2017,17.71,16.7,16,15,170,64,50,284,45,14,18,156,809,51,44
8469465,2017,2.81,2.74,8,13,66,29,63,158,24,3,4,63,0,81,13
8469466,2017,0.52,0.51,0,0,5,4,1,10,0,0,0,5,0,0,1
8469500,2017,11.39,10.61,12,10,128,44,48,220,29,7,9,121,77,43,22
8469501,2017,2.82,2.84,5,1,35,9,11,55,7,1,1,34,7,99,5
8469506,2017,14.5,14.06,10,8,168,53,57,278,34,16,13,152,33,39,22
8469521,2017,11.43,10.98,14,6,144,37,47,228,26,6,6,138,659,61,29
8469544,2017,9.99,9.64,7,4,143,38,62,243,21,10,9,133,53,46,16
8469598,2017,2.23,2.17,4,4,66,44,37,147,8,0,6,66,0,116,12
8469619,2017,1.29,1.26,3,2,31,13,19,63,5,0,4,31,0,65,2
8469638,2017,6.37,6.07,6,6,73,31,34,138,17,5,7,68,101,21,18
8469639,2017,0.63,0.63,0,1,10,4,7,21,1,0,0,10,53,22,4
8469665,2017,2.01,1.96,2,2,59,19,31,109,8,4,1,55,0,50,16
8470041,2017,22.88,21.85,8,5,230,81,54,365,34,21,13,209,4,51,58
8470047,2017,12.01,11.74,13,9,71,29,24,124,33,11,4,60,487,25,36
8470105,2017,6.01,5.74,7,5,71,22,27,120,19,7,3,64,8,119,18
8470110,2017,5.44,5.27,3,4,101,42,51,194,16,9,6,92,0,24,11
8470144,2017,12.7,12.34,10,5,133,55,47,235,31,16,8,117,480,47,28
8470151,2017,1.56,1.53,2,3,45,21,35,101,7,2,3,43,0,29,5
8470162,2017,7.97,7.79,4,4,65,21,13,99,12,4,6,61,248,74,20
8470187,2017,3.88,3.79,8,4,141,59,82,282,18,6,5,135,0,114,15
8470257,2017,18.4,17.44,18,13,168,48,87,303,46,15,15,153,24,53,34
8470281,2017,6.87,6.65,6,24,187,60,153,400,32,2,8,185,0,41,34
8470318,2017,2.63,2.58,7,3,86,17,49,152,13,3,2,83,1,129,13
8470324,2017,0.48,0.48,1,1,15,10,10,35,2,0,2,15,0,69,3
8470358,2017,7.94,7.63,2,6,90,37,29,156,14,6,3,84,8,65,7
8470543,2017,8.32,8.22,9,7,81,24,28,133,29,13,5,68,7,131,38
8470595,2017,27.33,26.38,20,14,242,57,98,397,76,42,17,200,571,42,48
8470598,2017,18.88,18.38,23,9,168,51,47,266,56,24,14,144,6,36,28
8470600,2017,6.71,6.13,24,21,149,65,109,323,51,6,14,143,0,78,14
8470601,2017,2.78,2.71,9,5,73,33,56,162,15,1,4,72,0,77,11
8470602,2017,5.42,5.29,11,9,134,50,72,256,26,6,7,128,0,161,20
8470604,2017,12.28,11.72,6,3,85,35,26,146,22,13,8,72,222,27,7
8470606,2017,24.11,23.31,21,12,222,80,66,368,61,28,13,194,17,189,40
8470607,2017,7.24,6.97,8,11,136,59,112,307,26,7,12,129,0,85,25
8470609,2017,0.56,0.55,0,0,4,1,1,6,0,0,0,4,2,11,0
8470610,2017,13.39,13.19,5,4,119,29,25,173,24,15,12,104,5,26,15
8470611,2017,3.24,3.21,1,0,27,7,5,39,4,3,1,24,66,24,6
8470612,2017,10.58,10.33,34,16,117,65,60,242,61,11,9,106,406,96,45
8470613,2017,13.59,13.16,30,25,332,150,293,775,67,12,23,320,0,79,75
8470616,2017,10.54,9.92,1,5,78,36,23,137,14,8,14,70,400,71,13
8470619,2017,11.28,10.59,7,3,120,40,36,196,23,13,3,107,420,126,19
8470621,2017,21.26,20.49,22,10,169,56,62,287,49,17,19,152,2,59,18
8470622,2017,0.24,0.24,0,0,3,3,2,8,1,1,0,2,0,5,0
8470626,2017,11.74,11.32,9,4,101,24,23,148,23,10,5,91,6,7,25
8470638,2017,25.36,24.6,21,12,224,91,83,398,63,30,9,194,784,48,55
8470642,2017,3.08,2.94,5,5,75,39,49,163,16,6,12,69,0,66,7
8470655,2017,16.72,16.07,14,5,160,54,26,240,33,14,10,146,125,137,31
8470724,2017,0.31,0.31,0,3,11,2,5,18,3,0,0,11,0,21,6
8470740,2017,5.14,4.77,5,1,41,22,25,88,9,3,5,38,3,40,17
8470755,2017,12.05,11.29,7,5,105,32,48,185,15,3,10,102,543,72,24
8470760,2017,1.07,1.05,0,2,25,18,18,61,3,1,0,24,0,77,1
8470775,2017,5.78,5.63,7,5,53,25,30,108,17,5,4,48,360,122,21
8470794,2017,25.03,23.99,26,18,224,87,68,379,66,22,13,202,500,93,44
8470803,2017,8.92,8.69,12,11,113,29,35,177,33,10,8,103,504,83,52
8470828,2017,1.1,1.11,2,3,31,19,18,68,6,1,1,30,0,20,3
8470834,2017,11.48,11.18,13,24,193,90,89,372,45,8,16,185,0,147,34
8470852,2017,1.12,1.1,0,0,13,10,5,28,0,0,0,13,0,8,1
8470854,2017,1.7,1.57,0,0,14,9,2,25,0,0,2,14,2,35,2
8470966,2017,9.63,9.35,6,19,214,95,182,491,38,13,18,201,0,93,50
8471214,2017,37.48,35.84,20,18,355,171,179,705,87,49,32,306,3,139,25
8471215,2017,31.43,30.07,32,24,239,67,73,379,98,42,17,197,460,48,75
8471217,2017,13.39,12.92,11,6,112,57,51,220,29,12,4,100,1,76,29
8471218,2017,20.92,20.42,48,20,246,81,83,410,91,23,23,223,166,94,34
8471226,2017,12.45,12.02,5,2,102,37,27,166,15,8,9,94,41,77,16
8471228,2017,25.49,24.84,31,13,215,83,83,381,71,27,13,188,6,77,45
8471233,2017,11,10.74,7,7,91,34,27,152,26,12,8,79,557,64,42
8471242,2017,7.19,6.97,7,18,132,52,95,279,33,8,4,124,0,78,29
8471260,2017,10.03,9.82,16,5,120,42,51,213,33,12,6,108,104,141,47
8471262,2017,16.46,15.22,13,8,149,54,51,254,37,16,7,133,422,71,41
8471266,2017,2.42,2.43,1,0,33,8,8,49,5,4,0,29,4,23,0
8471273,2017,8.12,7.77,7,3,89,31,31,151,16,6,3,83,521,145,25
8471274,2017,6.73,6.54,16,7,119,54,106,279,35,12,5,107,0,114,16
8471276,2017,13.06,12.75,17,10,119,41,41,201,44,17,11,102,502,31,25
8471284,2017,1.15,1.08,4,4,36,14,45,95,8,0,4,36,0,27,11
8471296,2017,2.1,2,5,3,59,35,41,135,9,1,5,58,1,181,20
8471303,2017,5.95,5.58,16,12,172,58,124,354,34,6,8,166,1,157,31
8471338,2017,5.27,5.24,5,0,55,15,18,88,11,6,8,49,194,53,7
8471339,2017,11.06,10.94,6,7,104,43,32,179,18,5,3,99,27,138,26
8471346,2017,3.06,3.01,3,2,49,12,27,88,8,3,5,46,46,6,14
8471392,2017,2.18,2.11,5,5,47,33,47,127,12,2,4,45,0,131,5
8471426,2017,8.7,8.04,11,5,79,52,39,170,22,6,9,73,101,125,28
8471436,2017,2.15,2.1,3,3,52,19,34,105,10,4,3,48,0,51,14
8471476,2017,8.42,8.29,9,8,82,31,38,151,23,6,4,76,89,27,23
8471490,2017,0.23,0.21,0,0,6,0,2,8,0,0,0,6,3,12,3
8471498,2017,4.36,4.18,8,4,54,28,17,99,14,2,2,52,8,38,25
8471657,2017,3.51,3.45,1,2,36,7,5,48,4,1,1,35,0,131,2
8471663,2017,0.22,0.21,0,0,1,0,0,1,0,0,0,1,0,6,0
8471669,2017,21.65,20.88,19,18,159,58,26,243,53,16,16,143,832,43,43
8471675,2017,31.69,30.57,33,27,247,94,71,412,89,29,23,218,1026,75,42
8471676,2017,11.25,10.81,12,10,112,54,70,236,33,11,6,101,12,97,24
8471677,2017,3.67,3.56,4,4,88,37,50,175,11,3,5,85,0,101,20
8471678,2017,8.7,8.61,6,0,83,34,28,145,19,13,7,70,12,69,35
8471685,2017,21.82,21.22,31,26,200,64,86,350,92,35,8,165,983,50,54
8471686,2017,3.84,3.72,4,3,68,32,47,147,8,1,2,67,0,76,32
8471691,2017,8.11,7.75,1,4,61,32,18,111,10,5,5,56,233,65,10
8471698,2017,17.76,16.43,17,12,127,67,46,240,47,18,10,109,101,124,51
8471699,2017,18.07,17.68,16,7,175,62,66,303,35,12,10,163,35,80,24
8471702,2017,4.96,4.86,12,10,120,62,95,277,29,7,10,113,0,117,18
8471707,2017,19.3,18.27,11,8,202,73,87,362,44,25,11,177,0,44,49
8471709,2017,8.58,8.32,4,17,161,57,119,337,32,11,12,150,0,26,20
8471710,2017,0.47,0.46,1,2,14,8,12,34,4,1,1,13,0,21,4
8471716,2017,15.47,14.87,9,13,110,58,32,200,35,13,14,97,46,173,21
8471717,2017,1.01,0.98,0,3,39,14,22,75,4,1,0,38,0,80,7
8471724,2017,9.88,9.61,15,27,222,75,146,443,51,9,19,213,0,109,53
8471729,2017,3.85,3.72,7,10,90,43,60,193,21,4,3,86,0,97,20
8471735,2017,8.57,8.03,24,22,175,68,111,354,54,8,17,167,0,26,42
8471742,2017,1.3,1.26,4,2,51,19,34,104,7,1,5,50,0,18,7
8471743,2017,10.57,10.41,14,6,136,35,58,229,31,11,9,125,191,127,21
8471761,2017,0.02,0.02,0,0,2,0,5,7,0,0,0,2,0,3,0
8471766,2017,0.27,0.26,0,0,4,1,0,5,1,1,0,3,0,9,0
8471768,2017,9.35,8.98,8,7,103,21,33,157,22,7,12,96,17,55,24
8471769,2017,1.49,1.43,4,4,32,17,35,84,9,1,2,31,0,16,16
8471794,2017,11.16,11.05,12,4,140,43,39,222,29,13,6,127,43,131,37
8471804,2017,0.01,0.01,0,0,1,0,0,1,0,0,0,1,0,4,0
8471811,2017,0.01,0.01,0,0,1,0,0,1,0,0,0,1,2,0,1
8471817,2017,5.55,5.29,2,4,42,22,15,79,10,4,4,38,14,236,12
8471873,2017,5.24,4.96,7,7,131,29,80,240,18,4,5,127,0,104,31
8471887,2017,29.55,28.6,14,6,247,78,52,377,49,29,18,218,16,137,24
8471958,2017,4.11,4.12,4,8,93,34,43,170,18,6,6,87,0,133,15
8471976,2017,5.52,5.37,8,14,55,15,28,98,28,6,2,49,386,22,26
8472382,2017,3.53,3.47,5,5,93,44,59,196,13,3,7,90,0,84,24
8473412,2017,13.79,13.36,12,15,129,39,63,231,43,16,7,113,732,50,37
8473415,2017,3.76,3.64,4,4,79,27,44,150,9,1,6,78,0,126,9
8473419,2017,23.91,22.45,29,22,182,61,65,308,85,34,13,148,50,37,58
8473422,2017,14.37,13.8,7,11,137,34,37,208,33,15,8,122,340,182,34
8473432,2017,3.29,3.27,2,0,26,11,2,39,9,7,2,19,0,39,4
8473440,2017,0.05,0.06,0,0,3,0,0,3,0,0,0,3,0,0,0
8473446,2017,6.89,6.75,10,6,167,42,79,288,25,9,6,158,0,113,41
8473449,2017,17.65,16.67,16,13,161,50,68,279,44,15,17,146,23,70,24
8473453,2017,12.24,11.97,10,2,134,50,46,230,26,14,14,120,47,125,19
8473463,2017,12.17,11.37,4,8,114,43,15,172,19,7,8,107,112,219,47
8473465,2017,13.62,12.7,11,5,116,34,31,181,29,13,7,103,7,117,18
8473468,2017,0.67,0.65,2,0,19,15,23,57,2,0,1,19,0,57,9
8473473,2017,19.63,18.46,11,13,147,79,56,282,34,10,14,137,29,254,29
8473485,2017,8.48,8.16,4,2,68,20,12,100,16,10,5,58,3,48,7
8473492,2017,1.85,1.8,0,0,17,14,7,38,0,0,1,17,2,34,5
8473504,2017,8.23,8.04,5,5,101,26,41,168,18,8,7,93,7,226,14
8473507,2017,10.87,10.44,21,9,178,62,138,378,42,12,12,166,0,167,41
8473512,2017,21.79,20.92,33,35,193,59,109,361,102,34,13,159,638,30,34
8473533,2017,23.56,22.56,14,13,160,64,52,276,46,19,6,141,757,181,58
8473534,2017,10.52,10.13,7,2,112,37,34,183,26,17,6,95,173,111,22
8473544,2017,19.07,18.43,17,8,197,61,59,317,46,21,13,176,516,96,42
8473546,2017,22.58,21.93,5,4,167,49,44,260,36,27,7,140,10,68,46
8473548,2017,21.68,21.08,40,18,261,66,122,449,92,34,20,227,6,10,26
8473560,2017,0.46,0.44,0,0,10,4,4,18,0,0,0,10,0,22,1
8473563,2017,17.13,16.08,27,23,165,58,56,279,71,21,10,144,702,37,44
8473564,2017,16.25,15.47,7,8,167,63,51,281,25,10,13,157,33,48,43
8473573,2017,17.93,16.43,8,3,130,39,57,226,31,20,16,110,416,15,18
8473574,2017,3.17,3.15,2,0,26,4,9,39,3,1,0,25,12,22,7
8473579,2017,0.87,0.83,1,1,7,2,4,13,3,1,1,6,4,16,1
8473584,2017,3.44,3.36,2,13,82,39,73,194,21,6,7,76,0,36,16
8473604,2017,23.39,22.96,21,11,211,55,75,341,52,20,18,191,900,32,53
8473618,2017,19.52,18.29,9,13,139,45,46,230,39,17,8,122,33,120,42
8473673,2017,1.35,1.26,4,0,38,12,39,89,5,1,5,37,0,33,13
8473914,2017,9.53,8.82,6,8,111,30,46,187,23,9,4,102,473,62,19
8473933,2017,2.22,2.24,2,4,74,28,38,140,8,2,2,72,0,84,22
8473986,2017,16.22,15.74,17,15,156,68,53,277,47,15,8,141,22,82,32
8473991,2017,2.34,2.27,5,6,84,38,66,188,12,1,4,83,0,141,22
8473992,2017,1.01,0.99,0,1,36,9,16,61,2,1,1,35,0,121,3
8473994,2017,29.45,27.45,16,27,236,61,84,381,78,35,25,201,371,139,63
8474000,2017,1.34,1.31,1,0,31,12,9,52,1,0,1,31,0,46,6
8474008,2017,4.58,4.44,5,2,51,21,21,93,14,7,1,44,19,67,21
8474009,2017,10.17,10.14,8,5,83,38,23,144,25,12,3,71,527,18,64
8474013,2017,3.01,2.95,7,8,84,36,63,183,20,5,3,79,0,95,21
8474018,2017,2.81,2.74,2,2,23,14,5,42,10,6,2,17,6,21,10
8474024,2017,0.8,0.83,1,0,11,3,1,15,1,0,2,11,27,10,2
8474027,2017,3.69,3.59,15,13,115,55,81,251,33,5,11,110,0,143,32
8474031,2017,4.18,4.08,13,5,94,29,65,188,23,5,7,89,0,44,24
8474034,2017,16.91,16.11,16,10,141,68,38,247,43,17,16,124,11,150,22
8474037,2017,35.27,32.78,11,7,248,112,71,431,54,36,29,212,0,40,30
8474038,2017,22.13,20.26,10,5,115,56,32,203,35,20,18,95,40,137,45
8474040,2017,13.43,13.14,11,10,164,48,58,270,31,10,5,154,220,54,17
8474053,2017,17.17,16.4,18,9,204,70,103,377,61,34,14,170,149,33,55
8474056,2017,10.57,10.39,28,15,207,85,139,431,59,16,12,191,1,111,44
8474061,2017,0,0,0,0,0,0,0,0,0,0,0,0,0,4,0
8474062,2017,14.32,13.91,13,13,113,39,36,188,41,15,10,98,459,86,55
8474066,2017,4.67,4.54,11,9,87,43,80,210,25,5,6,82,0,76,14
8474068,2017,14.89,14.69,17,18,145,63,64,272,51,16,8,129,449,21,38
8474074,2017,1.04,0.95,1,0,14,9,10,33,1,0,0,14,0,13,1
8474089,2017,0.73,0.65,0,0,9,0,1,10,0,0,0,9,21,19,2
8474090,2017,3.47,3.45,4,3,66,19,34,119,8,1,4,65,0,58,23
8474091,2017,9.29,9.15,11,4,106,27,22,155,26,11,4,95,570,55,29
8474098,2017,11.9,11.55,8,5,141,41,37,219,24,11,15,130,74,81,31
8474102,2017,12.71,12.58,34,16,126,39,70,235,66,16,16,110,96,118,48
8474125,2017,2.07,2.05,1,3,59,22,28,109,9,5,1,54,0,35,7
8474131,2017,1.01,0.98,1,1,20,4,5,29,4,2,0,18,27,20,3
8474134,2017,2.35,2.23,3,0,40,17,25,82,5,2,2,38,0,47,4
8474141,2017,24.73,23.67,31,18,285,84,146,515,76,27,23,258,7,18,47
8474145,2017,3.52,3.31,3,6,76,29,59,164,13,4,8,72,0,121,5
8474149,2017,22.97,22.56,23,13,186,97,74,357,64,28,11,158,0,27,46
8474150,2017,20.86,20.29,19,12,214,85,73,372,45,14,11,200,705,54,81
8474151,2017,5.18,4.99,13,12,99,33,69,201,29,4,6,95,0,71,44
8474157,2017,21.97,21,11,9,212,81,98,391,37,17,23,195,7,118,24
8474161,2017,24.7,23.76,41,24,228,80,104,412,85,20,23,208,15,23,33
8474162,2017,8.04,7.78,14,20,154,77,122,353,42,8,8,146,0,170,17
8474166,2017,4.79,4.47,10,6,111,42,76,229,25,9,5,102,0,100,11
8474176,2017,13.28,13.12,11,10,169,38,49,256,31,10,15,159,21,112,46
8474189,2017,17.36,16.05,14,6,161,58,80,299,38,18,13,143,471,71,39
8474190,2017,26.3,25.28,12,10,176,66,50,292,46,24,19,152,12,129,38
8474207,2017,3.86,3.8,7,6,80,41,70,191,17,4,8,76,0,136,26
8474218,2017,4.73,4.47,7,7,95,52,78,225,20,6,9,89,0,66,20
8474230,2017,5.5,5.36,2,4,55,18,10,83,9,3,3,52,19,119,8
8474250,2017,12.12,11.84,5,9,124,57,47,228,19,5,8,119,297,90,27
8474291,2017,8.82,8.46,6,9,65,30,25,120,22,7,9,58,584,69,25
8474520,2017,0.15,0.15,0,1,7,2,6,15,1,0,0,7,0,7,3
8474563,2017,10.4,10,25,25,205,72,124,401,60,10,17,195,0,127,17
8474564,2017,23.88,22.83,36,23,212,88,112,412,86,27,10,185,466,61,27
8474565,2017,9.28,9,19,20,216,79,122,417,54,15,18,201,0,48,54
8474567,2017,1.03,1.01,1,0,29,6,13,48,1,0,1,29,0,22,3
8474568,2017,2.25,2.18,1,5,59,42,56,157,7,1,9,58,0,219,14
8474569,2017,8.28,7.88,7,5,75,17,17,109,18,6,9,69,60,38,11
8474571,2017,12.49,12.38,12,10,119,44,35,198,37,15,13,104,5,41,29
8474573,2017,14.68,14.05,30,23,151,45,70,266,71,18,12,133,11,12,45
8474574,2017,6.81,6.67,18,12,150,61,93,304,36,6,13,144,0,68,32
8474578,2017,9.4,8.96,28,25,196,100,182,478,62,9,14,187,0,58,55
8474579,2017,0.95,0.93,6,6,26,10,26,62,14,2,3,24,0,50,12
8474581,2017,6.67,6.49,22,25,133,68,116,317,52,5,5,128,0,51,39
8474584,2017,5.85,5.53,7,9,128,46,69,243,22,6,6,122,0,244,22
8474586,2017,21.65,20.9,19,15,183,57,50,290,59,25,14,158,12,46,38
8474589,2017,10,9.97,7,7,115,46,41,202,22,8,11,107,3,51,30
8474590,2017,13.26,12.26,26,27,237,88,142,467,68,15,19,222,0,47,58
8474600,2017,15.16,14.55,23,16,253,73,161,487,53,14,19,239,0,80,30
8474602,2017,5.54,5.33,15,8,109,59,67,235,27,4,5,105,0,36,17
8474604,2017,0.02,0.02,0,1,2,0,1,3,1,0,0,2,0,1,1
8474610,2017,0.75,0.73,0,0,18,3,4,25,0,0,1,18,7,6,3
8474612,2017,3.32,3.24,6,4,107,60,94,261,11,1,4,106,0,83,28
8474613,2017,18.76,18.06,21,21,209,69,67,345,56,14,19,195,740,52,42
8474618,2017,6.33,6.09,11,6,138,64,104,306,22,5,11,133,0,91,24
8474625,2017,4.28,3.73,3,3,37,10,17,64,9,3,4,34,6,50,15
8474627,2017,4.4,4.29,1,4,45,10,19,74,8,3,2,42,85,55,14
8474628,2017,3.35,3.17,5,2,98,61,91,250,10,3,4,95,0,106,15
8474641,2017,22.24,21.74,17,9,151,61,51,263,50,24,9,127,508,61,40
8474642,2017,7.52,7.27,4,2,56,16,12,84,9,3,6,53,14,132,5
8474660,2017,0.52,0.53,2,3,18,6,16,40,5,0,2,18,0,1,4
8474668,2017,3.68,3.58,3,1,44,12,13,69,8,4,1,40,1,77,13
8474673,2017,5.24,5.06,7,21,118,55,87,260,32,4,7,114,0,24,48
8474679,2017,22.46,21.75,16,3,210,70,59,339,40,21,9,189,6,63,41
8474683,2017,9.36,9.2,6,6,65,30,17,112,24,12,5,53,317,63,18
8474685,2017,11.87,11.58,8,7,108,32,29,169,24,9,5,99,15,61,28
8474688,2017,3.13,3,8,4,100,42,71,213,13,1,3,99,0,153,5
8474697,2017,3.37,3.31,3,5,66,32,34,132,11,3,5,63,0,226,11
8474709,2017,3.7,3.63,5,4,46,18,15,79,12,3,2,43,12,147,6
8474715,2017,27.31,24.95,16,6,231,72,77,380,46,24,28,207,21,32,31
8474716,2017,7.95,7.49,12,16,110,51,73,234,37,9,12,101,0,64,23
8474717,2017,2.3,2.21,5,5,51,30,39,120,12,2,4,49,0,26,8
8474722,2017,1.76,1.77,1,2,16,7,5,28,4,1,0,15,1,57,2
8474736,2017,4.23,4.08,1,1,56,18,24,98,7,5,2,51,4,188,6
8474739,2017,10.99,10.65,5,3,86,41,22,149,17,9,7,77,211,179,21
8474743,2017,0.18,0.18,0,0,7,0,3,10,0,0,0,7,0,4,1
8474749,2017,0.5,0.47,1,2,21,5,11,37,3,0,1,21,0,31,3
8474774,2017,0.16,0.15,0,0,5,2,2,9,0,0,0,5,0,7,0
8474818,2017,2.73,2.69,5,6,106,36,75,217,15,4,7,102,0,90,20
8474849,2017,8.48,8.3,9,3,83,40,45,168,17,5,8,78,22,104,16
8474870,2017,21.83,20.52,14,15,186,77,48,311,50,21,23,165,360,48,39
8474873,2017,0,0,0,0,0,0,0,0,0,0,0,0,0,0,0
8474884,2017,19.72,19.31,18,16,257,81,111,449,56,22,21,235,22,31,51
8475098,2017,19.73,18.05,21,11,154,44,54,252,43,11,12,143,627,43,37
8475147,2017,2.58,2.51,1,0,20,8,3,31,2,1,3,19,39,14,5
8475149,2017,3.87,3.83,4,5,42,13,14,69,14,5,2,37,36,8,15
8475151,2017,17.43,17.04,9,11,182,80,65,327,44,24,13,158,25,94,33
8475157,2017,0.39,0.39,0,0,3,0,0,3,1,1,1,2,0,1,0
8475158,2017,24.63,22.44,26,11,230,84,44,358,61,24,16,206,1274,42,65
8475160,2017,7.3,7.36,2,2,81,29,23,133,10,6,6,75,1,127,8
8475163,2017,8.91,8.86,7,2,59,14,19,92,18,9,4,50,11,57,29
8475164,2017,20.23,19.14,13,10,187,80,84,351,40,17,16,170,18,52,40
8475166,2017,31.09,29.43,28,19,258,85,105,448,84,37,18,221,913,30,49
8475167,2017,10.98,10.61,23,23,216,96,157,469,63,17,12,199,1,139,46
8475168,2017,22.35,21.51,22,10,190,73,65,328,59,27,9,163,717,60,47
8475169,2017,30.49,29.3,12,13,308,91,93,492,54,29,31,279,120,159,40
8475170,2017,24.11,23.22,23,19,210,81,64,355,70,28,15,182,660,154,56
8475171,2017,11.96,11.46,14,14,202,77,163,442,42,14,19,188,0,160,29
8475172,2017,24.7,23.68,12,11,211,75,81,367,55,32,11,179,546,94,42
8475175,2017,11.23,10.74,2,2,126,20,29,175,12,8,7,118,2,104,25
8475176,2017,5.06,4.77,12,11,110,49,61,220,32,9,12,101,0,27,33
8475177,2017,1.35,1.35,6,5,44,19,28,91,12,1,6,43,0,45,14
8475178,2017,9.23,8.85,7,5,86,29,28,143,19,7,7,79,5,129,26
8475179,2017,1.99,1.97,5,3,48,28,41,117,11,3,2,45,0,69,11
8475180,2017,2.01,1.9,2,1,30,7,9,46,4,1,1,29,107,14,7
8475181,2017,5.99,5.78,15,17,153,57,102,312,42,10,13,143,0,95,21
8475184,2017,14.51,13.91,11,10,137,59,40,236,37,16,10,121,25,103,18
8475185,2017,3.12,3.08,1,1,35,13,14,62,4,2,4,33,141,26,7
8475186,2017,5.09,5,5,6,141,56,68,265,18,7,10,134,0,135,17
8475188,2017,3.04,2.99,2,8,88,35,70,193,15,5,4,83,0,225,30
8475191,2017,18.6,18.11,23,15,162,57,58,277,60,22,12,140,4,40,54
8475193,2017,16.48,16.04,5,9,173,75,67,315,34,20,10,153,2,67,45
8475197,2017,9.05,8.93,24,19,178,68,150,396,57,14,13,164,0,40,20
8475200,2017,5.81,5.42,6,15,125,42,76,243,31,10,7,115,0,128,54
8475204,2017,0.5,0.53,0,0,11,3,1,15,3,3,1,8,1,2,2
8475208,2017,4.1,4.03,7,6,102,40,71,213,18,5,6,97,0,101,35
8475209,2017,18.26,17.68,15,6,136,58,74,268,35,14,17,122,4,137,26
8475218,2017,6.54,6.45,16,8,135,59,92,286,34,10,7,125,0,75,38
8475220,2017,8.66,8.24,7,8,79,26,20,125,23,8,9,71,9,185,20
8475222,2017,5.73,5.57,14,14,145,56,94,295,32,4,7,141,0,92,18
8475224,2017,1.17,1.13,2,1,19,2,2,23,3,0,4,19,28,9,3
8475225,2017,25.69,24.94,16,10,229,90,53,372,51,25,14,204,40,60,61
8475227,2017,1.58,1.52,0,5,24,8,13,45,8,3,3,21,0,17,0
8475231,2017,7.61,7.43,4,6,74,17,32,123,17,7,6,67,473,128,33
8475233,2017,5.37,5.23,8,4,145,44,82,271,16,4,11,141,0,144,24
8475235,2017,7.06,6.89,2,2,77,21,29,127,14,10,4,67,4,238,14
8475236,2017,10.59,10.39,7,9,107,37,51,195,27,11,3,96,479,63,60
8475246,2017,4.79,4.69,2,8,102,46,78,226,21,11,5,91,0,116,13
8475254,2017,2.67,2.72,0,1,38,13,10,61,2,1,3,37,41,62,5
8475263,2017,0.11,0.11,0,0,1,0,0,1,0,0,0,1,1,0,0
8475268,2017,5.81,5.84,4,2,44,26,14,84,11,5,5,39,7,118,12
8475278,2017,5.66,5.6,8,0,49,18,29,96,11,3,2,46,156,54,19
8475279,2017,1.65,1.64,7,5,57,27,48,132,14,2,3,55,0,105,10
8475287,2017,24.6,23.83,11,15,175,71,54,300,55,29,9,146,489,85,44
8475310,2017,1.41,1.42,2,0,11,5,6,22,2,0,3,11,0,8,3
8475314,2017,29.74,28.63,15,7,208,65,44,317,62,40,19,168,11,102,26
8475323,2017,3.01,2.9,4,1,30,16,12,58,6,1,3,29,159,56,10
8475324,2017,3.88,3.78,7,8,105,29,60,194,15,0,3,105,0,70,24
8475325,2017,4.96,4.74,2,2,50,15,29,94,8,4,4,46,1,123,10
8475328,2017,0.06,0.06,0,0,1,0,0,1,0,0,0,1,3,6,0
8475343,2017,6.03,5.88,1,0,51,20,18,89,4,3,2,48,202,81,16
8475423,2017,2.99,2.96,2,3,28,17,10,55,9,4,4,24,0,80,5
8475430,2017,4.8,4.74,6,6,111,49,72,232,19,7,14,104,0,113,17
8475436,2017,0.19,0.21,1,0,3,0,0,3,1,0,0,3,0,15,1
8475455,2017,3.16,3.12,8,9,88,52,63,203,22,5,5,83,0,197,11
8475462,2017,3.68,3.63,10,4,142,46,69,257,16,2,9,140,0,170,7
8475613,2017,0.81,0.81,4,2,27,19,28,74,9,3,2,24,0,60,11
8475625,2017,1.9,1.9,2,4,62,29,54,145,8,2,4,60,0,78,10
8475690,2017,0.76,0.75,2,7,31,8,12,51,11,2,0,29,0,21,15
8475692,2017,15.72,15.1,23,14,178,61,52,291,53,16,10,162,21,62,69
8475714,2017,10.81,10.74,10,9,105,39,40,184,35,16,5,89,266,36,22
8475715,2017,7.55,7.44,1,1,81,34,28,143,11,9,6,72,99,72,23
8475716,2017,0.02,0.02,0,0,0,2,1,3,0,0,0,0,0,1,1
8475718,2017,0.05,0.05,0,0,2,2,0,4,2,2,0,0,0,2,0
8475722,2017,29.49,28.81,19,12,222,62,54,338,64,33,24,189,4,80,54
8475726,2017,25.57,24.77,9,14,251,89,100,440,47,24,15,227,9,75,26
8475727,2017,8.29,8.33,15,13,107,26,28,161,41,13,4,94,91,66,15
8475728,2017,8.14,7.8,5,8,86,36,18,140,17,4,4,82,348,117,42
8475729,2017,0.27,0.27,0,0,11,6,12,29,0,0,2,11,0,17,3
8475730,2017,4.18,4.12,1,6,121,43,83,247,15,8,3,113,0,198,25
8475735,2017,1.89,1.87,2,0,21,6,5,32,4,2,2,19,115,19,3
8475736,2017,5.73,5.44,5,3,62,16,19,97,12,4,8,58,3,82,10
8475738,2017,13.13,12.93,9,4,102,50,28,180,21,8,6,94,53,17,19
8475739,2017,0.25,0.27,0,0,5,2,0,7,0,0,0,5,0,8,1
8475744,2017,21.67,20.93,33,23,187,64,62,313,83,27,14,160,450,50,44
8475745,2017,13.59,13.52,16,10,117,41,41,199,37,11,5,106,240,76,29
8475747,2017,2.58,2.52,3,8,72,28,42,142,14,3,0,69,0,65,14
8475750,2017,1.07,1.04,1,1,30,13,16,59,3,1,4,29,0,35,7
8475752,2017,12.18,11.98,5,8,128,51,63,242,27,14,5,114,13,121,24
8475753,2017,10.81,10.43,9,14,211,83,152,446,31,8,18,203,0,128,63
8475754,2017,15.98,15.3,6,10,138,47,64,249,35,19,5,119,389,50,34
8475755,2017,2.2,2.11,5,6,60,34,50,144,13,2,5,58,0,140,17
8475758,2017,11.33,11.1,7,2,103,52,40,195,16,7,5,96,16,151,16
8475760,2017,22.32,21.43,21,8,226,79,48,353,48,19,22,207,151,93,51
8475761,2017,0.47,0.47,0,0,6,4,4,14,0,0,0,6,1,9,2
8475762,2017,2.4,2.33,10,7,78,38,78,194,18,1,0,77,0,142,19
8475763,2017,18.2,17.3,10,9,172,47,49,268,44,25,13,147,562,40,52
8475764,2017,6.19,6.15,8,16,122,41,112,275,32,8,12,114,1,21,27
8475765,2017,26.88,26.07,16,17,306,130,173,609,66,33,28,273,1,89,32
8475766,2017,10.88,10.51,2,3,96,37,37,170,19,14,3,82,27,187,29
8475768,2017,19.38,19.06,25,10,157,61,51,269,59,24,13,133,30,52,45
8475772,2017,11.93,11.83,12,9,109,37,27,173,32,11,8,98,560,52,34
8475780,2017,10.71,10.5,6,3,93,44,38,175,16,7,6,86,230,253,16
8475784,2017,28.33,27.51,13,12,277,106,107,490,49,24,23,253,26,35,93
8475786,2017,19.52,19.07,17,8,149,54,36,239,40,15,10,134,72,117,36
8475788,2017,1.98,1.87,3,1,18,7,13,38,6,2,2,16,87,20,5
8475790,2017,1.56,1.55,2,1,53,31,45,129,5,2,3,51,0,126,5
8475791,2017,30.2,29.48,30,24,278,88,94,460,93,39,17,239,72,72,81
8475792,2017,8.02,7.83,8,4,67,37,44,148,27,15,4,52,14,72,17
8475793,2017,16.44,15.85,17,22,129,42,40,211,54,15,10,114,810,87,46
8475794,2017,34.62,32.56,26,12,329,107,124,560,78,40,32,289,778,74,38
8475796,2017,5.1,4.89,9,4,103,38,61,202,16,3,8,100,0,101,35
8475798,2017,23.93,22.71,26,20,193,76,65,334,67,21,16,172,69,47,33
8475799,2017,17.51,16.65,10,4,133,49,37,219,32,18,14,115,15,58,26
8475807,2017,8.41,8.26,4,1,97,41,50,188,7,2,7,95,36,107,27
8475808,2017,0.35,0.35,0,0,2,5,1,8,0,0,0,2,43,16,2
8475810,2017,17.12,16.8,16,9,123,60,34,217,38,13,11,110,8,97,31
8475820,2017,14.19,13.85,13,5,129,28,44,201,32,14,14,115,5,28,46
8475832,2017,4.97,4.91,4,2,63,12,17,92,8,2,3,61,2,139,15
8475834,2017,3.17,3.13,2,0,25,12,12,49,7,5,3,20,2,26,11
8475841,2017,2.26,2.21,4,4,51,21,55,127,11,3,3,48,0,8,15
8475844,2017,1.58,1.51,0,1,11,5,1,17,1,0,2,11,0,4,1
8475848,2017,35.89,34.51,13,10,278,92,108,478,54,31,28,247,85,90,42
8475855,2017,11.3,10.85,14,6,80,33,21,134,33,13,3,67,14,130,22
8475857,2017,0.52,0.49,1,2,20,11,14,45,3,0,2,20,0,16,0
8475868,2017,0.96,0.97,0,2,25,13,16,54,3,1,0,24,0,40,7
8475869,2017,1.86,1.83,2,1,63,24,37,124,7,4,6,59,0,105,13
8475878,2017,0.72,0.72,1,0,12,4,6,22,1,0,1,12,28,35,2
8475902,2017,0.08,0.07,0,0,6,1,3,10,0,0,0,6,0,1,0
8475906,2017,10.21,9.95,31,27,201,82,167,450,66,8,19,193,0,44,31
8475907,2017,20.68,19.61,16,4,144,77,44,265,41,21,15,123,22,171,35
8475913,2017,17.44,16.28,26,16,132,54,53,239,62,20,14,112,33,53,59
8475949,2017,0.32,0.36,0,0,2,2,1,5,0,0,0,2,0,4,1
8475982,2017,0.19,0.21,1,0,2,0,0,2,1,0,1,2,0,5,0
8476020,2017,0.08,0.07,0,0,0,1,0,1,0,0,0,0,8,4,1
8476166,2017,0.1,0.1,0,1,8,1,11,20,1,0,0,8,0,4,0
8476177,2017,2.73,2.59,0,0,16,9,9,34,1,1,0,15,4,21,5
8476191,2017,2.49,2.46,7,8,64,38,61,163,16,1,9,63,0,164,26
8476195,2017,4.86,4.6,2,2,45,18,14,77,12,8,4,37,4,32,5
8476207,2017,7.63,7.44,11,3,72,18,20,110,26,12,4,60,22,35,35
8476283,2017,0.28,0.27,0,0,1,2,0,3,0,0,1,1,0,0,2
8476285,2017,1.64,1.73,2,1,17,2,3,22,5,2,2,15,78,11,1
8476288,2017,16.59,15.69,12,6,136,48,54,238,41,23,12,113,24,60,27
8476292,2017,14.48,13.81,11,13,109,43,43,195,35,11,4,98,7,80,34
8476293,2017,7.83,7.54,7,1,98,32,28,158,14,6,5,92,10,128,14
8476302,2017,0.16,0.15,0,0,6,3,2,11,0,0,0,6,0,5,2
8476303,2017,0.88,0.85,2,1,21,14,26,61,3,0,3,21,0,42,4
8476310,2017,7.49,7.37,0,4,50,30,14,94,8,4,1,46,191,77,13
8476312,2017,6.15,5.98,13,17,117,53,53,223,37,7,9,110,0,180,48
8476322,2017,1.01,1.04,0,0,6,3,4,13,0,0,0,6,11,4,5
8476323,2017,1.86,1.72,1,1,33,6,11,50,5,3,1,30,9,56,5
8476326,2017,3.67,3.51,5,1,42,20,24,86,11,5,2,37,25,86,7
8476329,2017,0.29,0.28,1,0,2,2,1,5,1,0,1,2,18,2,0
8476331,2017,2.7,2.66,10,10,67,35,38,140,20,0,9,67,0,75,13
8476336,2017,4.22,4.1,1,0,50,26,22,98,3,2,3,48,1,72,13
8476344,2017,0.18,0.19,0,0,1,1,0,2,0,0,0,1,1,5,3
8476346,2017,21.5,21.09,34,26,227,91,92,410,84,24,24,203,1,16,44
8476356,2017,13.11,12.68,10,3,114,53,46,213,25,12,13,102,22,96,18
8476368,2017,2.11,2.05,3,3,60,24,42,126,7,1,2,59,0,158,15
8476370,2017,0.17,0.17,0,0,1,3,0,4,0,0,0,1,0,5,2
8476372,2017,0.64,0.61,3,1,17,8,14,39,4,0,1,17,0,20,2
8476374,2017,12.53,11.97,5,3,134,39,37,210,14,6,5,128,335,143,32
8476381,2017,13.18,12.59,7,4,100,35,30,165,21,10,12,90,213,90,26
8476386,2017,1.6,1.52,1,0,20,6,11,37,2,1,1,19,5,10,6
8476389,2017,31.16,30.61,22,22,285,120,84,489,75,31,17,254,846,143,64
8476392,2017,6.84,6.68,8,5,70,21,14,105,21,8,7,62,375,124,21
8476393,2017,10.96,10.44,2,5,119,27,33,179,19,12,10,107,84,117,18
8476396,2017,0.13,0.13,0,0,1,1,0,2,0,0,0,1,0,2,0
8476397,2017,0.59,0.55,0,0,4,1,5,10,0,0,1,4,0,1,1
8476399,2017,17.03,16.64,10,2,146,53,46,245,25,13,7,133,252,216,68
8476400,2017,8.64,8.37,4,5,99,44,42,185,13,4,8,95,56,100,17
8476401,2017,0.25,0.24,0,0,1,0,0,1,0,0,0,1,0,1,0
8476403,2017,1.5,1.47,1,3,43,18,32,93,5,1,2,42,0,74,7
8476404,2017,3.57,3.58,4,2,47,15,21,83,9,3,2,44,24,77,3
8476406,2017,9.3,8.89,6,8,75,41,22,138,19,5,5,70,352,55,23
8476407,2017,0.31,0.31,1,1,6,6,2,14,2,0,0,6,0,4,1
8476409,2017,1.06,1.12,2,1,15,5,11,31,3,0,2,15,40,32,5
8476410,2017,2.22,2.16,1,2,25,12,4,41,4,1,1,24,6,2,9
8476415,2017,0.53,0.52,0,1,4,1,2,7,1,0,0,4,0,7,1
8476419,2017,15.37,14.92,7,8,147,59,35,241,29,14,6,133,580,131,30
8476422,2017,3.14,3.09,9,7,65,27,33,125,18,2,2,63,0,41,8
8476423,2017,3.87,3.63,0,2,37,10,9,56,5,3,5,34,1,13,8
8476427,2017,3.52,3.5,3,1,32,10,8,50,9,5,5,27,0,11,2
8476428,2017,0.54,0.52,1,1,7,1,1,9,3,1,0,6,0,3,5
8476429,2017,2.4,2.33,4,6,58,26,57,141,12,2,6,56,0,77,5
8476430,2017,4.78,4.67,2,2,45,19,21,85,10,6,4,39,4,22,9
8476431,2017,0.11,0.1,0,2,4,4,3,11,2,0,0,4,0,2,2
8476432,2017,17.23,17.01,12,7,187,70,53,310,32,13,11,174,268,205,34
8476436,2017,11.36,11.21,6,5,124,46,42,212,17,6,16,118,2,207,36
8476437,2017,12.29,11.87,8,9,126,57,48,231,31,14,13,112,393,62,48
8476438,2017,25.77,25.11,12,5,237,82,78,397,35,18,10,219,56,29,45
8476439,2017,11.46,10.8,2,5,116,41,54,211,14,7,10,109,0,168,8
8476440,2017,9.74,8.45,4,0,93,24,32,149,12,8,7,85,73,47,22
8476441,2017,6.7,6.24,5,5,124,63,78,265,17,7,7,117,0,116,17
8476442,2017,11.21,10.9,6,5,85,28,31,144,26,15,3,70,4,26,21
8476443,2017,2.02,1.89,3,4,57,23,21,101,7,0,3,57,0,36,6
8476447,2017,4.38,4.31,4,2,51,31,26,108,8,2,7,49,5,114,14
8476448,2017,26.33,25.58,14,21,184,79,59,322,78,43,14,141,402,48,78
8476449,2017,1.19,1.16,1,2,28,13,12,53,5,2,0,26,0,35,7
8476450,2017,0.86,0.81,3,1,15,13,18,46,5,1,1,14,0,6,5
8476453,2017,26.36,25.81,33,28,279,144,124,547,100,39,9,240,3,31,66
8476454,2017,19.51,19.07,16,8,151,44,59,254,48,24,8,127,374,44,46
8476455,2017,22.66,21.9,18,19,182,60,67,309,62,25,12,157,211,149,54
8476456,2017,23.67,22.3,25,16,202,63,72,337,67,26,16,176,21,39,53
8476457,2017,4.28,4.17,2,7,92,38,64,194,13,4,5,88,0,239,26
8476458,2017,14.76,14.24,14,7,147,48,55,250,34,13,11,134,297,43,41
8476459,2017,21.08,20.38,10,10,212,86,69,367,47,27,11,185,654,92,49
8476460,2017,18.61,17.95,24,13,125,51,40,216,60,23,7,102,594,57,47
8476461,2017,34.3,31.21,33,12,227,83,67,377,76,31,25,196,529,74,48
8476462,2017,17.02,16.68,15,12,270,109,182,561,44,17,13,253,1,83,31
8476463,2017,2.99,2.96,9,6,77,32,53,162,21,6,5,71,0,34,16
8476464,2017,0.89,0.88,0,1,14,6,10,30,2,1,0,13,0,22,2
8476465,2017,1.71,1.69,1,2,25,11,12,48,5,2,3,23,0,5,1
8476466,2017,10.7,10.38,10,5,83,25,36,144,29,14,8,69,1,19,19
8476467,2017,3.81,3.71,4,8,81,39,50,170,17,5,5,76,0,174,19
8476468,2017,21.11,19.2,19,16,143,55,40,238,58,23,13,120,437,124,43
8476469,2017,13.84,13.73,11,6,128,39,53,220,29,12,8,116,7,86,48
8476470,2017,3.05,2.89,6,2,67,36,45,148,9,1,2,66,0,45,6
8476472,2017,8.48,8.25,7,9,203,73,123,399,21,5,9,198,0,49,27
8476473,2017,3.77,3.79,5,7,109,43,85,237,14,2,8,107,0,138,15
8476474,2017,11.97,11.73,10,4,127,40,26,193,27,13,6,114,20,112,33
8476476,2017,3.55,3.44,2,8,83,40,58,181,16,6,3,77,0,79,13
8476479,2017,10.43,9.97,11,6,94,25,32,151,25,8,8,86,380,59,38
8476480,2017,23.08,22.68,12,14,155,49,43,247,48,22,14,133,285,79,27
8476483,2017,24.13,23.16,18,17,230,95,81,406,69,34,18,196,105,115,32
8476495,2017,1.2,1.2,1,0,15,4,2,21,3,2,2,13,0,10,2
8476525,2017,8.45,8.08,18,13,177,88,155,420,41,10,17,167,1,165,35
8476539,2017,25.36,24.67,33,15,268,82,119,469,75,27,28,241,264,99,59
8476617,2017,1.21,1.18,2,0,15,2,3,20,3,1,0,14,0,6,5
8476619,2017,2.23,2.2,2,0,17,1,3,21,5,3,2,14,15,26,11
8476624,2017,6.29,6.12,3,4,57,25,20,102,14,7,7,50,154,68,20
8476779,2017,3.01,2.99,7,8,80,30,46,156,18,3,2,77,0,19,22
8476792,2017,10.51,9.88,26,19,197,77,142,416,59,14,14,183,0,79,35
8476806,2017,3.78,3.71,2,3,40,20,18,78,7,2,2,38,51,71,11
8476807,2017,0.74,0.72,0,0,25,6,16,47,0,0,2,25,0,13,1
8476822,2017,10.48,10.18,5,3,83,27,7,117,19,11,7,72,386,135,16
8476826,2017,18.89,18.42,23,16,136,54,50,240,64,25,11,111,158,57,52
8476850,2017,1.66,1.61,6,5,34,23,29,86,12,1,1,33,0,31,11
8476851,2017,18.93,18.14,16,16,213,70,99,382,51,19,19,194,49,33,29
8476853,2017,7.71,7.27,25,21,182,66,123,371,52,6,20,176,0,48,34
8476854,2017,8.07,7.81,9,9,131,48,99,278,31,13,13,118,0,93,24
8476855,2017,7.66,7.54,5,2,91,36,32,159,16,9,6,82,0,60,17
8476856,2017,8.79,8.56,19,17,176,77,116,369,50,14,7,162,2,136,22
8476857,2017,5.57,5.62,7,5,70,31,24,125,16,4,5,66,4,24,12
8476858,2017,4.09,3.9,6,2,64,31,28,123,13,5,4,59,0,88,16
8476866,2017,0,0,0,0,0,0,1,1,0,0,0,0,0,1,0
8476867,2017,5.08,5.1,2,0,55,20,21,96,6,4,1,51,38,48,16
8476869,2017,7.72,7.13,9,12,153,49,80,282,25,4,12,149,0,127,27
8476870,2017,0.69,0.67,1,0,8,5,6,19,1,0,1,8,1,8,5
8476871,2017,21.1,20.13,13,12,180,83,56,319,40,15,17,165,36,116,25
8476872,2017,11.27,11.13,7,3,108,38,27,173,20,10,5,98,314,126,22
8476873,2017,17.05,16.17,4,4,118,54,39,211,25,17,14,101,395,35,33
8476874,2017,5.06,4.98,10,12,164,51,103,318,29,7,10,157,0,131,17
8476875,2017,7.89,7.47,9,8,163,64,79,306,27,10,10,153,0,53,66
8476877,2017,0.08,0.08,1,0,5,1,7,13,1,0,0,5,0,4,0
8476878,2017,9.5,9.24,4,4,113,29,26,168,15,7,3,106,23,134,18
8476879,2017,7.7,7.26,8,6,143,62,110,315,19,5,10,138,0,163,18
8476880,2017,16.17,15.68,12,9,123,57,54,234,35,14,10,109,25,250,40
8476881,2017,27.33,26.08,14,10,175,89,68,332,46,22,19,153,587,84,60
8476882,2017,18.02,17.15,24,17,185,81,86,352,64,23,11,162,15,26,47
8476884,2017,3.61,3.5,9,10,78,46,61,185,22,3,5,75,0,79,24
8476885,2017,5.5,4.65,11,10,144,41,92,277,24,3,6,141,0,84,28
8476886,2017,1.97,1.94,2,2,43,10,21,74,8,4,1,39,0,36,3
8476887,2017,21.15,20.69,30,8,179,87,83,349,64,26,12,153,4,86,49
8476889,2017,12.16,11.65,8,8,118,31,39,188,33,17,14,101,549,100,37
8476890,2017,0.06,0.05,0,0,3,0,1,4,1,1,0,2,0,1,0
8476891,2017,3.46,3.37,4,8,82,43,53,178,15,3,3,79,0,45,26
8476892,2017,8.22,8.1,17,12,212,75,107,394,35,6,17,206,0,120,54
8476894,2017,8.86,8.3,13,4,95,27,47,169,22,5,6,90,8,32,39
8476897,2017,3.88,3.8,3,1,41,22,11,74,5,1,2,40,144,47,20
8476902,2017,7.08,6.94,5,15,136,43,84,263,27,7,8,129,0,90,18
8476905,2017,4.56,4.41,9,3,36,16,8,60,18,6,2,30,40,26,24
8476906,2017,12.93,11.61,21,31,221,99,138,458,65,13,25,208,0,53,23
8476913,2017,14.87,14.48,14,7,122,52,45,219,32,11,16,111,87,71,31
8476915,2017,9.7,9.29,4,6,73,39,46,158,21,11,2,62,174,128,26
8476917,2017,4.26,4.15,6,10,106,44,77,227,19,3,2,103,0,100,32
8476918,2017,17.02,16.12,8,3,136,51,53,240,28,17,9,119,15,83,46
8476919,2017,18.08,17.7,14,9,118,40,29,187,40,17,3,101,488,26,50
8476921,2017,11.87,11.4,6,3,112,54,45,211,15,6,12,106,39,128,32
8476922,2017,1.93,1.83,4,4,23,7,5,35,9,1,1,22,97,30,15
8476923,2017,4.92,4.8,11,4,121,43,74,238,24,9,9,112,0,107,26
8476924,2017,9.7,9.27,8,6,99,42,46,187,25,11,11,88,0,77,9
8476925,2017,12.15,12.15,8,10,120,33,39,192,27,9,6,111,517,136,25
8476931,2017,1.75,1.69,4,5,53,17,37,107,12,3,3,50,0,110,14
8476934,2017,22.93,22.15,6,8,160,85,82,327,30,16,14,144,17,137,38
8476941,2017,2.76,2.67,3,5,55,25,58,138,12,4,2,51,0,42,10
8476948,2017,13.42,13.16,13,7,179,34,73,286,30,10,15,169,88,126,37
8476952,2017,2.78,2.82,1,1,25,11,15,51,2,0,4,25,83,24,3
8476953,2017,0.02,0.02,0,0,1,0,0,1,0,0,0,1,0,0,0
8476955,2017,3.18,3.13,0,4,48,7,11,66,5,1,1,47,3,10,11
8476958,2017,6.2,6,11,11,154,54,92,300,30,8,12,146,0,47,77
8476960,2017,14.63,14.46,10,7,166,68,83,317,33,16,3,150,105,23,38
8476966,2017,4.25,4.28,5,0,42,10,14,66,11,6,5,36,43,33,12
8476967,2017,2.91,2.82,2,4,73,41,56,170,8,2,3,71,0,45,17
8476971,2017,3.19,3.14,1,0,26,15,12,53,7,6,2,20,0,11,13
8476975,2017,5.93,5.87,2,2,64,18,27,109,9,5,4,59,234,112,8
8476979,2017,2.68,2.57,6,5,71,25,35,131,16,5,5,66,0,30,12
8476981,2017,20.5,19.8,5,6,188,66,64,318,30,19,7,169,26,109,41
8476982,2017,1.3,1.23,3,1,17,3,6,26,4,0,3,17,58,5,8
8476983,2017,0.27,0.26,1,0,13,5,15,33,4,3,0,10,0,12,1
8476988,2017,4.85,4.69,7,8,111,53,73,237,21,6,15,105,0,149,18
8476994,2017,8.87,8.71,12,6,86,34,63,183,25,7,8,79,39,26,27
8477006,2017,0,0,0,0,0,0,0,0,0,0,0,0,0,0,0
8477009,2017,1.76,1.78,5,3,48,33,34,115,11,3,3,45,0,95,4
8477010,2017,0.11,0.12,0,0,4,0,0,4,0,0,0,4,0,2,1
8477015,2017,16.52,15.86,10,4,119,53,31,203,28,14,7,105,59,23,45
8477018,2017,3.88,3.73,2,4,103,36,65,204,6,0,3,103,0,40,26
8477021,2017,10.26,9.91,14,9,81,24,31,136,41,18,5,63,205,41,30
8477034,2017,0.33,0.32,1,0,7,7,5,19,1,0,0,7,0,6,4
8477043,2017,3.09,2.99,9,2,60,23,29,112,14,3,4,57,0,22,13
8477046,2017,3.03,2.94,2,7,79,23,58,160,12,3,5,76,0,33,14
8477070,2017,0.01,0.01,0,0,1,0,0,1,0,0,0,1,0,4,1
8477073,2017,1.7,1.69,1,2,19,8,16,43,4,1,2,18,0,77,3
8477085,2017,0.19,0.18,1,1,3,1,1,5,2,0,0,3,0,9,0
8477126,2017,0,0,0,0,0,0,0,0,0,0,0,0,0,0,0
8477205,2017,1.71,1.66,5,0,45,21,28,94,7,2,0,43,0,9,6
8477213,2017,16,15.78,6,4,133,38,39,210,22,12,11,121,76,132,31
8477215,2017,2.69,2.61,2,4,62,31,51,144,10,4,3,58,0,73,6
8477220,2017,7.26,6.88,14,17,103,58,94,255,36,5,4,98,0,41,57
8477240,2017,1.83,1.79,1,2,21,10,12,43,5,2,4,19,164,74,5
8477244,2017,1.87,1.84,1,2,67,29,38,134,5,2,4,65,0,67,11
8477290,2017,11.78,11.73,4,5,96,36,21,153,22,13,3,83,39,90,28
8477320,2017,0,0,0,0,0,0,0,0,0,0,0,0,0,3,0
8477337,2017,2.78,2.67,1,2,61,27,41,129,5,2,5,59,0,27,11
8477341,2017,1.62,1.53,0,1,19,4,4,27,3,2,0,17,2,5,4
8477346,2017,2.56,2.27,2,4,58,25,49,132,8,2,3,56,0,108,25
8477353,2017,7.22,6.88,2,0,64,23,26,113,7,5,7,59,6,93,15
8477355,2017,4.85,4.78,19,20,88,65,86,239,44,5,12,83,0,21,20
8477359,2017,0.91,0.91,1,0,27,19,17,63,2,1,2,26,0,20,5
8477369,2017,0.05,0.04,0,0,4,0,1,5,0,0,0,4,0,4,1
8477380,2017,4.31,4.28,2,0,53,17,18,88,6,4,2,49,4,35,5
8477392,2017,0.31,0.33,0,0,1,4,1,6,0,0,0,1,0,7,0
8477399,2017,0.17,0.16,0,0,2,2,1,5,0,0,0,2,0,15,1
8477401,2017,5.07,5.16,6,3,56,20,23,99,13,4,3,52,12,118,18
8477402,2017,13.05,12.38,18,11,136,55,75,266,43,14,13,122,12,51,39
8477404,2017,21.56,20.88,15,11,171,68,57,296,48,22,14,149,65,142,36
8477406,2017,14.62,14.27,11,4,135,38,51,224,34,19,11,116,71,14,32
8477407,2017,10.17,9.83,8,4,97,33,45,175,23,11,11,86,1,46,21
8477413,2017,9.85,9.82,6,8,111,39,48,198,22,8,6,103,7,38,22
8477415,2017,8.46,7.64,5,1,73,35,32,140,12,6,8,67,1,61,25
8477416,2017,13.71,13.27,17,12,163,69,59,291,40,11,11,152,1,64,26
8477417,2017,0.46,0.46,0,1,3,1,2,6,2,1,1,2,2,3,0
8477425,2017,15.04,14.6,5,8,170,56,36,262,32,19,13,151,2,75,24
8477426,2017,0.49,0.47,0,0,11,4,6,21,1,1,0,10,1,16,2
8477428,2017,0.07,0.07,0,0,1,1,1,3,0,0,0,1,0,2,0
8477429,2017,11.28,11.01,8,11,96,39,51,186,28,9,6,87,296,99,29
8477433,2017,0.73,0.7,1,0,26,15,29,70,1,0,2,26,0,71,8
8477444,2017,9.09,9.04,8,5,84,39,47,170,25,12,4,72,18,40,23
8477446,2017,0.92,0.92,1,0,15,5,7,27,1,0,0,15,60,61,3
8477447,2017,7.07,6.87,14,9,144,43,75,262,29,6,8,138,0,29,25
8477448,2017,2.32,2.33,0,1,22,11,5,38,3,2,1,20,1,26,3
8477449,2017,0.04,0.04,0,0,0,1,0,1,0,0,0,0,0,1,1
8477450,2017,1.03,1.02,1,1,16,6,12,34,2,0,0,16,69,45,5
8477451,2017,14.56,12.82,13,7,129,55,64,248,31,11,9,118,93,113,26
8477452,2017,1.07,1,0,1,26,20,19,65,4,3,2,23,0,71,3
8477453,2017,0.46,0.46,0,1,8,5,10,23,1,0,0,8,0,12,1
8477454,2017,2.91,2.77,0,1,29,13,7,49,4,3,1,26,5,37,4
8477455,2017,5.24,5.18,2,6,53,23,32,108,12,4,6,49,206,127,20
8477456,2017,13.26,12.79,7,3,131,45,55,231,23,13,4,118,273,45,16
8477458,2017,2.94,2.7,3,1,18,6,4,28,7,3,5,15,0,3,5
8477460,2017,0.01,0.01,0,0,1,0,0,1,0,0,0,1,5,1,0
8477461,2017,7.64,7.43,7,1,69,34,26,129,14,6,7,63,5,100,20
8477462,2017,3.1,3.05,3,3,89,40,53,182,9,3,10,86,0,238,8
8477463,2017,1.1,1.09,5,3,56,13,17,86,10,2,1,54,0,113,4
8477464,2017,1.41,1.33,0,0,16,3,8,27,2,2,0,14,12,4,6
8477467,2017,1.5,1.41,2,6,22,7,19,48,8,0,3,22,0,23,5
8477471,2017,0.12,0.12,0,1,6,3,1,10,1,0,0,6,0,7,0
8477472,2017,0.47,0.45,2,1,12,3,15,30,3,0,3,12,1,6,2
8477473,2017,1.49,1.46,0,1,19,6,5,30,4,3,0,16,0,19,4
8477474,2017,2.41,2.29,4,8,47,26,31,104,12,0,5,47,0,48,11
8477476,2017,19.04,18.56,7,2,164,56,70,290,21,12,15,152,11,71,27
8477478,2017,5.59,5.69,1,1,52,25,16,93,3,1,2,51,0,113,15
8477479,2017,11.68,11.41,9,8,82,46,23,151,24,7,8,75,1,52,13
8477488,2017,4.22,4.17,7,9,88,43,70,201,19,3,4,85,0,57,38
8477491,2017,3.62,3.64,1,1,45,13,12,70,6,4,3,41,2,16,4
8477492,2017,25.73,25.21,38,20,280,108,103,491,96,38,21,242,479,38,36
8477493,2017,27.59,26.25,27,24,250,61,57,368,77,26,17,224,892,30,79
8477494,2017,13.68,13.06,17,16,164,57,78,299,46,13,7,151,447,55,56
8477495,2017,12.3,11.87,25,16,249,112,124,485,57,16,18,233,0,92,67
8477496,2017,20.64,19.25,18,10,153,64,50,267,44,16,18,137,432,98,48
8477497,2017,34.83,31.91,22,11,202,84,66,352,64,31,18,171,709,35,51
8477498,2017,10.07,9.68,8,12,194,83,89,366,26,6,12,188,0,161,28
8477499,2017,7.18,6.85,18,17,182,71,100,353,41,6,5,176,0,206,12
8477500,2017,19.67,18.87,16,6,158,46,49,253,44,22,5,136,712,35,22
8477502,2017,0.14,0.14,0,0,1,1,1,3,0,0,0,1,0,7,1
8477503,2017,18.34,17.47,22,14,150,61,104,315,45,9,17,141,185,49,40
8477504,2017,5.53,5.35,7,12,102,40,73,215,26,7,7,95,1,139,22
8477505,2017,10.16,9.6,15,12,74,30,23,127,35,8,4,66,350,28,36
8477506,2017,8.9,8.41,10,12,184,65,109,358,32,10,10,174,0,113,25
8477507,2017,4.31,4.28,4,7,93,52,89,234,18,7,7,86,0,269,13
8477508,2017,8.29,7.8,7,3,65,29,30,124,12,2,9,63,48,130,9
8477509,2017,0.71,0.67,1,3,19,6,17,42,4,0,0,19,0,15,13
8477510,2017,0.61,0.63,0,1,7,2,0,9,2,1,2,6,2,13,1
8477511,2017,22.14,21.43,16,8,190,77,64,331,48,24,13,166,16,91,36
8477512,2017,1,0.99,0,0,12,2,2,16,1,1,1,11,27,12,3
8477520,2017,0.28,0.28,0,0,1,0,0,1,1,1,0,0,10,9,0
8477527,2017,2.32,2.28,1,2,19,6,6,31,6,3,2,16,1,46,7
8477529,2017,0.24,0.24,0,0,2,1,1,4,0,0,0,2,10,3,1
8477541,2017,0.1,0.09,0,0,7,1,3,11,0,0,0,7,0,5,0
8477573,2017,0.3,0.31,0,0,6,1,4,11,1,1,0,5,0,18,0
8477583,2017,0,0,0,0,0,0,0,0,0,0,0,0,0,1,0
8477591,2017,4.11,3.99,1,2,50,13,18,81,6,3,1,47,75,51,12
8477634,2017,0.24,0.25,0,2,5,4,5,14,3,1,1,4,0,6,3
8477642,2017,0.07,0.07,0,0,2,2,2,6,0,0,0,2,0,0,1
8477810,2017,0.32,0.31,0,0,2,5,1,8,0,0,1,2,0,1,0
8477839,2017,15.18,14.75,6,6,142,52,50,244,30,18,13,124,4,29,36
8477845,2017,4.54,4.4,5,8,111,44,41,196,16,3,7,108,0,25,45
8477846,2017,7.77,7.75,2,4,85,30,19,134,15,9,6,76,200,76,17
8477850,2017,1.57,1.5,7,3,58,23,32,113,13,3,7,55,0,167,8
8477851,2017,4.09,4.02,6,4,99,38,95,232,15,5,4,94,0,62,15
8477901,2017,6.13,5.78,3,7,52,30,22,104,16,6,4,46,3,30,12
8477903,2017,8.17,7.86,7,2,68,30,22,120,13,4,4,64,1,154,17
8477919,2017,1.14,1.16,0,3,14,9,9,32,3,0,0,14,69,8,5
8477922,2017,9.69,9.49,5,6,76,38,28,142,19,8,3,68,12,81,24
8477929,2017,1.65,1.61,0,3,19,6,7,32,4,1,1,18,34,31,9
8477930,2017,8.17,8.17,6,4,92,40,32,164,16,6,3,86,355,41,49
8477931,2017,10.21,9.99,6,2,92,36,26,154,15,7,9,85,35,53,36
8477932,2017,13.39,13.03,6,15,186,94,116,396,36,15,17,171,0,68,39
8477933,2017,24.54,23.23,14,11,188,71,40,299,50,25,12,163,56,48,29
8477934,2017,20.17,19.22,34,11,194,72,58,324,70,25,16,169,672,40,78
8477935,2017,17.59,17.06,9,6,157,73,63,293,26,11,15,146,119,140,54
8477936,2017,0.05,0.05,0,0,1,1,0,2,0,0,0,1,0,1,1
8477937,2017,12.97,12.87,4,6,130,68,47,245,20,10,5,120,7,156,51
8477938,2017,2.53,2.47,2,6,86,24,71,181,8,0,3,86,0,85,21
8477939,2017,21.4,20.55,28,13,184,81,115,380,61,20,13,164,334,21,68
8477940,2017,22.02,21.91,21,10,231,82,109,422,60,29,6,202,5,39,38
8477941,2017,17.07,16.51,6,11,122,71,42,235,27,10,17,112,6,221,10
8477942,2017,22.12,20.92,14,11,187,68,99,354,48,23,14,164,0,34,42
8477943,2017,13.87,13.53,7,6,129,72,79,280,30,17,3,112,5,83,16
8477944,2017,14.74,14.23,9,5,133,43,33,209,27,13,12,120,13,31,28
8477945,2017,1.23,1.18,2,1,41,17,42,100,4,1,2,40,0,20,2
8477946,2017,21.2,20.99,25,22,232,103,84,419,63,16,11,216,648,76,54
8477947,2017,6.48,6.41,4,4,69,32,21,122,22,14,7,55,0,28,14
8477948,2017,3.17,3.08,5,3,72,28,51,151,10,2,5,70,0,27,8
8477949,2017,21.72,21.19,15,7,171,73,58,302,37,15,17,156,70,99,57
8477950,2017,2.3,2.23,6,2,68,14,25,107,8,0,5,68,1,31,6
8477951,2017,15.28,14.8,15,16,118,40,60,218,52,21,7,97,321,13,86
8477953,2017,5.68,5.53,1,1,55,19,13,87,9,7,5,48,1,57,12
8477955,2017,9.64,9.25,11,8,142,25,43,210,28,9,12,133,211,42,38
8477956,2017,25.62,24.7,27,18,246,91,113,450,80,35,15,211,5,55,50
8477957,2017,3.88,3.64,1,1,39,15,31,85,6,4,1,35,2,18,13
8477958,2017,5.13,4.86,5,1,50,29,17,96,14,8,6,42,1,12,10
8477959,2017,1.72,1.79,6,4,18,8,9,35,12,2,1,16,2,3,10
8477960,2017,10.76,10.48,10,11,119,42,51,212,37,16,9,103,263,91,26
8477961,2017,0.36,0.35,0,0,5,1,3,9,0,0,0,5,0,4,0
8477962,2017,0.36,0.37,0,0,6,2,2,10,1,1,0,5,0,12,1
8477964,2017,6.75,6.76,3,3,45,33,25,103,13,7,2,38,61,70,21
8477969,2017,0.41,0.41,1,2,16,5,10,31,4,1,1,15,0,18,2
8477971,2017,0,0,0,0,0,0,0,0,0,0,0,0,0,3,1
8477973,2017,0.04,0.03,0,0,1,0,0,1,0,0,0,1,7,3,0
8477981,2017,0.16,0.16,0,3,7,5,14,26,3,0,0,7,0,3,1
8477986,2017,8.41,8.15,12,11,160,75,92,327,32,9,11,151,0,96,20
8477987,2017,3.59,3.55,3,1,24,6,12,42,9,5,1,19,12,6,3
8477989,2017,19.06,18.25,15,7,151,61,30,242,37,15,19,136,585,92,20
8477994,2017,0.27,0.3,0,0,3,1,1,5,0,0,0,3,7,3,3
8477998,2017,0.47,0.48,1,0,6,1,1,8,3,2,1,4,0,5,1
8478004,2017,0.4,0.38,0,1,14,10,14,38,1,0,0,14,0,56,4
8478010,2017,29.49,28.55,18,16,217,77,84,378,66,32,18,185,557,26,56
8478011,2017,0.02,0.02,0,2,0,2,2,4,2,0,0,0,0,1,0
8478020,2017,2.6,2.53,1,3,28,15,15,58,8,4,7,24,74,18,11
8478027,2017,1.29,1.26,0,0,16,5,5,26,1,1,1,15,38,13,4
8478042,2017,26.47,25.96,13,19,247,98,80,425,61,29,15,218,11,30,31
8478046,2017,13.82,13.7,12,19,135,43,53,231,47,16,10,119,10,45,42
8478055,2017,3.4,3.25,4,6,82,18,63,163,13,3,6,79,0,26,18
8478063,2017,0.27,0.26,1,0,4,0,2,6,1,0,0,4,0,0,3
8478067,2017,4.32,3.8,2,2,36,14,14,64,6,2,3,34,0,27,4
8478073,2017,0.73,0.73,2,2,22,10,31,63,4,0,2,22,0,97,8
8478075,2017,4.12,3.98,4,4,30,17,27,74,12,4,4,26,1,19,16
8478099,2017,13.66,13.3,20,9,156,66,74,296,40,11,11,145,5,31,28
8478104,2017,1.65,1.66,0,2,9,8,3,20,3,1,1,8,0,15,1
8478106,2017,0.45,0.42,1,2,9,1,5,15,3,0,0,9,0,0,3
8478131,2017,14.12,14.05,12,6,146,44,49,239,38,20,7,126,5,28,29
8478146,2017,2.5,2.23,0,0,27,7,9,43,2,2,1,25,1,9,1
8478176,2017,0.11,0.1,1,2,2,5,8,15,3,0,0,2,0,9,1
8478211,2017,0.48,0.48,1,0,12,8,3,23,1,0,0,12,1,22,3
8478233,2017,1.19,1.09,0,0,7,8,4,19,0,0,0,7,1,9,2
8478268,2017,0.06,0.06,0,0,0,2,1,3,0,0,0,0,0,5,2
8478365,2017,0.93,0.94,0,0,6,5,1,12,0,0,0,6,0,2,1
8478366,2017,5.96,5.78,3,0,72,24,25,121,10,7,2,65,10,51,11
8478373,2017,1.03,1.01,1,0,17,6,4,27,2,1,0,16,0,24,3
8478396,2017,9.19,8.85,11,11,165,52,124,341,32,10,23,155,0,81,50
8478397,2017,0.22,0.2,0,0,8,5,10,23,0,0,1,8,0,2,0
8478398,2017,23.95,22.99,13,13,192,49,48,289,57,31,14,161,2,18,39
8478400,2017,2.15,2.08,2,2,24,9,9,42,6,2,1,22,20,12,7
8478401,2017,11.63,11.28,12,5,112,48,31,191,25,8,7,104,318,70,37
8478402,2017,36.35,35.15,39,28,275,82,77,434,108,41,26,234,376,28,111
8478403,2017,19.79,19.15,23,16,246,92,96,434,64,25,16,221,347,52,38
8478407,2017,5.27,5.2,6,13,138,38,108,284,24,5,12,133,1,29,29
8478408,2017,2.1,2,4,8,54,14,38,106,13,1,4,53,0,48,9
8478413,2017,0.27,0.28,1,0,4,2,1,7,1,0,0,4,0,5,2
8478414,2017,22.54,21.35,5,10,210,85,65,360,36,21,19,189,71,105,48
8478420,2017,23.43,22.36,29,26,177,66,59,302,84,29,9,148,60,31,45
8478421,2017,0.56,0.56,1,1,13,2,5,20,2,0,0,13,1,29,3
8478425,2017,1.55,1.48,3,2,37,11,21,69,5,0,2,37,0,10,1
8478427,2017,23.83,23.21,24,12,200,90,100,390,65,29,11,171,78,65,59
8478431,2017,1.33,1.31,2,0,15,6,5,26,4,2,0,13,1,15,3
8478432,2017,17.58,16.89,10,8,154,42,44,240,33,15,20,139,5,109,15
8478439,2017,18.67,18.25,13,10,177,59,54,290,47,24,16,153,7,97,31
8478440,2017,5.03,5.06,2,3,30,18,16,64,9,4,2,26,92,7,12
8478443,2017,3.03,2.93,3,3,76,27,41,144,6,0,3,76,1,89,26
8478444,2017,16.56,16.07,13,13,179,61,101,341,55,29,7,150,10,29,26
8478445,2017,18.08,17.68,35,28,170,37,53,260,85,22,7,148,355,21,65
8478447,2017,0.05,0.04,0,0,0,1,0,1,0,0,0,0,0,0,1
8478451,2017,0.81,0.78,2,1,20,8,17,45,4,1,0,19,0,14,5
8478454,2017,0.81,0.81,1,1,33,8,29,70,3,1,1,32,0,58,6
8478458,2017,3.21,3.12,6,3,38,25,12,75,14,5,3,33,18,20,14
8478460,2017,12.94,12.43,12,9,207,76,100,383,37,16,12,191,0,58,32
8478462,2017,0.02,0.02,0,0,1,0,1,2,0,0,0,1,6,2,1
8478463,2017,14.87,14.51,10,5,132,38,49,219,36,21,3,111,72,80,26
8478466,2017,2.06,2.03,1,0,22,8,3,33,3,2,1,20,0,9,0
8478469,2017,4.95,4.8,9,7,94,21,66,181,25,9,9,85,0,44,27
8478474,2017,1.11,1.06,0,0,13,6,5,24,1,1,1,12,3,29,2
8478476,2017,0.01,0.01,0,0,0,1,0,1,0,0,0,0,0,3,1
8478483,2017,19.04,17.79,27,20,194,83,122,399,69,22,13,172,50,31,85
8478488,2017,1.69,1.68,3,0,21,12,5,38,4,1,3,20,50,19,9
8478493,2017,9.98,9.75,4,6,124,31,36,191,16,6,9,118,201,134,17
8478498,2017,14.77,14.62,14,13,143,55,48,246,43,16,11,127,13,70,31
8478500,2017,10.14,9.61,11,13,203,60,130,393,41,17,13,186,0,148,26
8478506,2017,0.49,0.48,0,2,18,1,7,26,2,0,0,18,0,10,2
8478512,2017,0.8,0.76,3,1,7,4,1,12,4,0,1,7,14,4,2
8478519,2017,3,2.92,5,1,26,7,8,41,11,5,1,21,96,17,8
8478528,2017,0.46,0.45,1,1,7,2,1,10,3,1,1,6,35,3,3
8478541,2017,2.34,2.44,1,2,31,7,12,50,6,3,3,28,3,31,10
8478542,2017,7.01,6.82,7,11,91,39,36,166,25,7,9,84,156,19,20
8478550,2017,22.53,22.05,35,20,228,110,132,470,82,27,12,201,0,15,70
8478561,2017,0.94,0.91,0,0,14,3,9,26,1,1,0,13,0,35,2
8478567,2017,0.57,0.59,1,3,12,2,4,18,4,0,0,12,0,2,0
8478569,2017,7.75,7.48,1,0,66,26,21,113,11,10,6,56,42,152,20
8478585,2017,18.36,17.22,12,11,135,67,45,247,38,15,14,120,531,52,54
8478842,2017,0.13,0.12,0,2,3,1,5,9,3,1,0,2,0,19,1
8478843,2017,8.2,8.06,6,5,79,29,32,140,22,11,7,68,51,46,30
8478846,2017,0.51,0.48,0,2,14,2,4,20,3,1,1,13,0,5,3
8478866,2017,4.29,3.99,4,4,36,15,17,68,12,4,2,32,6,37,10
8478868,2017,0,0,0,0,0,0,2,2,0,0,0,0,0,4,0
8478873,2017,0.18,0.19,0,0,3,0,0,3,0,0,0,3,0,0,0
8478874,2017,0.67,0.65,0,0,9,5,6,20,0,0,0,9,6,2,1
8478906,2017,3.92,3.74,10,6,79,34,43,156,23,7,6,72,0,42,9
8478915,2017,0.14,0.14,0,0,2,0,1,3,1,1,0,1,0,0,1
8479066,2017,0.25,0.26,1,0,5,0,1,6,1,0,1,5,0,11,0
8479206,2017,2.66,2.75,4,0,27,10,11,48,7,3,0,24,47,59,4
8479250,2017,0.77,0.78,0,0,7,2,2,11,1,1,2,6,0,8,1
8479268,2017,2.04,1.95,3,2,48,18,37,103,8,3,1,45,0,31,8
8479290,2017,0.77,0.68,1,0,9,4,0,13,2,1,0,8,26,7,4
8479291,2017,0.32,0.29,0,0,3,1,0,4,0,0,0,3,1,2,1
8479293,2017,7.7,7.61,3,7,79,32,24,135,18,8,7,71,3,188,20
8479304,2017,0.59,0.57,0,0,5,1,2,8,0,0,0,5,19,13,3
8479314,2017,22.88,22.15,14,11,188,82,39,309,49,24,17,164,7,80,32
8479316,2017,2.53,2.49,1,1,32,8,14,54,4,2,1,30,24,34,2
8479318,2017,22.83,21.38,18,11,187,68,58,313,63,34,10,153,375,16,59
8479325,2017,5.5,5.41,10,15,77,45,65,187,32,7,3,70,0,133,22
8479337,2017,19.54,19.1,15,9,181,71,106,358,52,28,7,153,25,40,33
8479339,2017,27.36,26.39,12,14,241,113,113,467,70,44,7,197,11,74,29
8479343,2017,24.34,22.72,23,19,212,91,82,385,65,23,24,189,37,7,42
8479344,2017,12.67,12.15,7,1,136,49,47,232,20,12,15,124,0,67,27
8479345,2017,5.53,5.4,6,4,102,58,75,235,14,4,14,98,0,74,19
8479366,2017,0.55,0.55,0,1,4,2,1,7,1,0,0,4,4,1,2
8479370,2017,10.98,10.76,6,4,110,30,50,190,22,12,10,98,80,33,22
8479376,2017,2.63,2.5,5,2,43,19,35,97,7,0,6,43,0,1,6
8479398,2017,3.39,3.32,9,9,82,36,51,169,22,4,7,78,0,46,13
8479400,2017,19.7,19.25,12,16,165,57,52,274,48,20,12,145,461,127,38
8479404,2017,0.51,0.52,0,0,6,2,2,10,1,1,1,5,15,1,2
8479407,2017,9.05,8.73,12,10,100,39,36,175,35,13,5,87,7,44,25
8479410,2017,7.71,7.47,17,14,141,81,108,330,40,9,13,132,0,90,21
8479420,2017,4.04,3.97,3,3,55,34,24,113,9,3,6,52,1,39,20
8479423,2017,0.51,0.46,0,0,2,2,0,4,1,1,0,1,0,0,0
8479442,2017,3.79,3.53,6,4,94,43,76,213,11,1,6,93,0,111,22
8479458,2017,2.08,2.02,5,3,54,29,83,166,13,5,4,49,0,113,21
8479465,2017,12.76,12.32,5,2,104,32,45,181,20,13,6,91,11,147,27
8479482,2017,2.49,2.49,5,2,82,29,57,168,10,3,4,79,0,57,9
8479483,2017,2.7,2.71,2,4,69,14,45,128,9,3,3,66,0,18,8
8479511,2017,0.65,0.59,0,0,6,2,2,10,0,0,1,6,0,1,3
8479553,2017,2.35,2.35,0,1,28,9,9,46,4,3,3,25,0,50,13
8479580,2017,0.03,0.03,0,0,1,1,1,3,0,0,0,1,9,0,0
8479595,2017,0.07,0.07,0,0,5,2,3,10,1,1,0,4,0,5,0
8479613,2017,0.04,0.04,0,0,0,1,0,1,0,0,0,0,0,0,0
8479650,2017,0.67,0.56,0,0,3,5,0,8,1,1,0,2,12,1,0
8479755,2017,1.71,1.58,4,6,40,13,26,79,10,0,4,40,0,14,4
8479944,2017,2.65,2.69,2,0,20,4,8,32,6,4,3,16,1,55,6
8479968,2017,2.63,2.64,2,2,28,20,9,57,5,1,3,27,5,22,2
8479974,2017,16.36,16.01,11,6,127,40,38,205,30,13,12,114,376,48,32
8479977,2017,3.5,3.12,1,2,23,8,10,41,3,0,6,23,0,6,5
8479999,2017,0.98,0.97,2,2,9,3,3,15,5,1,0,8,17,2,0
8480002,2017,21.36,20.86,21,11,180,57,52,289,52,20,20,160,422,56,56
8480009,2017,0.48,0.47,0,0,3,2,1,6,0,0,1,3,0,2,0
8480015,2017,0.92,0.87,0,0,17,4,10,31,1,1,0,16,0,3,2
8480029,2017,0,0,0,0,0,0,0,0,0,0,0,0,0,1,0
8480039,2017,0,0,0,0,0,0,0,0,0,0,0,0,0,0,1
8480072,2017,0.32,0.3,1,0,5,3,2,10,2,1,0,4,19,9,4
8480078,2017,3.2,2.84,1,1,21,6,4,31,3,1,3,20,28,3,1
8480082,2017,0,0,0,0,0,0,0,0,0,0,0,0,0,0,0
8480113,2017,13.05,12.8,10,6,129,54,50,233,25,9,8,120,14,53,24
8480143,2017,1.69,1.67,3,3,33,20,22,75,8,2,2,31,0,42,4
8480144,2017,5.3,5.26,2,5,46,20,19,85,11,4,2,42,291,29,14
8480145,2017,2.13,2.1,6,7,54,16,35,105,14,1,1,53,0,49,13
8480147,2017,1.86,1.78,2,5,33,21,20,74,9,2,6,31,0,43,3
8480153,2017,0.34,0.33,0,1,7,1,8,16,1,0,0,7,20,6,2
8480157,2017,0.28,0.26,0,1,5,3,5,13,1,0,0,5,0,1,2
8480158,2017,1.76,1.72,3,5,46,25,46,117,11,3,2,43,0,121,13
8480163,2017,0.01,0.01,0,0,0,1,0,1,0,0,0,0,0,1,0
8480164,2017,0.37,0.36,0,1,3,0,0,3,1,0,0,3,0,5,0
8480172,2017,3.72,3.63,5,9,71,29,69,169,20,6,2,65,0,24,12
8480222,2017,0.83,0.85,1,2,24,9,21,54,4,1,1,23,0,10,3
8480330,2017,1.9,1.56,0,0,16,4,2,22,2,2,1,14,1,6,2
8480727,2017,0,0,0,0,0,0,1,1,0,0,0,0,0,0,0
8480761,2017,0.04,0.03,0,0,1,1,1,3,0,0,0,1,0,0,0
8480762,2017,0.11,0.11,0,0,2,1,0,3,0,0,0,2,0,0,0
8480771,2017,0,0,0,1,0,0,1,1,1,0,0,0,0,1,0
8448208,2016,23.04,21.86,20,10,178,59,54,291,46,16,19,162,1,19,37
8462038,2016,13.16,12.6,17,4,139,47,48,234,26,5,8,134,89,99,26
8462042,2016,16.75,15.27,10,3,154,55,54,263,27,14,11,140,16,114,24
8464989,2016,15.62,14.96,10,8,95,33,29,157,31,13,12,82,440,36,20
8465009,2016,6.69,6.55,10,9,136,53,90,279,29,10,9,126,0,130,35
8465058,2016,0.81,0.79,2,0,16,6,4,26,3,1,2,15,0,47,5
8465978,2016,3.05,2.96,0,2,42,20,18,80,4,2,4,40,5,51,8
8466138,2016,9.97,9.73,17,25,81,36,28,145,49,7,5,74,368,52,64
8466139,2016,27.05,26.2,7,12,188,84,51,323,46,27,15,161,115,82,46
8466148,2016,19.98,19.54,11,8,167,59,77,303,45,26,10,141,5,32,47
8466251,2016,11.71,11.61,7,6,121,29,30,180,33,20,6,101,16,149,20
8466285,2016,4.15,3.95,6,6,75,35,61,171,17,5,5,70,0,43,11
8467370,2016,13.7,12.71,17,7,120,43,31,194,42,18,10,102,703,160,21
8467371,2016,4.79,4.53,10,11,38,12,24,74,25,4,1,34,183,33,10
8467400,2016,4.99,4.13,8,5,131,54,88,273,17,4,1,127,0,72,27
8467407,2016,14.5,14.25,14,6,149,55,39,243,35,15,10,134,46,54,28
8467493,2016,3.68,3.51,1,2,42,9,15,66,4,1,0,41,0,108,11
8467496,2016,3.87,3.52,21,9,98,42,83,223,36,6,6,92,0,39,28
8467875,2016,19.77,18.76,22,7,216,69,60,345,44,15,6,201,3,20,26
8467876,2016,11.76,11.26,13,22,99,30,31,160,50,15,5,84,611,15,29
8467967,2016,7.85,7.62,6,1,86,19,24,129,12,5,7,81,223,71,18
8468001,2016,9.11,8.92,7,3,90,33,30,153,16,6,4,84,386,190,34
8468083,2016,13.51,13.1,35,16,195,62,78,335,68,17,10,178,705,58,38
8468085,2016,16.92,15.95,23,11,226,75,91,392,54,20,14,206,14,46,33
8468208,2016,14.7,14.06,8,11,103,58,46,207,28,9,10,94,220,59,34
8468309,2016,6,5.1,6,15,114,40,70,224,27,6,10,108,0,38,16
8468483,2016,12.67,11.93,9,2,123,46,47,216,21,10,11,113,0,21,7
8468486,2016,11.6,11.22,15,9,104,33,35,172,37,13,8,91,3,94,17
8468493,2016,3.69,3.61,8,5,71,38,77,186,17,4,6,67,0,93,25
8468498,2016,2.71,2.65,6,7,91,33,55,179,13,0,4,91,0,181,12
8468505,2016,4.5,4.4,2,2,45,12,19,76,7,3,0,42,153,144,11
8468508,2016,18.83,18.29,8,16,166,67,55,288,47,23,14,143,64,28,36
8468509,2016,2.78,2.67,5,6,67,23,47,137,13,2,3,65,0,77,6
8468513,2016,1.21,1.2,3,1,25,16,22,63,4,0,1,25,0,45,2
8468535,2016,10.76,10.45,10,9,88,43,31,162,28,9,7,79,744,51,14
8468542,2016,1.5,1.5,5,17,57,19,49,125,26,4,3,53,0,41,34
8468575,2016,10.37,9.91,7,7,96,21,35,152,25,11,4,85,357,63,31
8468611,2016,3.31,3.13,0,3,42,9,10,61,7,4,0,38,132,79,10
8468639,2016,1.57,1.53,3,2,36,19,31,86,5,0,3,36,2,25,11
8468674,2016,3.51,3.46,6,6,107,34,77,218,16,4,7,103,1,135,19
8469455,2016,14.27,13.82,15,20,149,71,65,285,50,15,13,134,354,13,32
8469459,2016,16.21,15.84,14,26,140,55,65,260,58,18,15,122,938,32,39
8469465,2016,3.34,3.23,7,8,83,34,84,201,16,1,5,82,0,93,19
8469466,2016,3.58,3.48,3,0,30,11,11,52,7,4,3,26,0,1,9
8469492,2016,1.44,1.41,1,11,46,17,31,94,13,1,0,45,0,115,15
8469500,2016,13.08,12.64,14,7,142,50,52,244,31,10,6,132,17,44,24
8469501,2016,2.99,2.92,1,0,36,9,18,63,4,3,0,33,13,90,4
8469506,2016,14.46,14.34,19,15,176,59,71,306,47,13,16,163,39,44,22
8469508,2016,5.58,5.65,2,1,37,28,22,87,8,5,5,32,253,49,29
8469521,2016,13.78,13.34,9,9,139,42,55,236,28,10,11,129,692,57,30
8469544,2016,12.62,12.3,4,6,146,48,67,261,18,8,8,138,29,24,16
8469547,2016,4.37,4.24,0,1,43,16,22,81,3,2,2,41,1,52,9
8469598,2016,5.18,5.16,2,9,94,52,51,197,14,3,5,91,0,173,13
8469619,2016,2.66,2.57,5,12,89,22,55,166,22,5,8,84,0,154,10
8469638,2016,10.48,10.11,11,6,114,39,41,194,28,11,7,103,75,28,26
8469665,2016,1.86,1.76,3,4,37,33,48,118,9,2,5,35,0,29,14
8469707,2016,11.82,11.25,8,7,123,25,25,173,28,13,17,110,6,60,21
8469759,2016,4,4.01,1,1,48,24,17,89,4,2,3,46,370,57,12
8469760,2016,0.02,0.01,0,0,2,0,1,3,0,0,0,2,0,5,0
8469770,2016,4.74,4.66,6,7,87,30,74,191,18,5,2,82,0,61,21
8470041,2016,22.12,20.72,13,2,192,70,54,316,38,23,14,169,0,62,42
8470047,2016,12.47,12.12,21,9,97,31,19,147,42,12,7,85,556,26,30
8470104,2016,0.45,0.46,4,0,12,9,9,30,5,1,0,11,0,10,1
8470105,2016,8.56,8.65,6,2,86,24,33,143,18,10,10,76,3,99,16
8470110,2016,5.25,5.11,6,8,84,33,39,156,19,5,6,79,0,29,20
8470121,2016,0.4,0.39,0,1,14,10,26,50,2,1,0,13,0,71,3
8470144,2016,16.43,15.89,12,12,162,57,56,275,41,17,11,145,653,64,29
8470151,2016,3.78,3.75,7,7,106,33,66,205,15,1,8,105,0,67,11
8470159,2016,1.04,0.82,0,0,8,2,3,13,1,1,2,7,48,4,2
8470162,2016,6.98,6.79,10,7,59,33,16,108,23,6,6,53,385,60,30
8470187,2016,7.76,7.11,10,7,155,80,104,339,23,6,6,149,1,160,13
8470201,2016,2.34,2.28,5,3,27,11,17,55,11,3,4,24,3,9,12
8470257,2016,14.65,14.51,20,15,117,57,54,228,51,16,11,101,101,33,27
8470281,2016,5.63,5.5,19,28,183,60,141,384,53,6,9,177,0,24,32
8470318,2016,1.7,1.69,4,4,43,26,26,95,9,1,3,42,0,86,9
8470324,2016,1.81,1.71,3,2,40,14,26,80,6,1,0,39,0,143,7
8470358,2016,13.35,12.93,10,6,143,37,57,237,31,15,9,128,5,68,35
8470543,2016,12.66,12.25,11,9,134,40,46,220,29,9,11,125,3,216,25
8470595,2016,25.26,24.68,24,13,211,63,87,361,65,28,17,183,577,42,51
8470598,2016,15.72,15.23,21,10,133,39,44,216,48,17,14,116,6,29,21
8470599,2016,0.56,0.51,0,1,6,2,2,10,2,1,0,5,0,7,3
8470600,2016,8.47,8.12,10,21,164,62,106,332,40,9,12,155,0,72,41
8470601,2016,4.41,4.31,4,3,102,40,78,220,12,5,5,97,0,109,6
8470602,2016,9.28,7.93,10,11,156,56,98,310,30,9,10,147,0,132,16
8470604,2016,28.33,27.59,22,12,250,108,110,468,66,32,29,218,735,86,24
8470606,2016,18.4,17.76,9,13,175,76,75,326,36,14,21,161,2,190,25
8470607,2016,5.85,5.72,16,20,131,60,107,298,39,3,12,128,0,111,24
8470610,2016,27.45,26.26,17,6,194,56,50,300,42,19,23,175,8,46,33
8470611,2016,7.01,7.01,3,2,62,17,18,97,11,6,6,56,79,82,24
8470612,2016,15.42,15.02,38,20,142,74,79,295,73,15,13,127,510,102,61
8470613,2016,16.09,15.77,27,20,316,158,290,764,76,29,21,287,0,68,53
8470614,2016,0.79,0.78,1,1,24,9,19,52,4,2,2,22,0,68,3
8470616,2016,27.47,25.44,23,13,186,93,73,352,58,22,17,164,1029,146,22
8470619,2016,14.05,13.59,7,5,131,50,35,216,25,13,7,118,303,115,22
8470621,2016,25.39,24.77,21,13,215,101,69,385,53,19,23,196,7,81,32
8470622,2016,28.81,27.25,8,11,209,87,64,360,51,32,21,177,2,89,30
8470626,2016,15.14,14.48,10,3,132,27,53,212,24,11,9,121,0,11,37
8470630,2016,3.06,2.99,6,5,53,22,39,114,14,3,3,50,0,133,10
8470638,2016,30.27,28.75,21,11,302,91,87,480,53,21,17,281,1089,54,65
8470640,2016,0.04,0.04,1,0,2,1,1,4,1,0,0,2,0,3,0
8470642,2016,10.3,9.99,9,16,183,101,141,425,42,17,10,166,0,140,11
8470644,2016,0.54,0.55,0,0,5,1,0,6,1,1,0,4,0,9,0
8470655,2016,19.93,19.19,12,9,175,66,45,286,38,17,15,158,60,226,28
8470667,2016,0.3,0.31,0,0,5,4,4,13,0,0,0,5,0,4,1
8470724,2016,3.23,3.19,5,4,79,17,67,163,15,6,4,73,0,97,19
8470740,2016,18.06,17.5,13,11,131,56,62,249,40,16,13,115,3,113,57
8470750,2016,5.09,4.89,1,3,56,28,41,125,7,3,1,53,294,86,29
8470755,2016,2.58,2.53,1,3,25,7,12,44,9,5,1,20,121,19,10
8470760,2016,2.62,2.42,5,7,69,11,33,113,12,0,1,69,0,164,11
8470775,2016,1.1,1.06,0,1,19,5,10,34,2,1,1,18,130,69,6
8470778,2016,4.07,3.87,1,1,43,13,13,69,7,5,7,38,2,71,13
8470794,2016,31.4,30.38,23,16,231,108,79,418,68,29,13,202,440,130,33
8470803,2016,5.6,5.38,3,4,55,17,19,91,15,8,4,47,323,56,33
8470828,2016,1.75,1.72,7,6,46,20,45,111,14,1,6,45,0,24,8
8470834,2016,14.83,14.31,20,19,241,101,110,452,52,13,17,228,0,183,65
8470852,2016,16.16,15.19,9,9,134,40,26,200,32,14,13,120,1,37,18
8470854,2016,1.13,1.13,0,1,8,7,3,18,2,1,2,7,2,37,2
8470886,2016,0.49,0.48,1,1,16,3,10,29,3,1,1,15,0,35,2
8470966,2016,9.93,9.6,12,15,151,78,144,373,39,12,11,139,0,78,45
8471214,2016,28.85,27.81,20,16,309,139,168,616,68,32,26,277,0,216,29
8471215,2016,22.77,21.88,26,13,192,57,65,314,72,33,19,159,365,40,52
8471217,2016,16.66,16.24,7,1,142,64,71,277,31,23,10,119,4,112,37
8471218,2016,25.64,24.05,33,15,259,86,74,419,74,26,21,233,43,100,39
8471226,2016,9.33,8.89,9,4,109,22,24,155,21,8,9,101,7,62,13
8471228,2016,20.41,19.87,26,10,148,67,68,283,54,18,13,130,6,76,42
8471232,2016,10.05,9.65,9,3,108,31,39,178,20,8,13,100,0,37,12
8471233,2016,15.24,14.62,21,10,126,35,34,195,45,14,11,112,884,81,44
8471242,2016,7.01,6.92,14,8,125,58,101,284,36,14,6,111,0,67,24
8471254,2016,1.22,1.2,0,0,8,6,6,20,1,1,0,7,0,16,3
8471260,2016,10.35,9.91,6,6,101,41,52,194,20,8,6,93,114,128,34
8471262,2016,10.32,9.95,4,4,127,44,39,210,14,6,11,121,360,32,30
8471269,2016,0.04,0.04,0,0,3,0,4,7,0,0,0,3,0,7,0
8471273,2016,12.62,12.14,21,8,115,41,48,204,41,12,7,103,770,248,38
8471274,2016,4.36,4.16,14,16,110,43,78,231,36,6,9,104,0,136,15
8471276,2016,21.55,19.19,23,8,158,71,81,310,54,23,8,135,659,40,60
8471284,2016,7.25,6.97,13,14,128,64,127,319,35,8,6,120,0,54,35
8471296,2016,2.81,2.74,3,5,82,45,73,200,10,2,4,80,0,241,16
8471303,2016,5.44,5.28,7,8,138,56,115,309,21,6,4,132,2,106,17
8471331,2016,0.14,0.15,0,0,0,1,1,2,0,0,0,0,7,5,2
8471338,2016,8.39,8.32,4,5,68,30,26,124,17,8,9,60,410,47,43
8471339,2016,2.09,2.02,1,1,22,11,9,42,4,2,0,20,5,48,7
8471346,2016,11.33,11.02,10,12,136,42,76,254,37,15,7,121,53,5,38
8471385,2016,0.11,0.11,0,0,4,1,1,6,0,0,1,4,0,3,1
8471392,2016,2.42,2.37,2,5,64,38,63,165,11,4,5,60,0,232,16
8471426,2016,10.92,10.59,5,7,87,40,26,153,25,13,4,74,20,171,22
8471436,2016,2.38,2.34,9,9,73,38,63,174,19,1,3,72,0,91,26
8471476,2016,8.96,8.75,10,3,78,33,18,129,23,10,11,68,9,25,30
8471490,2016,7.92,7.76,3,3,87,40,43,170,16,10,6,77,135,91,19
8471498,2016,8.97,8.62,10,2,73,32,27,132,20,8,6,65,0,43,21
8471504,2016,9.33,8.71,3,3,110,45,37,192,17,11,9,99,0,74,24
8471657,2016,2.44,2.48,0,1,30,8,9,47,6,5,0,25,0,150,4
8471663,2016,0.03,0.03,0,0,1,0,0,1,0,0,0,1,0,6,0
8471664,2016,0.07,0.07,0,0,3,1,1,5,0,0,0,3,0,3,0
8471669,2016,15.16,14.51,16,6,112,33,27,172,40,18,6,94,786,51,24
8471675,2016,30.77,30.15,28,17,255,70,86,411,89,44,20,211,842,80,39
8471676,2016,10.44,10.04,8,4,111,49,68,228,25,13,8,98,6,109,27
8471677,2016,4.46,4.28,6,12,116,36,72,224,23,5,10,111,1,94,20
8471678,2016,8.77,8.43,5,1,77,36,33,146,14,8,6,69,7,39,39
8471681,2016,6.68,6.58,4,0,73,28,20,121,9,5,5,68,2,74,14
8471682,2016,6.72,6.61,4,4,60,25,25,110,12,4,4,56,2,53,15
8471685,2016,18.44,17.47,22,18,150,72,68,290,52,12,17,138,892,78,29
8471686,2016,3.24,3.23,4,2,68,34,42,144,9,3,2,65,0,88,22
8471691,2016,19.9,18.56,12,7,167,57,45,269,39,20,16,147,754,144,31
8471693,2016,1.06,1.03,2,1,41,17,19,77,3,0,3,41,0,47,9
8471698,2016,20.55,20.08,16,7,140,75,31,246,56,33,11,107,85,94,48
8471699,2016,16.8,16.32,10,9,179,51,63,293,35,16,14,163,8,76,19
8471702,2016,6,5.99,17,17,152,58,122,332,39,5,7,147,0,146,35
8471707,2016,21.4,20,14,4,202,58,78,338,41,23,12,179,3,84,40
8471709,2016,5.83,5.79,14,7,143,69,103,315,27,6,6,137,0,18,22
8471710,2016,0.75,0.74,1,3,19,9,6,34,5,1,3,18,0,27,3
8471716,2016,12.2,11.82,9,5,104,36,20,160,21,7,7,97,5,144,15
8471717,2016,2.08,2.05,4,4,64,30,42,136,10,2,5,62,0,157,10
8471724,2016,6.25,6.11,9,20,122,41,64,227,34,5,10,117,0,70,30
8471729,2016,3.02,2.91,2,10,67,35,59,161,13,1,3,66,0,67,36
8471735,2016,8.51,7.67,19,17,174,88,127,389,40,4,7,170,0,28,24
8471742,2016,3.08,3.03,6,10,93,40,67,200,19,3,9,90,0,87,14
8471743,2016,0.69,0.67,0,0,2,1,1,4,1,1,0,1,6,0,1
8471760,2016,0.01,0.01,0,0,1,0,2,3,0,0,0,1,0,14,2
8471761,2016,0.02,0.02,0,0,1,0,2,3,0,0,0,1,0,0,0
8471762,2016,7.04,6.87,3,6,69,19,33,121,15,6,6,63,22,114,14
8471766,2016,0.91,0.89,3,0,13,6,7,26,3,0,1,13,0,68,2
8471768,2016,11.6,11.49,9,5,95,39,30,164,23,9,8,86,21,46,35
8471769,2016,2.97,2.76,7,6,61,17,57,135,18,5,3,56,0,23,23
8471794,2016,10.13,9.92,3,6,98,31,37,166,17,8,4,90,216,71,17
8471811,2016,0.26,0.27,1,0,2,0,1,3,1,0,1,2,24,2,1
8471816,2016,0.18,0.17,2,0,4,3,0,7,2,0,1,4,0,1,0
8471817,2016,7.1,6.92,5,1,58,25,22,105,13,7,6,51,0,239,11
8471873,2016,7.98,7.41,8,9,130,53,74,257,22,5,15,125,0,106,26
8471887,2016,24.9,23.93,15,8,223,50,53,326,44,21,19,202,3,227,30
8471956,2016,4.46,4.39,0,1,46,13,25,84,1,0,3,46,39,73,9
8471958,2016,1.55,1.49,2,9,55,25,44,124,15,4,4,51,0,105,10
8471976,2016,5.37,5.17,3,5,46,9,17,72,14,6,3,40,170,5,21
8471996,2016,0.15,0.15,0,0,3,2,0,5,0,0,0,3,10,5,0
8472382,2016,4.54,4.41,6,3,83,54,53,190,13,4,6,79,0,50,26
8472410,2016,1.15,1.14,5,0,17,3,8,28,6,1,1,16,56,56,5
8473412,2016,16.59,15.99,16,10,119,39,31,189,47,21,11,98,610,35,31
8473415,2016,1.23,1.23,1,2,37,22,20,79,3,0,1,37,0,97,5
8473419,2016,31.02,29.07,23,23,226,94,88,408,85,39,12,187,13,51,69
8473422,2016,24.71,23.58,14,11,185,56,39,280,51,26,15,159,41,157,44
8473432,2016,1.92,1.86,2,1,24,2,7,33,4,1,4,23,1,35,2
8473446,2016,4.17,3.83,7,8,96,34,74,204,17,2,9,94,0,87,18
8473449,2016,19.27,18.48,13,13,156,57,71,284,45,19,14,137,54,53,26
8473453,2016,13.76,13.15,8,4,145,64,39,248,24,12,13,133,44,174,18
8473463,2016,15.92,15.29,11,7,114,38,26,178,32,14,8,100,91,232,46
8473465,2016,11.13,10.41,4,4,112,34,23,169,17,9,15,103,1,114,5
8473466,2016,4.61,4.55,4,3,58,21,22,101,16,9,2,49,36,184,11
8473468,2016,1.91,1.79,3,1,45,19,37,101,6,2,0,43,0,145,6
8473473,2016,24.01,23.27,19,7,173,70,60,303,49,23,14,150,3,197,26
8473485,2016,8.58,8.38,4,4,82,27,24,133,21,13,4,69,2,85,15
8473492,2016,6.09,5.98,1,4,79,34,36,149,8,3,0,76,29,98,7
8473504,2016,13.15,12.48,10,5,115,36,48,199,20,5,6,110,3,222,30
8473507,2016,8.16,7.95,11,9,172,79,110,361,28,8,11,164,0,171,19
8473512,2016,15.53,15,23,21,199,81,86,366,58,14,15,185,977,68,38
8473533,2016,24.74,23.04,11,18,164,66,43,273,45,16,20,148,689,139,55
8473534,2016,20.31,20.08,7,4,153,72,50,275,34,23,8,130,584,155,43
8473537,2016,10.56,10.48,5,0,101,41,39,181,16,11,7,90,0,141,37
8473542,2016,0.15,0.14,1,1,3,0,3,6,2,0,0,3,0,19,0
8473544,2016,17.98,17.31,12,13,195,70,72,337,39,14,14,181,612,92,37
8473546,2016,23.41,23.22,9,4,162,59,43,264,40,27,8,135,7,41,46
8473548,2016,17.65,17.04,25,22,229,66,112,407,70,23,18,206,5,12,15
8473560,2016,0.78,0.77,2,3,14,9,13,36,7,2,1,12,0,71,3
8473563,2016,18.54,17.88,31,31,160,57,50,267,85,23,6,137,678,45,60
8473564,2016,18.6,18.07,11,16,202,69,81,352,44,17,11,185,13,60,45
8473565,2016,0.16,0.16,2,0,3,4,3,10,2,0,0,3,0,5,0
8473571,2016,0.11,0.11,0,0,3,2,3,8,0,0,0,3,0,0,1
8473573,2016,16.11,15.59,12,11,105,35,51,191,45,22,7,83,416,18,35
8473574,2016,5.47,5.24,3,1,51,22,13,86,12,8,2,43,5,47,10
8473579,2016,12.63,12.16,7,4,74,41,31,146,23,12,7,62,14,78,30
8473584,2016,3.19,3.09,12,4,65,30,64,159,18,2,4,63,0,39,8
8473588,2016,0.76,0.73,0,0,8,3,4,15,0,0,1,8,1,5,3
8473604,2016,22.4,21.72,21,16,199,49,63,311,58,21,18,178,852,43,37
8473618,2016,16.6,16.12,18,14,134,50,34,218,45,13,9,121,97,97,33
8473673,2016,4.8,4.43,8,8,115,46,87,248,17,1,7,114,0,35,28
8473914,2016,14.99,14.45,12,7,120,44,57,221,35,16,14,104,438,71,24
8473933,2016,3.31,3.21,4,2,84,29,37,150,7,1,1,83,0,82,18
8473962,2016,0.51,0.5,1,1,10,3,7,20,2,0,1,10,3,7,2
8473986,2016,18.23,17.79,11,6,177,66,54,297,36,19,12,158,4,99,33
8473989,2016,0.61,0.61,0,0,3,1,1,5,0,0,0,3,0,16,1
8473991,2016,2.96,2.98,5,5,80,39,41,160,13,3,2,77,0,105,17
8473992,2016,1.43,1.4,2,6,33,25,28,86,8,0,5,33,0,101,7
8473994,2016,23.29,21.82,26,17,201,77,81,359,69,26,19,175,212,89,55
8474000,2016,0.26,0.25,1,0,10,5,8,23,2,1,0,9,0,24,2
8474008,2016,0.59,0.58,0,0,8,2,6,16,0,0,0,8,0,5,5
8474009,2016,16.61,16.06,12,7,142,38,46,226,37,18,12,124,582,60,41
8474013,2016,4.1,4.02,11,10,89,68,63,220,26,5,11,84,0,164,32
8474018,2016,0.39,0.39,0,0,5,1,1,7,0,0,1,5,2,2,0
8474027,2016,2.87,2.81,4,5,92,58,82,232,13,4,7,88,0,135,40
8474031,2016,8.58,8.36,20,21,157,54,100,311,54,13,9,144,0,86,36
8474034,2016,26.06,25.02,9,6,175,64,57,296,42,27,14,148,5,188,33
8474037,2016,27.84,26.96,17,16,238,79,74,391,62,29,14,209,1,62,37
8474038,2016,14.6,14.34,15,6,96,28,34,158,43,22,11,74,10,119,40
8474040,2016,15.72,14.92,21,11,179,62,65,306,50,18,12,161,202,22,17
8474052,2016,1.79,1.86,1,1,15,5,4,24,4,2,2,13,1,10,5
8474053,2016,19.78,19.45,20,6,172,68,83,323,51,25,16,147,291,56,37
8474056,2016,6.48,6.1,13,17,142,54,98,294,40,10,9,132,0,78,30
8474062,2016,13.76,13.13,8,2,125,46,42,213,17,7,12,118,276,67,48
8474066,2016,4.14,4.1,5,11,87,43,69,199,20,4,9,83,0,89,16
8474068,2016,17.55,17.27,21,7,185,63,102,350,55,27,12,158,650,21,25
8474074,2016,2.13,2.08,7,6,50,18,51,119,14,1,3,49,0,36,10
8474090,2016,3.43,3.39,6,0,62,32,49,143,9,3,6,59,0,59,11
8474091,2016,16,15.16,7,10,160,67,45,272,34,17,12,143,788,78,32
8474098,2016,14.01,13.59,9,6,167,48,43,258,24,9,12,158,28,104,40
8474100,2016,10.17,9.92,4,3,110,39,27,176,16,9,6,101,4,120,15
8474102,2016,15.67,15.46,16,12,151,64,45,260,46,18,9,133,32,87,48
8474125,2016,1.07,1.06,3,3,32,16,24,72,6,0,2,32,0,42,2
8474130,2016,0,0,0,0,0,0,0,0,0,0,0,0,0,2,0
8474134,2016,2.21,2.15,5,2,72,24,56,152,8,1,7,71,0,72,9
8474141,2016,25.18,24.87,36,19,292,90,109,491,89,34,12,258,7,28,49
8474145,2016,1.86,1.85,2,1,45,20,22,87,4,1,4,44,0,77,4
8474150,2016,21.66,21.32,21,10,197,75,66,338,53,22,8,175,711,55,57
8474151,2016,8.49,8.06,22,14,150,67,100,317,42,6,16,144,0,78,45
8474157,2016,28.29,27.12,18,14,268,117,115,500,67,35,27,233,27,63,44
8474161,2016,23.99,22.95,26,15,253,93,134,480,61,20,20,233,3,30,24
8474162,2016,8.46,7.87,9,10,184,75,129,388,28,9,9,175,0,162,15
8474166,2016,8.55,7.95,13,17,144,80,109,333,39,9,19,135,0,137,5
8474176,2016,10.83,10.81,8,8,128,43,29,200,22,6,9,122,3,66,19
8474189,2016,12.56,12.49,6,7,113,53,56,222,25,12,8,101,414,71,31
8474190,2016,36.84,33.89,13,10,224,94,79,397,54,31,21,193,8,162,38
8474207,2016,5.48,5.36,9,14,81,61,79,221,34,11,2,70,0,160,23
8474218,2016,6.29,5.89,9,10,96,54,46,196,28,9,9,87,0,105,19
8474230,2016,5.04,4.79,7,3,38,26,22,86,12,2,7,36,66,129,18
8474250,2016,15.44,15.07,8,8,137,56,52,245,32,16,13,121,317,140,31
8474291,2016,10.68,10.59,12,4,100,33,21,154,29,13,7,87,611,54,11
8474520,2016,3.51,3.38,6,2,96,55,42,193,9,1,1,95,0,93,8
8474563,2016,9.08,8.86,16,16,181,64,120,365,44,12,18,169,1,129,24
8474564,2016,8.02,7.58,9,2,58,18,24,100,20,9,4,49,106,21,15
8474565,2016,9.24,9.07,17,17,181,59,95,335,48,14,6,167,0,38,53
8474567,2016,3.02,2.92,4,5,73,32,30,135,11,2,9,71,0,59,11
8474568,2016,2.67,2.59,2,5,94,40,78,212,8,1,8,93,0,283,10
8474569,2016,15.07,14.66,17,6,113,35,36,184,35,12,9,101,16,50,23
8474571,2016,15.05,15.1,10,6,120,53,49,222,26,10,10,110,5,70,31
8474573,2016,17.04,16.55,30,13,173,56,75,304,56,13,13,160,8,37,54
8474574,2016,0.84,0.81,0,3,16,7,17,40,5,2,1,14,0,12,6
8474577,2016,4.83,4.6,4,0,46,16,12,74,8,4,5,42,45,82,10
8474578,2016,13.29,12.76,25,29,218,119,169,506,71,17,21,201,0,67,59
8474579,2016,3.59,3.54,4,7,75,30,92,197,13,2,2,73,0,130,19
8474581,2016,6.32,6.06,14,20,127,63,136,326,43,9,4,118,0,69,44
8474584,2016,5.24,5.15,7,5,92,40,56,188,18,6,8,86,0,173,9
8474586,2016,23.05,22.36,14,16,205,87,79,371,50,20,13,185,9,25,38
8474589,2016,7.45,7.12,5,3,89,23,33,145,13,5,6,84,3,45,19
8474590,2016,10.55,10.33,18,10,179,87,92,358,37,9,12,170,0,58,49
8474597,2016,0.62,0.58,2,2,29,6,18,53,4,0,3,29,0,30,5
8474600,2016,9.74,9.49,20,17,218,68,124,410,49,12,14,206,0,54,16
8474602,2016,7.88,7.76,15,24,155,45,94,294,51,12,10,143,0,67,22
8474604,2016,0.03,0.02,0,0,0,1,0,1,0,0,0,0,0,2,0
8474605,2016,2.47,2.37,3,5,62,23,51,136,12,4,3,58,0,52,6
8474610,2016,0.77,0.78,0,2,8,3,3,14,3,1,1,7,27,5,3
8474611,2016,0.38,0.36,3,0,8,6,3,17,4,1,3,7,0,23,2
8474612,2016,2.45,2.4,6,5,74,35,48,157,14,3,4,71,0,58,14
8474613,2016,15.56,15.11,23,14,207,55,70,332,54,17,13,190,711,26,50
8474618,2016,3.41,3.34,4,5,88,35,77,200,13,4,10,84,0,50,28
8474625,2016,6.41,6.16,2,1,74,24,36,134,5,2,8,72,14,74,14
8474627,2016,7.64,7.54,7,8,67,8,25,100,22,7,1,60,409,64,21
8474628,2016,2.65,2.54,6,6,81,45,59,185,15,3,5,78,1,124,5
8474641,2016,17.81,17.28,13,7,142,48,53,243,40,20,11,122,585,88,45
8474642,2016,5.75,5.66,1,3,53,25,16,94,7,3,1,50,4,127,17
8474660,2016,0.43,0.42,1,0,14,9,8,31,1,0,0,14,0,3,2
8474668,2016,9.56,8.83,4,3,94,28,22,144,15,8,4,86,3,135,13
8474673,2016,5.37,5.29,14,16,78,53,77,208,36,6,7,72,0,30,57
8474679,2016,17.92,17.26,22,14,165,63,64,292,48,12,14,153,4,54,32
8474683,2016,4.24,4.16,2,2,40,19,7,66,4,0,1,40,201,27,10
8474685,2016,12.27,12.03,2,3,92,34,28,154,15,10,5,82,2,61,23
8474688,2016,1.41,1.39,1,7,42,23,25,90,9,1,0,41,0,69,4
8474697,2016,1.88,1.83,2,0,50,24,41,115,3,1,3,49,1,364,6
8474707,2016,1.88,1.81,4,1,32,17,38,87,6,1,2,31,0,12,4
8474709,2016,7.22,7.08,2,2,66,30,17,113,9,5,5,61,0,300,16
8474715,2016,27.21,26.15,18,9,240,63,97,400,62,35,21,205,2,33,36
8474716,2016,8.13,7.74,16,12,144,55,73,272,38,10,13,134,0,49,23
8474717,2016,5.12,4.92,6,5,80,49,69,198,13,2,4,78,0,20,16
8474722,2016,1.98,1.84,0,4,24,7,11,42,4,0,4,24,0,81,3
8474727,2016,4.1,3.94,1,1,30,14,12,56,4,2,1,28,241,29,9
8474739,2016,6.96,6.83,4,1,80,20,15,115,12,7,8,73,111,125,12
8474743,2016,0.39,0.38,1,4,12,7,16,35,5,0,0,12,0,25,5
8474749,2016,0.65,0.62,0,1,16,12,21,49,2,1,0,15,0,46,3
8474774,2016,0.33,0.33,2,4,13,8,15,36,6,0,0,13,0,44,3
8474818,2016,3.4,3.28,7,6,68,48,64,180,17,4,5,64,0,64,14
8474849,2016,10.35,10.08,11,4,82,39,41,162,27,12,7,70,7,69,16
8474870,2016,15.67,15.01,12,14,130,65,55,250,45,19,8,111,583,46,26
8474873,2016,0.06,0.06,0,0,1,1,3,5,0,0,0,1,0,8,0
8474884,2016,19.7,19.21,24,11,224,88,103,415,61,26,18,198,12,41,45
8475098,2016,18.51,17.73,24,13,145,54,39,238,55,18,11,127,774,45,52
8475147,2016,2.97,2.95,4,3,37,12,6,55,13,6,1,31,19,29,11
8475149,2016,16.99,16.85,18,15,127,34,54,215,57,24,7,103,13,32,39
8475151,2016,22.12,20,13,14,192,84,96,372,53,26,15,166,12,124,29
8475155,2016,0.02,0.02,0,0,1,1,0,2,0,0,1,1,0,1,0
8475158,2016,19.61,18.86,21,14,190,56,53,299,55,20,11,170,1047,21,60
8475160,2016,11.33,10.91,6,0,122,44,33,199,12,6,13,116,2,146,17
8475163,2016,9.42,9.19,5,7,104,27,34,165,24,12,6,92,7,74,32
8475164,2016,23.08,22.19,15,11,227,76,80,383,49,23,19,204,1,47,46
8475165,2016,0.77,0.77,1,2,12,5,4,21,4,1,0,11,79,28,8
8475166,2016,34.22,33.13,21,17,260,101,110,471,66,28,17,232,824,42,63
8475167,2016,11.49,11,34,22,166,104,138,408,72,16,12,150,0,93,39
8475168,2016,19.74,18.87,14,9,159,67,47,273,41,18,15,141,677,40,60
8475169,2016,20.48,19.76,8,7,260,81,99,440,43,28,14,232,55,109,34
8475170,2016,29.25,27.59,17,13,178,83,56,317,55,25,25,153,232,189,18
8475171,2016,13,11.69,9,17,140,78,103,321,38,12,9,128,0,110,16
8475172,2016,33.18,31.35,15,14,236,100,94,430,61,32,14,204,544,124,58
8475175,2016,5.55,5.33,3,2,51,12,18,81,13,8,2,43,1,29,11
8475176,2016,7.98,7.8,13,9,140,57,84,281,38,16,6,124,0,64,37
8475177,2016,4.85,4.81,11,9,116,58,78,252,25,5,6,111,0,139,24
8475178,2016,10.42,10.18,8,9,110,26,26,162,24,7,10,103,4,199,21
8475179,2016,1.88,1.68,1,2,42,27,45,114,5,2,3,40,0,60,18
8475180,2016,7.48,7.3,3,4,74,29,19,122,11,4,8,70,221,37,19
8475181,2016,7.61,7.39,17,18,137,70,81,288,46,11,10,126,0,77,26
8475184,2016,24.19,22.77,18,7,184,83,47,314,52,27,19,157,4,132,17
8475185,2016,4.93,4.72,3,6,44,28,12,84,10,1,4,43,162,31,7
8475186,2016,5.66,5.21,4,6,102,54,73,229,22,12,3,90,0,68,7
8475188,2016,2.57,2.39,0,2,47,27,51,125,4,2,3,45,0,110,10
8475191,2016,18.91,18.11,9,13,158,50,74,282,37,15,16,143,3,75,49
8475192,2016,0.29,0.28,0,0,5,0,6,11,0,0,0,5,0,5,1
8475193,2016,20.68,19.91,12,9,166,76,79,321,46,25,9,141,8,92,34
8475197,2016,10.97,10.66,20,11,182,97,130,409,38,7,14,175,0,32,22
8475199,2016,0.72,0.7,0,1,28,14,18,60,1,0,2,28,0,32,3
8475200,2016,5.64,5.52,18,8,125,42,80,247,32,6,12,119,0,121,34
8475204,2016,9.65,9.24,6,4,96,50,55,201,18,8,8,88,137,39,22
8475208,2016,3.56,3.53,7,7,78,26,78,182,15,1,7,77,0,113,25
8475209,2016,18.32,17.55,12,10,155,51,64,270,44,22,15,133,2,147,30
8475210,2016,0.17,0.17,0,1,2,1,2,5,1,0,0,2,0,0,2
8475213,2016,0.98,0.93,2,0,11,5,2,18,2,0,0,11,38,22,4
8475218,2016,7.49,7.25,6,14,120,68,96,284,23,3,10,117,0,61,38
8475220,2016,11.77,11.64,4,6,97,42,36,175,23,13,4,84,1,279,33
8475222,2016,6.5,6.31,9,12,117,53,82,252,24,3,11,114,0,75,15
8475223,2016,0.58,0.44,0,0,1,2,2,5,0,0,0,1,9,1,0
8475225,2016,17.99,17.89,13,4,155,81,81,317,29,12,11,143,51,93,34
8475227,2016,5.69,5.56,8,4,123,37,89,249,17,5,7,118,0,68,14
8475231,2016,11.08,10.66,13,4,82,20,25,127,25,8,11,74,420,144,36
8475233,2016,6.82,6.28,8,9,135,65,64,264,23,6,6,129,0,127,22
8475235,2016,2.47,2.42,2,0,26,11,9,46,2,0,1,26,0,109,2
8475236,2016,10.75,10.32,7,2,82,48,38,168,12,3,7,79,524,65,24
8475246,2016,0.59,0.59,1,0,21,14,16,51,1,0,1,21,0,48,4
8475250,2016,2.59,2.46,3,1,27,6,6,39,5,1,1,26,3,10,11
8475254,2016,4.45,4.27,2,0,34,14,18,66,4,2,5,32,133,83,6
8475263,2016,0.54,0.53,0,0,6,1,0,7,1,1,0,5,13,2,0
8475268,2016,1.3,1.3,0,0,6,2,3,11,1,1,1,5,0,18,1
8475274,2016,0.19,0.18,0,0,3,5,3,11,1,1,0,2,0,16,0
8475278,2016,0.33,0.35,0,0,6,1,2,9,0,0,1,6,26,3,3
8475279,2016,1.86,1.78,4,6,49,11,42,102,12,2,0,47,0,78,13
8475287,2016,11.29,11.15,7,4,134,40,36,210,26,15,12,119,404,39,24
8475291,2016,0,0,0,0,0,0,0,0,0,0,0,0,0,2,0
8475296,2016,0.28,0.27,0,0,2,1,3,6,0,0,0,2,0,3,1
8475310,2016,7.99,7.9,5,5,66,28,22,116,16,6,6,60,3,103,12
8475314,2016,25.25,24.55,11,7,191,60,37,288,52,34,14,157,7,172,22
8475321,2016,0.24,0.24,0,0,1,3,1,5,0,0,0,1,15,3,3
8475323,2016,8.14,7.71,4,8,83,22,20,125,17,5,5,78,357,31,24
8475324,2016,2.56,2.46,5,4,59,23,39,121,13,4,6,55,0,55,10
8475325,2016,3.83,3.76,2,2,39,29,21,89,8,4,3,35,2,62,5
8475343,2016,10.28,9.78,10,6,78,35,31,144,22,6,7,72,338,145,19
8475413,2016,1.22,1.24,1,1,11,3,7,21,2,0,0,11,38,1,3
8475430,2016,3.78,3.7,4,5,84,32,76,192,12,3,4,81,0,121,9
8475436,2016,0,0,0,0,0,0,0,0,0,0,0,0,0,1,0
8475455,2016,3.04,2.95,1,7,86,40,74,200,10,2,6,84,0,173,11
8475462,2016,4.72,4.61,10,7,113,68,118,299,23,6,9,107,0,280,18
8475597,2016,1.49,1.44,1,0,13,5,5,23,3,2,1,11,0,19,4
8475613,2016,0.72,0.74,2,3,20,19,13,52,7,2,3,18,0,30,3
8475625,2016,3.27,3.13,4,7,98,43,76,217,14,3,7,95,0,115,18
8475690,2016,1.48,1.45,3,5,39,24,29,92,10,2,4,37,0,19,15
8475692,2016,15.77,15.32,22,21,187,61,75,323,58,15,7,172,6,82,68
8475714,2016,13.6,13.24,7,9,134,46,53,233,31,15,7,119,452,49,23
8475715,2016,6.29,6.26,6,6,86,29,35,150,20,8,3,78,299,94,10
8475716,2016,0.87,0.88,2,4,22,17,28,67,7,1,2,21,0,25,7
8475722,2016,17.64,17.4,16,9,172,73,47,292,47,22,9,150,1,73,44
8475726,2016,18.05,17.12,9,9,165,75,82,322,34,16,8,149,2,54,19
8475727,2016,14.18,13.72,14,14,145,36,42,223,39,11,11,134,79,24,36
8475728,2016,6.29,6.03,2,3,49,24,20,93,11,6,5,43,261,33,13
8475730,2016,3.21,3.12,2,4,91,47,63,201,10,4,4,87,0,159,20
8475735,2016,2.49,2.48,3,1,35,10,8,53,7,3,2,32,86,44,7
8475738,2016,5.75,5.38,2,2,49,13,11,73,12,8,7,41,14,7,14
8475739,2016,2.53,2.51,0,1,25,14,7,46,3,2,2,23,1,31,6
8475744,2016,19.35,19.24,23,17,167,67,84,318,59,19,10,148,456,57,43
8475745,2016,19.01,18.57,26,12,159,57,49,265,56,18,19,141,114,101,30
8475747,2016,2.29,2.19,2,1,46,15,30,91,3,0,6,46,0,45,10
8475750,2016,1.65,1.55,1,4,48,24,25,97,6,1,1,47,0,39,16
8475752,2016,4.15,4.07,2,1,52,9,12,73,11,8,2,44,8,67,2
8475753,2016,12.7,12.35,11,9,225,93,140,458,37,17,20,208,0,117,53
8475754,2016,16.45,16.3,14,11,173,42,90,305,45,20,12,153,346,50,43
8475755,2016,2.48,2.44,5,8,55,28,27,110,14,1,2,54,0,106,16
8475758,2016,8.03,7.77,2,3,76,24,11,111,9,4,2,72,29,94,17
8475760,2016,11.1,10.06,3,4,91,31,32,154,14,7,8,84,186,72,21
8475761,2016,9.28,8.73,7,4,101,46,38,185,19,8,1,93,3,77,19
8475762,2016,2.84,2.77,6,10,100,42,70,212,18,2,5,98,1,180,9
8475763,2016,13.46,13.48,18,14,141,41,61,243,49,17,9,124,439,40,53
8475764,2016,8.74,8.47,12,16,186,62,124,372,39,11,19,175,0,29,30
8475765,2016,26.7,25.86,18,18,286,112,128,526,75,39,14,247,5,50,29
8475766,2016,8.07,7.91,9,3,90,25,39,154,17,5,6,85,17,143,24
8475768,2016,22.28,21.53,24,12,179,62,62,303,55,19,13,160,67,71,59
8475769,2016,0.53,0.52,0,0,5,0,1,6,0,0,0,5,0,4,1
8475770,2016,0,0,0,0,0,0,0,0,0,0,0,0,0,4,0
8475772,2016,10.95,10.16,5,6,109,50,38,197,13,2,9,107,236,81,20
8475774,2016,0.1,0.1,0,0,4,1,1,6,0,0,0,4,0,17,0
8475780,2016,4.94,4.68,1,0,40,19,10,69,7,6,3,34,62,112,4
8475784,2016,33.79,32.3,19,7,281,98,111,490,63,37,25,244,10,33,65
8475786,2016,17.37,16.89,12,6,156,49,27,232,28,10,21,146,11,109,42
8475788,2016,4.68,4.5,8,3,45,19,25,89,16,5,2,40,178,60,12
8475790,2016,1.51,1.48,5,0,40,15,33,88,6,1,4,39,0,66,4
8475791,2016,26.77,26.01,22,11,238,64,90,392,53,20,13,218,8,59,43
8475792,2016,8,8.07,7,1,80,17,32,129,23,15,7,65,4,88,16
8475793,2016,18.13,17.72,28,19,154,65,57,276,61,14,15,140,803,77,38
8475794,2016,29.21,27.94,27,19,302,101,105,508,72,26,24,276,401,60,37
8475795,2016,0.07,0.07,0,0,3,3,5,11,1,1,0,2,0,15,1
8475796,2016,3.76,3.68,3,10,83,38,48,169,17,4,4,79,0,70,31
8475798,2016,22.8,21.8,31,12,177,67,74,318,69,26,13,151,16,50,43
8475799,2016,18.94,18.39,25,7,186,47,62,295,57,25,18,161,0,120,32
8475800,2016,1.02,1.02,0,0,10,5,5,20,2,2,1,8,0,4,2
8475807,2016,11,10.43,2,3,104,41,40,185,12,7,7,97,9,148,27
8475808,2016,6.78,6.54,2,3,64,16,33,113,9,4,3,60,203,68,13
8475810,2016,12.56,12.18,9,4,110,35,43,188,28,15,9,95,2,101,18
8475815,2016,0.36,0.36,1,1,15,8,10,33,2,0,0,15,0,30,4
8475820,2016,11.9,11.5,5,6,95,40,34,169,17,6,13,89,8,27,30
8475832,2016,6.25,6.27,7,5,49,25,25,99,16,4,4,45,2,112,6
8475834,2016,2.11,2.03,1,2,27,5,11,43,4,1,2,26,3,15,9
8475841,2016,0.01,0.01,0,0,1,0,3,4,0,0,0,1,0,0,1
8475844,2016,1.05,1.1,2,0,17,7,2,26,3,1,2,16,0,9,1
8475848,2016,19.01,18.24,11,8,187,55,84,326,29,10,22,177,30,69,33
8475855,2016,7.36,7.19,10,5,55,25,20,100,21,6,4,49,17,98,28
8475857,2016,2,1.95,3,3,52,32,32,116,7,1,1,51,0,73,2
8475868,2016,0.6,0.59,3,4,17,12,16,45,7,0,1,17,0,43,1
8475869,2016,1.27,1.24,2,1,42,16,32,90,3,0,0,42,0,42,7
8475878,2016,2.8,2.79,0,0,30,10,11,51,2,2,3,28,75,46,3
8475906,2016,9.26,8.82,21,15,124,70,119,313,49,13,11,111,1,42,40
8475907,2016,11.75,11.64,6,4,106,39,27,172,25,15,7,91,3,149,36
8475913,2016,19.06,18.4,17,15,134,54,41,229,54,22,7,112,10,43,96
8475949,2016,2.1,2,1,1,15,9,4,28,2,0,0,15,32,19,5
8475958,2016,3.5,3.44,5,2,33,12,10,55,9,2,5,31,138,39,6
8475982,2016,0.04,0.03,0,0,2,1,0,3,0,0,0,2,0,5,0
8476043,2016,0.82,0.73,1,0,8,3,0,11,1,0,1,8,0,3,0
8476116,2016,1.55,1.51,0,1,22,16,12,50,3,2,0,20,6,50,3
8476158,2016,1.52,1.46,2,0,19,2,11,32,4,2,1,17,8,25,7
8476162,2016,0.39,0.39,0,1,11,7,9,27,1,0,1,11,0,20,1
8476166,2016,0.84,0.8,3,4,24,8,13,45,7,0,2,24,0,7,5
8476177,2016,9.91,9.68,7,2,92,32,37,161,19,10,2,82,5,95,21
8476191,2016,2.08,2.05,4,6,49,24,34,107,13,3,3,46,0,118,7
8476195,2016,2.41,2.33,3,0,16,7,3,26,4,1,1,15,1,1,6
8476200,2016,1.09,1.07,1,2,19,6,5,30,3,0,1,19,0,48,4
8476219,2016,0.25,0.24,0,0,2,0,1,3,0,0,0,2,11,2,1
8476279,2016,0.88,0.85,1,4,29,10,21,60,6,1,1,28,0,31,6
8476285,2016,1.16,1.1,1,0,9,8,7,24,2,1,1,8,32,9,0
8476288,2016,16.23,15.6,13,5,123,36,44,203,32,14,16,109,9,71,23
8476289,2016,1.65,1.63,1,6,36,23,21,80,8,1,1,35,0,22,5
8476292,2016,17.79,17.01,17,18,162,54,61,277,52,17,14,145,9,141,60
8476293,2016,12.94,12.89,11,7,127,45,43,215,26,8,14,119,3,167,20
8476300,2016,3.13,3.07,9,4,63,27,55,145,17,4,4,59,0,84,6
8476302,2016,0.24,0.23,0,0,3,6,2,11,0,0,0,3,0,4,0
8476303,2016,0.08,0.08,0,0,2,1,0,3,0,0,0,2,0,3,0
8476310,2016,7.57,7.51,3,3,57,29,30,116,13,7,5,50,232,66,15
8476312,2016,4.78,4.72,4,8,88,41,52,181,17,5,12,83,0,227,23
8476323,2016,0.47,0.45,0,0,7,2,5,14,0,0,0,7,15,13,2
8476326,2016,2.03,1.99,0,0,11,9,4,24,3,3,0,8,0,28,0
8476331,2016,1.69,1.63,5,2,32,14,24,70,8,1,4,31,0,36,4
8476336,2016,1.41,1.4,1,1,15,7,3,25,4,2,3,13,0,30,4
8476344,2016,6.03,5.92,1,1,48,23,13,84,9,7,4,41,163,52,16
8476346,2016,19.53,18.78,30,13,182,59,66,307,61,18,14,164,0,9,44
8476356,2016,18.25,17.39,8,9,151,67,51,269,33,16,14,135,4,24,33
8476368,2016,1.41,1.39,3,5,25,12,35,72,11,3,3,22,0,55,4
8476370,2016,0.8,0.79,1,0,9,3,6,18,1,0,0,9,23,16,4
8476374,2016,0.89,0.88,0,1,11,4,6,21,1,0,0,11,1,9,2
8476381,2016,15.44,14.95,7,10,127,40,54,221,29,12,13,115,239,147,28
8476386,2016,7.4,7.33,7,6,71,18,35,124,18,5,3,66,4,36,23
8476389,2016,25.37,24.77,15,14,229,107,85,421,52,23,16,206,822,163,63
8476390,2016,4.21,4.16,3,3,36,14,13,63,10,4,2,32,6,133,8
8476391,2016,0.22,0.21,0,0,3,2,2,7,0,0,0,3,0,1,0
8476392,2016,18.59,17.13,7,7,122,42,36,200,29,15,21,107,658,217,29
8476393,2016,10.33,9.29,5,5,99,27,38,164,16,6,6,93,89,61,15
8476399,2016,2.93,2.85,1,0,29,9,8,46,2,1,1,28,96,51,12
8476400,2016,5.16,4.99,4,3,59,18,14,91,10,3,3,56,55,62,10
8476403,2016,2.05,1.99,2,2,37,25,36,98,6,2,5,35,0,77,11
8476404,2016,4.37,4.08,2,0,38,19,24,81,2,0,2,38,41,70,5
8476406,2016,8.77,8.55,6,5,79,41,43,163,17,6,6,73,362,58,11
8476409,2016,7.33,7.23,6,7,82,17,26,125,18,5,5,77,264,77,17
8476410,2016,3.42,3.16,6,2,27,13,7,47,10,2,1,25,1,5,11
8476414,2016,0.02,0.02,0,0,1,1,2,4,0,0,0,1,2,3,0
8476415,2016,1.58,1.54,0,1,20,5,6,31,3,2,0,18,2,23,7
8476416,2016,0.05,0.05,0,0,2,1,2,5,0,0,0,2,0,3,0
8476418,2016,0.6,0.59,0,0,18,13,9,40,0,0,0,18,0,24,0
8476419,2016,19.9,19.09,10,11,169,60,29,258,33,12,16,157,558,161,25
8476422,2016,0.71,0.71,0,0,19,11,17,47,1,1,2,18,0,2,0
8476423,2016,6.29,6.06,3,1,70,21,22,113,10,6,3,64,0,20,18
8476425,2016,0.58,0.55,0,0,5,4,4,13,0,0,0,5,1,23,3
8476427,2016,0.7,0.72,2,0,10,3,2,15,2,0,0,10,0,10,4
8476428,2016,1.34,1.18,1,0,11,2,5,18,1,0,2,11,0,1,3
8476429,2016,1.65,1.55,3,4,39,16,25,80,9,2,3,37,0,37,8
8476430,2016,4.45,4.23,0,0,35,16,15,66,1,1,5,34,0,21,3
8476431,2016,1.35,1.29,2,7,38,19,31,88,11,2,4,36,0,22,7
8476432,2016,21.18,20.59,9,7,211,71,90,372,34,18,15,193,92,216,42
8476436,2016,5.62,5.34,5,5,55,28,21,104,11,1,6,54,5,98,13
8476437,2016,16.04,15.43,11,18,186,48,76,310,45,16,11,170,457,43,41
8476438,2016,23.18,22.56,18,11,210,79,81,370,53,24,11,186,4,24,43
8476439,2016,15.23,14.5,4,4,167,68,77,312,24,16,12,151,1,153,15
8476440,2016,14.81,14.32,8,5,122,52,46,220,32,19,7,103,40,32,33
8476441,2016,2.84,2.74,5,7,81,36,54,171,15,3,3,78,0,122,7
8476442,2016,8.74,7.82,3,3,83,24,19,126,13,7,6,76,2,41,28
8476443,2016,2.98,2.89,5,4,89,36,53,178,12,3,7,86,0,73,9
8476447,2016,0.25,0.23,0,0,3,2,3,8,0,0,1,3,0,14,1
8476448,2016,10.61,10.39,13,6,96,34,39,169,25,6,6,90,435,35,33
8476449,2016,0.89,0.85,0,2,16,9,10,35,3,1,0,15,0,21,4
8476450,2016,2.28,2.3,4,2,46,21,14,81,7,1,4,45,0,12,5
8476452,2016,0.15,0.15,0,0,4,1,3,8,0,0,0,4,0,3,1
8476453,2016,30.78,29.82,28,17,246,102,116,464,85,40,19,206,0,30,54
8476454,2016,21.58,21.02,14,11,197,44,79,320,43,18,13,179,551,46,48
8476455,2016,17.82,17.15,7,8,166,52,44,262,33,18,12,148,61,142,63
8476456,2016,9.71,9.42,9,7,86,25,25,136,26,10,6,76,4,18,15
8476457,2016,3.06,2.98,3,12,82,40,77,199,18,3,4,79,0,251,28
8476458,2016,10.93,10.61,10,7,114,42,47,203,30,13,6,101,147,59,33
8476459,2016,13.15,12.43,8,15,115,63,44,222,36,13,15,102,477,23,36
8476460,2016,25.96,24.7,26,24,160,57,61,278,82,32,8,128,635,49,67
8476461,2016,15.23,14.65,10,10,120,42,33,195,34,14,8,106,587,41,46
8476462,2016,9.7,9.48,17,20,222,78,123,423,50,13,19,209,0,68,17
8476463,2016,3.29,3.23,8,14,85,38,63,186,25,3,5,82,0,20,16
8476464,2016,0.09,0.09,0,0,2,1,1,4,0,0,0,2,0,10,0
8476465,2016,0.9,0.89,1,1,17,7,17,41,2,0,1,17,0,2,11
8476466,2016,13.52,13.02,8,9,114,35,36,185,35,18,11,96,1,52,39
8476467,2016,1.53,1.48,0,2,33,12,22,67,7,5,2,28,0,51,13
8476468,2016,16.53,15.67,21,13,131,56,44,231,56,22,4,109,155,96,48
8476469,2016,12.36,11.91,6,3,111,32,52,195,19,10,9,101,3,68,42
8476470,2016,4.93,4.88,14,10,118,41,76,235,28,4,3,114,0,65,16
8476471,2016,0.26,0.26,0,0,1,0,0,1,0,0,0,1,0,0,0
8476472,2016,8.59,8.27,14,11,195,82,111,388,37,12,12,183,0,41,29
8476473,2016,3.22,3.13,7,8,77,37,67,181,17,2,6,75,0,199,13
8476474,2016,6.72,6.43,1,1,63,20,9,92,10,8,5,55,26,50,11
8476476,2016,0.72,0.71,1,0,19,11,9,39,1,0,1,19,0,29,1
8476477,2016,6.26,6.05,2,1,44,19,17,80,9,6,4,38,0,28,8
8476479,2016,13.58,13.19,15,12,133,43,50,226,40,13,10,120,533,76,49
8476480,2016,17.64,17.04,9,9,115,42,40,197,28,10,8,105,209,72,14
8476482,2016,0.25,0.23,0,0,8,3,7,18,0,0,0,8,0,7,2
8476483,2016,19.88,18.91,13,5,177,83,69,329,51,33,14,144,62,81,23
8476495,2016,3.53,3.37,4,1,21,19,10,50,5,0,6,21,2,30,5
8476511,2016,0.02,0.02,0,0,1,0,0,1,1,1,0,0,0,2,0
8476525,2016,4.02,3.96,4,3,85,61,83,229,13,6,6,79,0,88,19
8476526,2016,0.92,0.8,0,0,7,1,0,8,0,0,2,7,0,7,0
8476539,2016,16.76,16.61,10,11,193,57,64,314,51,30,10,163,122,101,63
8476545,2016,0.28,0.26,0,1,3,2,1,6,1,0,0,3,0,26,0
8476619,2016,0.95,0.94,0,0,10,4,0,14,0,0,0,10,11,14,2
8476624,2016,0.19,0.2,0,1,3,1,2,6,1,0,0,3,0,3,1
8476766,2016,0.1,0.09,1,0,6,0,2,8,1,0,0,6,0,3,0
8476769,2016,0.32,0.32,0,0,4,0,0,4,0,0,0,4,1,8,0
8476779,2016,1.16,1.17,2,3,14,6,7,27,6,1,0,13,0,0,4
8476792,2016,10.81,9.89,25,18,208,89,165,462,51,8,17,200,0,59,22
8476798,2016,0.39,0.37,0,3,11,5,7,23,3,0,0,11,0,26,3
8476805,2016,0.08,0.08,0,0,1,0,1,2,0,0,0,1,0,0,1
8476806,2016,6.33,6.15,1,2,67,21,28,116,6,3,4,64,12,103,8
8476807,2016,1.41,1.38,5,1,36,14,32,82,6,0,3,36,0,65,11
8476808,2016,3.79,3.58,3,1,47,20,25,92,10,6,6,41,69,20,13
8476822,2016,9.23,9.08,9,2,76,31,15,122,14,3,3,73,307,150,19
8476826,2016,3.96,3.93,2,0,30,12,12,54,8,6,4,24,60,11,12
8476850,2016,2.83,2.8,5,4,52,19,39,110,11,2,4,50,0,23,8
8476851,2016,11.56,11.25,16,11,104,46,48,198,44,17,9,87,274,36,17
8476853,2016,10.11,9.75,14,7,171,78,103,352,27,6,6,165,0,46,34
8476854,2016,4.34,4.14,5,9,94,38,71,203,20,6,8,88,2,98,18
8476855,2016,3.33,3.37,3,3,35,18,15,68,9,3,2,32,0,32,11
8476856,2016,8.43,8.14,10,13,131,49,112,292,34,11,5,120,0,96,18
8476857,2016,0.46,0.46,0,1,12,3,9,24,2,1,0,11,1,9,5
8476858,2016,7.18,6.69,3,3,68,25,20,113,7,1,9,67,0,91,12
8476866,2016,0.08,0.08,0,0,0,1,0,1,0,0,0,0,1,0,0
8476867,2016,3.4,3.31,2,3,51,13,17,81,5,0,1,51,84,94,11
8476869,2016,4.88,4.71,13,21,125,45,57,227,39,5,9,120,0,147,16
8476871,2016,21.7,20.74,14,6,187,87,90,364,44,24,18,163,10,124,25
8476872,2016,0.63,0.6,0,0,4,0,1,5,0,0,0,4,11,3,1
8476873,2016,0,0,0,0,0,0,0,0,0,0,0,0,5,1,1
8476874,2016,1.71,1.7,4,2,66,22,41,129,7,1,0,65,0,72,11
8476875,2016,7.38,7.17,7,3,178,67,64,309,17,7,10,171,1,68,46
8476877,2016,0.16,0.16,1,1,5,2,2,9,2,0,0,5,0,4,1
8476878,2016,10.49,10.23,8,1,112,35,42,189,16,7,2,105,273,120,17
8476879,2016,5.98,5.74,6,9,143,54,90,287,17,2,6,141,1,111,22
8476880,2016,9.43,9.44,4,8,95,23,48,166,19,7,5,88,3,234,36
8476881,2016,12.7,12.45,7,5,100,39,44,183,22,10,11,90,245,76,30
8476882,2016,17.59,16.85,12,15,169,68,61,298,42,15,7,154,193,27,51
8476884,2016,0.29,0.29,0,0,11,4,5,20,0,0,0,11,0,14,3
8476885,2016,9.06,8.77,10,15,154,64,105,323,33,8,16,146,0,107,36
8476886,2016,1.04,1.03,2,2,27,13,28,68,4,0,3,27,0,25,1
8476887,2016,26.15,24.78,17,10,234,127,105,466,58,31,16,203,5,97,76
8476888,2016,7.81,7.55,8,5,84,25,36,145,22,9,6,75,111,26,33
8476889,2016,16.53,16,13,8,132,71,46,249,33,12,17,120,590,101,43
8476891,2016,0.08,0.08,0,0,4,1,3,8,0,0,0,4,0,0,0
8476892,2016,6.71,6.55,17,14,188,65,131,384,35,4,17,184,0,80,38
8476897,2016,0.6,0.59,0,0,9,0,1,10,0,0,0,9,16,13,1
8476902,2016,4.89,4.62,5,7,99,52,72,223,18,6,8,93,0,93,34
8476905,2016,0.29,0.3,0,0,3,0,1,4,0,0,0,3,12,0,1
8476906,2016,12.68,11.75,17,15,198,105,142,445,39,7,21,191,0,43,18
8476911,2016,0.05,0.05,0,0,1,1,1,3,0,0,0,1,13,6,2
8476913,2016,17.25,16.07,13,7,115,56,42,213,33,13,18,102,221,44,26
8476915,2016,1.13,1.08,0,0,10,5,3,18,1,1,1,9,7,20,1
8476917,2016,1.23,1.26,1,6,40,17,32,89,10,3,2,37,0,73,17
8476918,2016,16.3,15.89,7,3,113,49,49,211,26,16,9,97,2,63,43
8476919,2016,10.93,10.72,8,4,89,25,34,148,23,11,7,78,394,48,40
8476921,2016,12.82,12.02,10,4,107,50,38,195,25,11,15,96,444,49,39
8476922,2016,0.09,0.1,0,0,0,1,0,1,0,0,0,0,3,0,0
8476923,2016,6.4,6.15,13,15,125,58,95,278,31,3,9,122,0,79,24
8476924,2016,0.04,0.04,0,0,1,1,1,3,0,0,0,1,0,3,0
8476925,2016,7.27,7.1,2,0,42,14,17,73,10,8,3,34,192,104,12
8476931,2016,4.6,4.48,10,7,79,40,57,176,20,3,6,76,0,73,29
8476934,2016,9.41,9,6,3,74,27,41,142,16,7,7,67,1,91,29
8476941,2016,4.69,4.51,4,2,89,51,75,215,8,2,6,87,0,66,14
8476948,2016,0.18,0.18,1,1,3,0,0,3,2,0,0,3,0,11,3
8476955,2016,0.7,0.69,0,1,7,3,4,14,2,1,0,6,0,7,2
8476958,2016,3.88,3.73,14,15,99,57,75,231,34,5,5,94,0,35,83
8476960,2016,12.08,11.72,5,6,120,61,55,236,29,18,6,102,37,30,17
8476966,2016,2.02,1.97,1,2,19,8,5,32,6,3,3,16,25,6,4
8476967,2016,0.57,0.57,2,1,19,11,23,53,3,0,2,19,0,14,4
8476975,2016,8.34,7.74,3,3,68,31,33,132,10,4,5,64,200,144,17
8476981,2016,13.08,12.78,8,4,119,41,33,193,29,17,6,102,8,147,25
8476982,2016,0.31,0.31,0,0,5,1,0,6,1,1,0,4,15,1,2
8476983,2016,0.86,0.81,2,6,27,7,21,55,8,0,2,27,0,17,3
8476988,2016,2.48,2.37,6,6,67,29,54,150,15,3,4,64,0,105,7
8476989,2016,0.24,0.23,0,0,10,2,7,19,0,0,0,10,0,10,1
8476994,2016,7.97,7.77,4,4,76,24,32,132,14,6,7,70,68,31,27
8477003,2016,0.07,0.07,0,0,2,0,1,3,0,0,0,2,0,1,0
8477006,2016,0.34,0.33,0,1,5,0,0,5,1,0,1,5,0,7,0
8477009,2016,1.87,1.78,3,8,50,27,36,113,11,0,2,50,0,85,4
8477010,2016,2.94,2.84,4,2,24,15,11,50,9,3,3,21,76,37,7
8477015,2016,17.7,17.49,10,6,139,59,51,249,36,20,5,119,2,50,40
8477018,2016,5.08,4.83,6,8,130,45,93,268,19,5,4,125,0,46,31
8477034,2016,0,0,0,0,0,0,1,1,0,0,0,0,0,0,0
8477041,2016,0.12,0.12,0,0,8,1,1,10,0,0,1,8,0,6,1
8477070,2016,0,0,0,0,0,0,0,0,0,0,0,0,0,1,0
8477091,2016,0.02,0.02,0,0,1,0,0,1,0,0,0,1,0,0,0
8477126,2016,7.22,7.05,3,1,72,16,19,107,8,4,4,68,2,87,20
8477205,2016,3.67,3.61,5,6,93,26,45,164,14,3,7,90,0,45,18
8477210,2016,0.43,0.44,0,0,4,1,0,5,0,0,1,4,0,9,1
8477213,2016,10.16,9.76,6,1,89,41,27,157,14,7,3,82,28,73,19
8477215,2016,3.24,3.1,6,2,85,40,52,177,12,4,5,81,0,100,16
8477220,2016,3.45,3.44,6,8,60,32,47,139,17,3,4,57,0,51,36
8477240,2016,2.96,2.97,3,1,24,7,9,40,7,3,4,21,95,64,11
8477244,2016,1.45,1.44,6,2,45,18,34,97,10,2,2,43,0,36,9
8477290,2016,8.9,8.65,2,1,63,26,23,112,11,8,3,55,3,91,13
8477320,2016,2.93,2.68,1,0,26,11,10,47,2,1,2,25,0,41,4
8477326,2016,2.02,1.73,0,3,12,8,5,25,3,0,0,12,2,17,5
8477346,2016,0.18,0.17,0,0,3,2,0,5,0,0,0,3,0,4,1
8477353,2016,4,3.91,3,0,46,13,15,74,7,4,3,42,4,27,13
8477380,2016,1.51,1.32,1,1,17,6,7,30,2,0,2,17,0,10,2
8477391,2016,0.12,0.12,0,0,1,0,1,2,0,0,0,1,5,0,0
8477392,2016,0.84,0.79,1,0,6,3,4,13,1,0,2,6,0,17,1
8477401,2016,2.31,2.25,3,0,22,5,6,33,4,1,2,21,0,44,5
8477402,2016,6.6,6.35,6,6,55,27,28,110,20,8,5,47,1,17,11
8477404,2016,10.74,10.5,14,3,81,27,28,136,33,16,9,65,8,61,16
8477407,2016,8.56,7.98,5,4,74,30,38,142,14,5,8,69,4,21,29
8477413,2016,6.53,6.14,9,8,68,23,39,130,24,7,8,61,7,40,19
8477415,2016,3.47,3.43,3,3,55,16,39,110,10,4,2,51,2,64,19
8477416,2016,6.58,6.15,4,3,55,11,24,90,13,6,8,49,1,14,8
8477417,2016,1.51,1.49,1,1,8,6,1,15,2,0,0,8,2,7,8
8477425,2016,12.81,12.56,5,4,105,42,20,167,17,8,5,97,1,68,16
8477426,2016,0.42,0.4,0,0,4,2,0,6,0,0,0,4,5,3,1
8477429,2016,8.26,8.25,6,2,77,26,23,126,17,9,3,68,95,87,20
8477433,2016,0.06,0.06,0,0,3,1,7,11,0,0,0,3,0,5,2
8477444,2016,11.18,11.24,9,14,110,34,75,219,35,12,3,98,2,31,32
8477445,2016,0.53,0.51,0,1,5,2,4,11,1,0,1,5,0,3,2
8477446,2016,2.95,2.81,3,1,31,14,11,56,5,1,2,30,76,75,7
8477447,2016,3.75,3.37,6,1,60,29,37,126,9,2,7,58,0,14,4
8477448,2016,5.79,5.69,3,4,44,22,11,77,11,4,4,40,1,83,18
8477450,2016,1.28,1.23,0,0,9,5,5,19,2,2,1,7,4,8,3
8477451,2016,15.88,15.45,8,4,170,44,47,261,31,19,13,151,25,121,36
8477452,2016,0,0,0,1,0,0,1,1,1,0,0,0,0,3,0
8477454,2016,3.84,3.61,0,0,40,18,7,65,3,3,3,37,0,71,2
8477455,2016,0.5,0.5,0,0,4,4,1,9,0,0,0,4,17,23,4
8477456,2016,3.14,2.94,1,1,30,13,16,59,5,3,2,27,78,11,6
8477458,2016,0.92,0.81,0,0,3,1,0,4,1,1,1,2,0,0,0
8477460,2016,2.77,2.66,1,0,28,4,4,36,3,2,1,26,37,28,9
8477461,2016,2.48,2.39,2,4,15,8,17,40,7,1,1,14,1,30,12
8477462,2016,0.28,0.26,0,0,5,1,3,9,0,0,0,5,0,4,0
8477463,2016,1.72,1.66,2,3,46,16,13,75,7,2,1,44,0,83,1
8477464,2016,6.07,5.88,8,4,57,27,24,108,13,1,3,56,145,12,16
8477466,2016,0.31,0.32,0,1,7,1,1,9,1,0,0,7,1,2,0
8477467,2016,0.33,0.3,0,3,7,6,8,21,3,0,0,7,0,10,3
8477473,2016,2.32,2.31,1,1,36,13,26,75,4,2,3,34,0,27,8
8477476,2016,16.3,15.79,3,7,158,50,71,279,28,18,16,140,2,72,25
8477478,2016,4.35,4.13,1,2,50,15,7,72,8,5,1,45,1,112,8
8477479,2016,0.4,0.4,0,0,3,4,1,8,0,0,0,3,1,12,1
8477482,2016,4.28,4.2,1,3,36,17,20,73,8,4,3,32,17,22,14
8477488,2016,4.24,4.08,7,11,109,55,104,268,20,2,13,107,0,57,55
8477491,2016,1.48,1.45,0,1,17,4,0,21,4,3,1,14,1,12,1
8477492,2016,23.82,22.68,24,12,244,80,102,426,52,16,24,228,764,56,47
8477493,2016,15.72,15.19,21,9,141,45,34,220,51,21,14,120,462,39,49
8477494,2016,17.45,17.02,17,15,183,63,77,323,53,21,9,162,96,50,45
8477495,2016,7.48,7.36,13,17,152,60,85,297,42,12,6,140,0,61,32
8477496,2016,19.53,18.62,29,5,151,69,52,272,45,11,17,140,353,99,57
8477497,2016,26.81,25.44,15,16,199,67,82,348,58,27,15,172,743,34,50
8477498,2016,3,2.85,2,4,85,24,34,143,11,5,3,80,0,106,11
8477499,2016,8.13,7.76,17,22,186,61,112,359,45,6,17,180,0,195,25
8477500,2016,23.3,22.2,22,10,158,78,50,286,52,20,11,138,756,65,37
8477502,2016,0.1,0.11,0,0,2,1,1,4,0,0,0,2,0,7,1
8477503,2016,11.29,10.6,19,10,104,41,60,205,37,8,6,96,5,28,27
8477504,2016,4.34,4.23,9,5,99,36,83,218,20,6,8,93,0,145,15
8477505,2016,11.21,10.82,27,19,109,26,51,186,59,13,10,96,609,58,44
8477506,2016,0,0,0,0,0,0,1,1,0,0,0,0,0,1,0
8477507,2016,2.95,2.87,7,3,59,41,53,153,10,0,4,59,0,148,11
8477508,2016,2.13,2.12,1,2,26,9,12,47,4,1,2,25,39,66,7
8477509,2016,0.04,0.04,0,1,3,0,4,7,2,1,0,2,0,2,2
8477511,2016,14.3,13.93,6,13,133,52,31,216,36,17,9,116,5,46,26
8477512,2016,1.57,1.54,0,1,15,5,5,25,3,2,0,13,120,17,5
8477520,2016,0.05,0.04,0,0,1,1,1,3,0,0,0,1,1,3,0
8477566,2016,0.09,0.09,1,0,2,0,1,3,1,0,0,2,0,0,0
8477591,2016,3.88,3.8,3,5,72,18,22,112,12,4,2,68,214,48,9
8477715,2016,0.36,0.36,1,0,3,3,3,9,1,0,1,3,14,3,0
8477810,2016,0.1,0.1,0,0,5,0,0,5,0,0,0,5,0,8,1
8477816,2016,0,0,0,0,0,1,0,1,0,0,0,0,0,0,0
8477839,2016,18.09,17.49,12,18,156,42,48,246,53,23,15,133,0,29,26
8477845,2016,4.14,3.99,5,6,73,30,58,161,16,5,4,68,0,22,22
8477846,2016,1.64,1.6,1,0,18,2,1,21,3,2,3,16,33,14,1
8477850,2016,1.04,1.01,2,4,39,18,37,94,8,2,5,37,0,69,9
8477851,2016,0.04,0.03,0,0,2,1,6,9,0,0,0,2,0,2,2
8477881,2016,0.69,0.69,0,0,2,1,6,9,0,0,0,2,8,13,2
8477887,2016,1.09,1.1,0,0,12,6,4,22,0,0,0,12,9,30,2
8477901,2016,5.07,4.45,5,2,44,19,10,73,9,2,9,42,2,19,7
8477903,2016,2.23,2.1,2,2,22,9,9,40,5,1,0,21,10,56,8
8477916,2016,0.07,0.06,0,0,1,0,0,1,0,0,0,1,0,0,0
8477919,2016,0.61,0.58,0,1,8,1,3,12,1,0,2,8,4,1,2
8477922,2016,9.58,9.56,5,6,72,32,27,131,21,10,6,62,1,66,17
8477929,2016,7.57,7.31,4,0,77,14,23,114,8,4,5,73,165,61,25
8477930,2016,6.51,6.31,3,1,90,39,43,172,8,4,8,86,402,73,24
8477931,2016,2.37,2.18,0,0,19,3,2,24,1,1,2,18,37,10,5
8477932,2016,12.23,11.86,4,7,224,71,107,402,20,9,12,215,0,87,25
8477933,2016,23.77,22.22,23,7,178,55,47,280,47,17,20,161,86,21,25
8477934,2016,27.78,26.53,31,17,170,70,53,293,77,29,22,141,469,41,74
8477935,2016,15.95,15.43,7,6,122,47,46,215,26,13,6,109,374,127,43
8477937,2016,0.77,0.72,0,1,13,4,8,25,1,0,2,13,3,17,4
8477939,2016,22.53,21.53,23,16,205,81,77,363,61,22,9,183,49,25,59
8477940,2016,24.35,23.95,20,19,204,93,81,378,64,25,5,179,0,43,36
8477941,2016,15.98,15.51,8,6,149,59,53,261,28,14,12,135,4,247,16
8477942,2016,11.9,11.47,3,2,114,32,37,183,16,11,9,103,0,44,39
8477943,2016,9.28,9.05,3,4,91,38,44,173,21,14,6,77,1,40,7
8477944,2016,6.42,5.83,2,1,32,17,7,56,6,3,5,29,0,6,4
8477945,2016,1.33,1.22,4,0,34,10,17,61,5,1,3,33,0,9,6
8477946,2016,15.74,14.42,7,8,178,63,69,310,32,17,6,161,196,67,49
8477947,2016,0.49,0.43,0,0,2,2,2,6,0,0,2,2,0,3,1
8477949,2016,0.93,0.92,0,0,8,2,5,15,0,0,1,8,0,5,2
8477950,2016,3.46,3.38,3,5,57,21,29,107,13,5,6,52,0,31,4
8477951,2016,6.54,6.37,16,6,66,20,41,127,28,6,4,60,84,20,46
8477952,2016,9.82,9.61,12,6,91,35,34,160,29,11,5,80,13,64,20
8477953,2016,1.02,1,0,0,11,3,4,18,1,1,0,10,0,6,2
8477955,2016,2.77,2.76,6,0,44,16,18,78,7,1,3,43,41,28,8
8477956,2016,31.52,30.33,22,14,262,99,104,465,70,34,18,228,2,72,50
8477957,2016,0.79,0.78,0,0,3,1,4,8,1,1,0,2,0,0,0
8477958,2016,1.79,1.81,0,0,14,9,5,28,3,3,0,11,0,1,3
8477959,2016,2.31,2.32,5,1,22,10,12,44,10,4,1,18,0,4,9
8477960,2016,2.69,2.58,3,1,32,12,17,61,6,2,1,30,67,23,5
8477961,2016,2.06,2.01,2,1,21,10,4,35,4,1,2,20,0,15,4
8477964,2016,2.72,2.78,4,3,20,10,11,41,12,5,3,15,83,34,9
8477971,2016,0.25,0.24,0,0,3,3,1,7,0,0,0,3,0,18,0
8477973,2016,0.02,0.02,0,0,1,1,1,3,0,0,0,1,6,1,0
8477986,2016,2.55,2.44,2,2,50,24,37,111,6,2,5,48,0,21,3
8477989,2016,10.53,10.29,10,8,84,51,25,160,33,15,9,69,456,70,13
8477997,2016,3.06,2.97,3,4,65,41,56,162,9,2,4,63,0,145,12
8478004,2016,0.04,0.04,0,0,3,1,0,4,0,0,1,3,0,8,0
8478010,2016,16.91,16.34,8,14,122,49,43,214,40,18,3,104,238,39,30
8478027,2016,1.25,1.22,0,2,11,3,5,19,2,0,0,11,31,14,3
8478031,2016,0.28,0.25,0,0,8,2,6,16,0,0,0,8,0,12,0
8478042,2016,24.42,23.95,14,16,246,95,71,412,61,31,11,215,4,23,37
8478046,2016,0.54,0.53,0,0,7,4,1,12,0,0,0,7,0,6,5
8478055,2016,2.48,2.45,2,1,48,18,55,121,5,2,3,46,0,16,5
8478073,2016,0.29,0.28,0,0,7,7,8,22,0,0,0,7,0,38,2
8478099,2016,8.54,8.38,10,1,68,38,41,147,19,8,2,60,2,18,15
8478131,2016,7.37,7.12,7,3,77,30,38,145,15,5,5,72,1,42,23
8478366,2016,9.66,9.52,2,6,116,44,34,194,18,10,4,106,2,51,9
8478371,2016,0.5,0.49,0,1,6,1,1,8,1,0,0,6,0,0,1
8478373,2016,6.18,6,3,1,70,36,27,133,9,5,5,65,2,101,20
8478376,2016,0.6,0.61,0,0,10,0,2,12,0,0,0,10,0,4,1
8478396,2016,5.28,5.08,16,9,108,55,107,270,29,4,13,104,0,57,42
8478397,2016,0,0,0,0,0,0,1,1,0,0,0,0,0,4,0
8478398,2016,2.65,2.55,1,2,24,13,4,41,5,2,2,22,1,1,11
8478400,2016,0.03,0.03,0,0,1,1,0,2,0,0,0,1,7,0,1
8478401,2016,8.51,8.18,11,5,83,27,17,127,24,8,8,75,184,54,16
8478402,2016,31.15,30.46,44,26,248,76,91,415,99,29,22,219,346,34,75
8478403,2016,22.28,21.63,19,14,249,84,95,428,57,24,8,225,310,26,38
8478414,2016,8.66,8.57,2,1,85,30,41,156,6,3,2,82,1,64,24
8478417,2016,0,0,0,0,0,0,0,0,0,0,0,0,1,0,0
8478420,2016,13.95,13.5,10,8,131,57,51,239,38,20,5,111,29,29,48
8478421,2016,1.1,1.05,0,1,8,2,1,11,1,0,2,8,0,4,1
8478425,2016,0.07,0.06,0,0,4,1,4,9,0,0,1,4,0,3,0
8478427,2016,26.76,25.19,12,13,214,72,76,362,49,24,21,190,17,51,40
8478431,2016,0.42,0.41,0,0,4,1,1,6,0,0,0,4,0,2,0
8478432,2016,0.49,0.52,0,0,8,2,3,13,3,3,0,5,0,8,0
8478439,2016,12.25,11.98,10,7,133,50,51,234,28,11,14,122,0,92,26
8478440,2016,0.71,0.73,1,0,6,6,4,16,1,0,1,6,31,3,3
8478443,2016,3.06,3.05,4,6,88,42,49,179,16,6,4,82,0,87,21
8478444,2016,2.86,2.26,1,0,25,3,10,38,5,4,1,21,0,5,1
8478445,2016,0,0,0,0,0,0,0,0,0,0,0,0,6,1,0
8478458,2016,0.01,0.01,0,0,1,0,0,1,0,0,0,1,1,0,0
8478460,2016,9.4,8.85,15,21,188,69,133,390,47,11,24,177,0,41,27
8478463,2016,8.55,8.51,8,7,101,34,35,170,24,9,6,92,123,81,17
8478469,2016,0.04,0.04,0,0,1,1,0,2,0,0,1,1,0,1,0
8478474,2016,8.82,8.64,5,2,80,44,27,151,12,5,5,75,1,156,14
8478480,2016,0.1,0.09,0,0,3,0,0,3,0,0,0,3,0,1,1
8478483,2016,18.66,18.1,24,18,176,80,69,325,61,19,14,157,14,41,67
8478491,2016,0.07,0.07,0,0,2,3,6,11,0,0,0,2,0,1,0
8478493,2016,1.29,1.35,2,2,15,7,3,25,7,3,1,12,45,23,3
8478495,2016,0.05,0.05,0,0,0,1,2,3,0,0,0,0,0,1,0
8478500,2016,7.39,7.25,15,9,161,59,111,331,30,6,21,155,0,111,23
8478506,2016,0.05,0.05,0,1,3,1,2,6,1,0,0,3,0,5,0
8478512,2016,5.59,5.52,5,3,66,33,20,119,13,5,4,61,57,19,19
8478528,2016,8.05,8.04,6,4,60,20,20,100,16,6,5,54,209,41,14
8478541,2016,0.63,0.58,0,1,8,3,3,14,2,1,1,7,0,16,0
8478542,2016,3.35,3.3,2,0,51,23,20,94,6,4,2,47,104,12,12
8478550,2016,22.13,21.97,27,16,211,90,95,396,74,31,10,180,2,23,57
8478561,2016,5.45,5.31,3,1,73,31,26,130,7,3,5,70,3,166,25
8478562,2016,0.13,0.14,0,0,3,1,3,7,0,0,0,3,0,2,1
8478566,2016,3.64,3.42,2,0,38,10,8,56,4,2,2,36,72,53,7
8478569,2016,3.39,3.34,1,2,24,8,11,43,5,2,2,22,11,80,10
8478585,2016,10.99,10.69,9,9,73,29,34,136,29,11,10,62,391,33,33
8478843,2016,6.4,6.27,1,3,67,13,19,99,10,6,3,61,65,34,17
8478851,2016,0.01,0.01,0,0,1,0,0,1,0,0,0,1,0,0,0
8478866,2016,0.34,0.34,1,0,2,2,1,5,1,0,1,2,0,2,1
8478906,2016,2.7,2.65,1,4,66,24,44,134,7,2,4,64,0,36,9
8478963,2016,0.18,0.18,0,0,3,1,4,8,0,0,0,3,0,1,1
8479249,2016,0.07,0.07,0,0,1,0,0,1,0,0,0,1,12,1,1
8479250,2016,5.57,5,1,2,57,16,14,87,7,4,1,53,2,36,13
8479252,2016,0.04,0.03,0,0,1,0,0,1,0,0,0,1,0,3,0
8479268,2016,0.23,0.24,0,0,10,2,7,19,0,0,0,10,0,15,0
8479290,2016,0.02,0.02,0,0,1,0,1,2,0,0,0,1,3,1,0
8479291,2016,0.1,0.09,0,0,2,2,1,5,0,0,0,2,10,4,0
8479293,2016,4.22,4.12,0,2,54,14,14,82,4,2,2,52,1,128,19
8479314,2016,17.14,16.97,25,10,142,50,40,232,48,13,17,129,8,65,40
8479318,2016,35.78,34.76,20,9,279,110,87,476,69,40,26,239,530,21,76
8479339,2016,18.85,18.49,13,15,204,80,76,360,64,36,9,168,0,80,43
8479343,2016,0,0,1,1,0,0,0,0,2,0,0,0,0,0,1
8479344,2016,2.45,2.39,6,0,41,13,13,67,7,1,1,40,0,11,12
8479345,2016,4.7,4.46,5,8,83,53,58,194,20,7,9,76,0,109,11
8479370,2016,0.73,0.7,0,0,9,2,4,15,1,1,0,8,28,3,3
8479410,2016,0.09,0.09,0,0,2,1,1,4,0,0,0,2,0,10,1
8479423,2016,0.18,0.18,1,0,4,1,3,8,1,0,0,4,0,1,3
8479442,2016,5.07,4.95,10,11,125,59,123,307,24,3,6,122,0,51,26
8479458,2016,4.84,4.7,13,19,106,75,122,303,36,4,3,102,0,176,33
8479465,2016,11.35,10.93,6,5,92,42,36,170,18,7,10,85,117,96,22
8479482,2016,2.37,2.31,2,4,67,39,67,173,8,2,2,65,0,76,6
8479483,2016,1.72,1.67,1,1,54,13,20,87,4,2,1,52,0,20,7
8479648,2016,4.71,4.49,1,1,41,26,17,84,6,4,5,37,1,28,12
8479969,2016,0.45,0.44,0,0,3,3,1,7,0,0,0,3,0,1,0
8480081,2016,0.11,0.1,0,0,4,1,5,10,0,0,0,4,0,5,2
8480083,2016,0.13,0.12,1,0,2,1,1,4,1,0,0,2,0,0,2
8480087,2016,0.1,0.1,0,0,1,0,1,2,0,0,0,1,8,1,0
8448208,2015,19.76,18.27,21,18,143,67,44,254,66,27,8,116,0,31,33
8460542,2015,1.69,1.64,3,3,21,5,9,35,8,2,0,19,9,10,5
8460720,2015,0.09,0.09,0,0,3,0,2,5,0,0,0,3,0,15,1
8462038,2015,21.16,20.44,12,7,171,65,55,291,47,28,17,143,74,116,33
8462042,2015,18.66,17.96,16,9,182,59,101,342,47,22,18,160,61,70,22
8464977,2015,4.32,4.29,1,3,33,16,17,66,7,3,2,30,15,68,15
8464989,2015,11.16,11.14,11,5,118,30,35,183,32,16,3,102,582,40,19
8465009,2015,6.85,6.64,15,13,158,59,95,312,37,9,11,149,0,134,23
8465058,2015,1.44,1.39,6,6,41,13,36,90,13,1,2,40,0,81,6
8465185,2015,1.21,1.2,1,5,33,17,27,77,7,1,2,32,0,68,6
8465978,2015,3.25,3.22,4,0,58,19,11,88,5,1,5,57,6,73,9
8466138,2015,14.42,13.58,34,29,121,49,41,211,82,19,8,102,399,48,69
8466139,2015,29.58,28.38,13,10,216,81,60,357,48,25,15,191,267,64,46
8466148,2015,20.01,19.54,14,6,191,40,76,307,33,13,15,178,0,37,44
8466251,2015,18.67,18.02,14,6,165,39,49,253,40,20,12,145,8,103,15
8466285,2015,5.68,5.55,12,13,99,44,56,199,31,6,7,93,0,27,23
8466333,2015,0.11,0.1,0,0,4,2,5,11,0,0,0,4,0,10,0
8466393,2015,2.47,2.32,2,0,28,11,13,52,4,2,3,26,2,35,2
8467096,2015,6.68,6.49,7,7,95,42,55,192,24,10,6,85,0,66,19
8467329,2015,6.84,6.7,6,2,67,24,22,113,18,10,3,57,297,62,13
8467330,2015,4.35,4.2,5,4,61,9,23,93,14,5,5,56,196,28,19
8467331,2015,0.07,0.07,0,0,0,3,1,4,0,0,0,0,0,11,0
8467338,2015,7.59,7.36,16,11,71,24,29,124,35,8,2,63,3,22,27
8467351,2015,1.47,1.44,3,5,20,6,6,32,9,1,1,19,125,3,6
8467370,2015,11,10.6,7,3,98,36,53,187,23,13,6,85,668,142,21
8467371,2015,7.22,7.04,19,24,76,27,20,123,50,7,6,69,288,61,22
8467389,2015,11.7,10.95,14,4,164,56,87,307,28,10,6,154,124,16,15
8467400,2015,6.45,6.21,6,20,127,52,85,264,34,8,7,119,0,78,31
8467407,2015,14.59,14.14,15,6,169,51,55,275,33,12,7,157,54,46,31
8467423,2015,6.87,6.79,6,3,73,27,16,116,15,6,6,67,320,58,12
8467452,2015,0.98,0.97,5,5,35,13,23,71,10,0,4,35,0,31,5
8467493,2015,8.43,8.18,4,4,70,36,28,134,13,5,2,65,1,215,11
8467496,2015,8.14,7.89,23,16,117,58,112,287,44,5,7,112,0,57,38
8467514,2015,20.96,20.19,16,17,181,68,74,323,49,16,15,165,599,70,48
8467875,2015,25.77,25.07,20,12,248,81,51,380,59,27,9,221,4,18,23
8467876,2015,10.96,10.63,30,15,109,32,32,173,57,12,3,97,621,11,24
8467890,2015,2.22,2.18,1,3,64,29,37,130,5,1,4,63,0,100,8
8467899,2015,0.24,0.24,0,0,3,1,0,4,1,1,0,2,0,1,3
8467967,2015,0.83,0.86,0,0,8,3,3,14,2,2,0,6,22,13,2
8468001,2015,9.31,9.24,1,6,79,31,16,126,13,6,5,73,439,154,27
8468083,2015,19.08,18.47,21,16,214,82,98,394,50,13,14,201,539,54,29
8468085,2015,14.67,14.35,6,8,199,56,77,332,27,13,10,186,4,15,20
8468208,2015,21.45,19.76,14,8,138,58,36,232,43,21,9,117,237,68,41
8468309,2015,5.81,5.67,6,11,110,47,68,225,23,6,7,104,0,28,14
8468483,2015,14.23,13.87,7,3,142,42,29,213,22,12,9,130,1,29,13
8468486,2015,22.63,21.88,15,11,150,49,41,240,49,23,16,127,0,131,20
8468493,2015,6.27,6.1,6,8,131,52,68,251,19,5,12,126,0,85,34
8468498,2015,1.06,1.02,2,5,31,14,36,81,10,3,3,28,0,125,7
8468504,2015,11.74,11.15,9,7,85,41,43,169,24,8,13,77,9,20,25
8468505,2015,2.19,2.17,1,1,21,6,3,30,2,0,2,21,39,34,3
8468508,2015,25.62,24.68,15,15,201,66,58,325,52,22,16,179,57,32,37
8468509,2015,2.72,2.59,11,12,61,29,54,144,26,3,6,58,0,93,9
8468513,2015,3.05,2.93,2,7,70,36,55,161,10,1,5,69,1,85,4
8468526,2015,4.57,4.51,1,4,49,17,12,78,9,4,3,45,481,117,8
8468535,2015,15.79,15.1,11,10,123,32,36,191,38,17,13,106,754,55,27
8468542,2015,1.89,1.82,7,10,49,21,52,122,20,3,0,46,0,54,26
8468575,2015,7.61,7.54,5,4,94,26,30,150,15,6,7,88,476,51,24
8468611,2015,6.2,5.96,4,3,62,24,32,118,12,5,3,57,251,175,14
8468635,2015,1.04,1.01,1,1,12,3,2,17,2,0,0,12,4,30,4
8468639,2015,5.18,5.03,8,7,111,39,82,232,21,6,7,105,0,81,26
8468674,2015,2.13,2.07,2,7,71,29,49,149,12,3,6,68,0,105,8
8468700,2015,3.6,3.57,2,2,46,13,12,71,6,2,0,44,427,114,14
8469455,2015,22.11,21.39,18,12,202,86,103,391,63,33,17,169,538,9,45
8469459,2015,19.81,18.32,18,21,141,61,75,277,56,17,18,124,987,38,37
8469462,2015,3.27,3.23,1,0,34,10,8,52,1,0,1,34,2,63,10
8469465,2015,3.65,3.58,6,4,72,28,64,164,13,3,2,69,0,64,24
8469466,2015,12.82,12.55,16,10,155,40,70,265,39,13,9,142,2,25,22
8469469,2015,4.4,4.33,8,1,48,12,12,72,11,2,1,46,2,59,4
8469470,2015,1.42,1.32,2,2,29,14,16,59,5,1,3,28,0,36,3
8469490,2015,0.06,0.06,0,0,1,0,0,1,0,0,0,1,0,2,0
8469492,2015,0.84,0.81,2,0,25,20,33,78,3,1,4,24,0,128,7
8469500,2015,11.42,10.78,18,6,102,29,23,154,38,14,6,88,7,15,19
8469501,2015,7.26,7.17,4,2,70,23,21,114,12,6,3,64,68,146,11
8469506,2015,14.38,13.52,10,15,187,49,50,286,36,11,12,176,37,31,21
8469508,2015,9.33,8.68,7,1,64,23,20,107,11,3,12,61,375,79,32
8469521,2015,16.83,16.45,21,19,189,61,73,323,54,14,12,175,804,60,15
8469544,2015,21.82,20.67,25,10,226,98,82,406,55,20,14,206,16,76,51
8469547,2015,7.75,7.76,3,2,90,31,20,141,9,4,5,86,0,99,17
8469555,2015,3.38,3.33,5,5,80,43,51,174,12,2,3,78,0,39,5
8469598,2015,4.86,4.72,7,4,109,56,84,249,15,4,5,105,0,152,13
8469619,2015,2.1,2.06,6,5,66,23,43,132,12,1,3,65,0,127,16
8469623,2015,2.49,2.36,6,6,48,17,28,93,16,4,3,44,0,39,5
8469638,2015,17.43,16.61,24,18,153,44,51,248,60,18,8,135,135,43,31
8469639,2015,9.6,9.18,6,6,101,27,30,158,14,2,9,99,98,126,29
8469665,2015,2.6,2.53,9,8,63,51,76,190,21,4,7,59,0,73,23
8469707,2015,19.46,18.57,10,11,168,69,76,313,41,20,17,148,4,48,29
8469759,2015,10.35,10.2,4,6,98,55,34,187,22,12,12,86,455,42,24
8469760,2015,2.16,2.08,1,4,69,23,41,133,7,2,2,67,0,84,21
8469770,2015,3.9,3.78,8,9,75,39,72,186,19,2,2,73,0,37,14
8470039,2015,11.97,11.81,8,3,123,38,52,213,25,14,12,109,24,40,38
8470041,2015,19.61,19.19,11,10,184,70,67,321,36,15,8,169,0,69,45
8470047,2015,8.46,8.26,12,11,101,27,35,163,31,8,2,93,632,30,30
8470104,2015,1.13,1.12,1,0,36,10,36,82,2,1,0,35,0,29,6
8470105,2015,10.58,10.4,7,1,113,35,34,182,14,6,8,107,12,92,19
8470110,2015,6.8,6.68,9,13,130,53,90,273,28,6,9,124,0,42,17
8470120,2015,1.3,1.33,1,2,18,11,12,41,4,1,1,17,1,6,6
8470121,2015,0.05,0.04,0,0,3,1,0,4,0,0,0,3,0,5,0
8470144,2015,20.55,19.58,16,16,181,71,70,322,52,20,11,161,586,35,30
8470151,2015,5.12,5,7,9,105,48,77,230,19,3,6,102,0,71,11
8470159,2015,4.38,4.32,1,1,53,15,12,80,4,2,2,51,526,21,10
8470162,2015,6.36,6.24,8,3,58,24,29,111,17,6,1,52,373,77,34
8470169,2015,5.84,5.6,3,5,58,26,31,115,11,3,4,55,229,100,14
8470171,2015,2.71,2.78,3,2,29,5,9,43,7,2,1,27,164,66,9
8470180,2015,3.68,3.63,0,0,27,9,14,50,7,7,2,20,1,92,6
8470187,2015,6.88,6.79,8,8,165,74,122,361,25,9,12,156,0,149,21
8470201,2015,13,12.57,17,13,109,35,36,180,46,16,9,93,11,28,23
8470207,2015,15.46,14.43,2,1,102,47,29,178,14,11,12,91,0,58,12
8470222,2015,0,0,0,0,0,0,0,0,0,0,0,0,0,1,0
8470230,2015,1.28,1.24,0,0,11,2,3,16,0,0,1,11,0,16,5
8470257,2015,15.79,15.42,20,15,172,54,66,292,52,17,15,155,159,50,36
8470274,2015,4.3,4.29,1,0,51,18,17,86,4,3,2,48,1,15,7
8470281,2015,5.96,5.89,15,19,130,55,102,287,43,9,7,121,0,16,22
8470317,2015,0.24,0.23,0,0,10,6,10,26,0,0,1,10,0,15,2
8470318,2015,2.97,2.93,6,6,68,42,44,154,15,3,8,65,0,121,14
8470324,2015,2.26,2.25,2,8,57,33,49,139,12,2,4,55,0,143,13
8470358,2015,12.85,12.53,7,6,135,49,37,221,22,9,7,126,10,81,27
8470378,2015,0.03,0.03,0,0,0,1,0,1,0,0,0,0,0,1,0
8470543,2015,15.79,15.49,15,8,150,62,67,279,40,17,10,133,5,264,33
8470595,2015,25.95,25.09,16,10,199,98,81,378,39,13,18,186,446,74,62
8470598,2015,15.83,15.35,17,6,146,46,56,248,41,18,15,128,12,18,22
8470599,2015,9.83,9.44,5,4,64,27,28,119,16,7,8,57,3,42,25
8470600,2015,7.74,6.83,21,22,188,68,146,402,51,8,12,180,0,69,36
8470601,2015,3.38,3.32,4,5,92,44,55,191,10,1,2,91,0,111,17
8470602,2015,7.31,7.1,16,12,144,83,131,358,32,4,15,140,0,168,19
8470604,2015,25.14,23.73,20,18,242,108,97,447,62,24,18,218,598,89,26
8470606,2015,17.52,17.15,10,7,218,95,62,375,28,11,15,207,8,234,40
8470607,2015,8.16,7.99,15,20,167,60,134,361,49,14,10,153,0,121,19
8470609,2015,2.11,2.11,1,4,27,4,12,43,6,1,1,26,0,42,6
8470610,2015,28.56,26.03,14,14,234,81,70,385,53,25,29,209,0,71,39
8470611,2015,8.94,8.96,1,5,74,24,27,125,14,8,5,66,107,60,30
8470612,2015,18.95,18.37,30,20,179,99,75,353,63,13,10,166,602,110,48
8470613,2015,18.02,17.35,25,23,353,145,252,750,75,27,17,326,1,101,53
8470614,2015,1.85,1.8,0,2,39,25,41,105,3,1,5,38,0,162,3
8470616,2015,25.46,24.73,19,13,165,103,80,348,53,21,15,144,980,168,39
8470617,2015,6.46,6.32,3,0,46,18,13,77,5,2,5,44,235,39,12
8470619,2015,12.06,11.65,4,3,117,43,39,199,20,13,6,104,346,115,15
8470621,2015,27.42,26.37,22,6,215,90,79,384,62,34,14,181,2,104,25
8470622,2015,10.37,10.1,4,2,86,37,37,160,17,11,5,75,3,70,16
8470626,2015,21.12,20.36,18,15,184,51,33,268,63,30,6,154,12,22,48
8470630,2015,4.2,4.16,4,13,69,31,54,154,26,9,3,60,0,117,20
8470638,2015,28.7,27.88,16,20,282,99,74,455,68,32,14,250,1130,77,67
8470640,2015,2.14,2.06,3,4,54,22,36,112,9,2,2,52,0,30,9
8470642,2015,14.37,13.45,17,14,189,91,100,380,51,20,14,169,0,169,19
8470644,2015,0.49,0.47,0,0,4,2,0,6,1,1,0,3,0,16,0
8470655,2015,19.79,19.24,17,7,168,60,42,270,45,21,10,147,620,239,39
8470667,2015,0.44,0.46,0,0,4,1,3,8,0,0,0,4,0,3,0
8470714,2015,0.01,0.01,0,0,0,1,0,1,0,0,1,0,0,0,0
8470724,2015,2.61,2.56,0,7,62,16,35,113,11,4,5,58,0,49,8
8470729,2015,0.03,0.03,0,0,0,1,1,2,0,0,0,0,0,4,0
8470740,2015,20.38,19.72,15,17,146,52,59,257,51,19,15,127,2,113,31
8470750,2015,11.95,11.77,4,7,101,30,34,165,21,10,5,91,415,85,33
8470755,2015,11.35,11.01,12,8,117,39,54,210,31,11,10,106,523,57,26
8470760,2015,2.13,2.1,3,4,74,22,36,132,12,5,1,69,0,124,10
8470775,2015,4.65,4.53,2,1,42,15,19,76,6,3,1,39,235,103,7
8470778,2015,2.3,2.3,1,0,27,11,6,44,2,1,1,26,1,39,8
8470794,2015,28.69,27.9,24,16,224,92,78,394,78,38,14,186,516,147,46
8470803,2015,5.3,5.18,2,2,49,27,28,104,11,7,2,42,275,50,18
8470828,2015,2.03,2.01,5,9,50,26,44,120,16,2,3,48,0,25,9
8470834,2015,17.92,16.45,20,14,247,108,143,498,53,19,15,228,0,222,73
8470852,2015,12.25,11.68,7,6,111,43,28,182,21,8,5,103,0,45,18
8470854,2015,4.68,4.49,2,1,49,18,15,82,7,4,5,45,6,224,4
8470871,2015,4.15,4.02,1,2,45,20,21,86,7,4,2,41,0,157,15
8470877,2015,10.86,10.49,6,1,84,48,27,159,18,11,8,73,17,147,14
8470886,2015,1.54,1.49,1,4,32,16,23,71,6,1,1,31,0,123,2
8470920,2015,3.17,3.1,1,1,24,4,5,33,4,2,2,22,2,45,5
8470966,2015,10.92,10.5,17,18,212,84,177,473,56,21,14,191,0,65,45
8471214,2015,40.12,38.5,6,15,398,166,215,779,71,50,23,348,0,225,24
8471215,2015,19.35,17.46,21,10,162,57,66,285,58,27,17,135,317,27,54
8471217,2015,22.42,21.68,9,12,181,71,100,352,46,25,10,156,8,155,29
8471218,2015,26.12,25.42,37,15,256,107,96,459,78,26,17,230,10,92,38
8471222,2015,0.37,0.37,0,0,11,4,9,24,0,0,1,11,0,39,1
8471226,2015,19.48,18.86,10,7,187,40,62,289,38,21,8,166,51,59,30
8471231,2015,4.91,4.52,6,2,47,17,23,87,12,4,3,43,88,73,25
8471232,2015,10.5,9.95,7,5,88,30,30,148,22,10,5,78,18,100,19
8471233,2015,15.92,15.06,14,14,111,39,36,186,42,14,5,97,715,65,49
8471240,2015,0.02,0.02,0,0,1,0,0,1,0,0,0,1,0,0,0
8471242,2015,6.25,6.09,12,16,124,51,80,255,35,7,6,117,0,106,18
8471245,2015,3.2,2.98,2,2,26,12,14,52,5,1,5,25,156,36,5
8471254,2015,1.96,1.89,1,1,21,11,12,44,2,0,3,21,2,58,4
8471260,2015,13.35,13.06,11,13,142,40,69,251,36,12,9,130,276,173,31
8471262,2015,18.58,17.36,27,12,163,54,50,267,51,12,18,151,339,27,32
8471269,2015,1.18,1.14,2,2,42,17,32,91,7,3,6,39,0,106,3
8471273,2015,20.73,19.69,22,9,158,49,81,288,48,17,13,141,780,235,45
8471274,2015,6.23,5.92,14,18,127,56,115,298,37,5,9,122,0,100,18
8471276,2015,16.55,15.85,28,18,143,62,87,292,63,17,10,126,560,43,36
8471283,2015,2.63,2.59,4,2,19,11,7,37,7,1,2,18,6,40,5
8471284,2015,7.75,7.46,13,11,155,61,162,378,30,6,15,149,0,60,37
8471296,2015,2.38,2.34,3,9,71,42,82,195,12,0,4,71,0,256,15
8471303,2015,4.63,4.52,3,11,111,60,77,248,20,6,1,105,0,84,15
8471309,2015,0.26,0.27,1,0,3,2,1,6,1,0,1,3,0,3,0
8471311,2015,4.55,4.44,8,5,72,22,31,125,16,3,3,69,23,35,16
8471331,2015,3.11,3.04,2,1,34,12,11,57,3,0,2,34,44,96,7
8471338,2015,6.99,6.66,6,2,69,17,16,102,19,11,4,58,370,67,22
8471339,2015,14.72,14.42,11,7,156,73,55,284,28,10,11,146,21,164,34
8471346,2015,18.1,16.98,9,14,156,77,55,288,38,15,17,141,8,20,38
8471348,2015,0.37,0.37,0,1,12,6,15,33,1,0,0,12,0,14,0
8471362,2015,10.05,9.65,7,9,83,41,34,158,25,9,8,74,221,28,28
8471371,2015,3.74,3.49,3,0,51,18,20,89,5,2,2,49,3,176,9
8471385,2015,1.27,1.28,3,1,22,10,11,43,4,0,1,22,0,32,6
8471390,2015,7,6.95,1,8,81,22,28,131,18,9,3,72,75,28,5
8471392,2015,4.8,4.57,8,7,91,49,77,217,16,1,6,90,1,303,17
8471426,2015,16.88,16.75,10,11,142,47,55,244,39,18,14,124,65,200,40
8471436,2015,3.68,3.6,5,3,74,46,63,183,10,2,5,72,0,126,24
8471476,2015,8.67,8.21,7,6,101,30,35,166,19,6,9,95,8,53,35
8471490,2015,5.57,5.28,4,1,68,24,28,120,10,5,5,63,156,124,23
8471498,2015,10.21,10.17,12,4,117,39,34,190,38,22,3,95,6,39,25
8471504,2015,6.14,5.97,1,4,77,27,27,131,8,3,3,74,3,82,16
8471657,2015,7.65,7.55,2,3,73,20,14,107,13,8,5,65,1,240,6
8471663,2015,1.2,1.21,2,0,14,4,10,28,5,3,1,11,0,41,1
8471664,2015,3.81,3.69,0,1,53,15,19,87,5,4,2,49,3,12,8
8471669,2015,15.37,14.9,20,19,103,51,25,179,49,10,10,93,684,32,20
8471675,2015,26.54,25.6,28,21,248,94,104,446,85,36,25,212,986,90,40
8471676,2015,20.7,19.3,23,11,183,65,93,341,56,22,19,161,3,106,52
8471677,2015,4.92,4.79,3,5,86,51,68,205,14,6,3,80,0,98,8
8471678,2015,12.64,11.99,12,10,109,41,24,174,36,14,9,95,20,35,32
8471681,2015,8.19,8.06,6,0,106,38,32,176,14,8,4,98,4,97,17
8471685,2015,20.47,19.59,24,25,177,67,67,311,74,25,14,152,950,78,43
8471686,2015,3.61,3.58,5,8,65,28,52,145,15,2,1,63,1,65,20
8471691,2015,15.6,14.46,14,14,141,61,41,243,41,13,13,128,586,126,27
8471693,2015,2.52,2.49,2,4,63,31,40,134,8,2,5,61,0,39,7
8471698,2015,23.07,22.53,11,14,185,71,64,320,51,26,11,159,138,134,62
8471699,2015,13.74,13.62,12,11,131,50,50,231,32,9,11,122,6,124,26
8471702,2015,6.23,6.14,12,15,150,70,115,335,32,5,5,145,0,157,34
8471703,2015,1.88,1.91,2,1,22,7,7,36,6,3,0,19,2,29,4
8471707,2015,25.39,24.86,19,8,268,95,111,474,58,31,18,237,8,113,49
8471709,2015,7.29,7.08,13,18,116,74,90,280,39,8,12,108,0,47,15
8471710,2015,1.4,1.37,3,2,28,18,32,78,6,1,1,27,0,56,8
8471716,2015,17.78,17.35,17,6,155,53,31,239,42,19,12,136,5,207,23
8471717,2015,1.19,1.13,3,5,42,17,48,107,9,1,2,41,0,142,7
8471724,2015,14.33,13.26,23,28,218,53,146,417,67,16,11,202,0,135,47
8471729,2015,5.39,5.35,7,8,70,56,63,189,19,4,5,66,0,40,23
8471733,2015,0.96,0.95,4,0,10,2,5,17,4,0,1,10,0,58,2
8471735,2015,6.99,6.92,24,18,160,82,122,364,47,5,6,155,0,43,27
8471742,2015,3.5,3.41,6,7,92,34,63,189,17,4,9,88,0,61,14
8471752,2015,0.1,0.1,0,0,0,4,5,9,0,0,0,0,0,1,1
8471760,2015,0.56,0.55,0,0,11,3,2,16,0,0,0,11,12,26,2
8471761,2015,0.08,0.08,0,0,4,1,2,7,0,0,0,4,0,3,0
8471762,2015,9.64,9.28,5,7,77,32,19,128,14,2,10,75,6,139,21
8471766,2015,0.74,0.73,1,1,11,5,6,22,3,1,1,10,2,53,3
8471769,2015,4.54,4.46,7,15,77,36,71,184,24,2,3,75,0,32,31
8471794,2015,17.24,16.43,7,6,165,59,67,291,26,13,18,152,39,115,22
8471804,2015,6.48,6.39,2,2,73,28,39,140,7,3,3,70,2,54,13
8471811,2015,2.45,2.19,4,3,20,4,3,27,11,4,1,16,103,5,2
8471816,2015,1.87,1.83,2,3,61,33,40,134,7,2,3,59,0,53,13
8471817,2015,3.12,3.08,0,1,31,10,14,55,4,3,2,28,1,206,8
8471856,2015,0.15,0.15,0,0,1,1,0,2,0,0,0,1,0,1,0
8471862,2015,7.58,6.95,5,3,58,27,17,102,15,7,5,51,13,90,10
8471873,2015,7.96,7.57,10,15,127,48,72,247,34,9,6,118,0,99,26
8471887,2015,29.28,27.86,15,14,257,71,64,392,51,22,27,235,5,160,28
8471916,2015,0.53,0.51,0,0,1,2,3,6,1,1,0,0,10,6,1
8471956,2015,10.92,10.88,4,1,97,35,52,184,13,8,7,89,43,102,26
8471958,2015,4.21,3.9,6,9,77,29,43,149,17,2,5,75,0,168,23
8471976,2015,11.66,11.4,10,8,90,21,32,143,29,11,8,79,391,31,27
8471996,2015,0,0,1,0,0,0,0,0,1,0,0,0,8,5,0
8472382,2015,4.01,3.99,5,4,63,42,43,148,13,4,5,59,0,73,26
8472410,2015,6.79,6.66,6,4,62,26,22,110,11,1,2,61,291,113,17
8473412,2015,17.07,16.37,14,11,127,45,44,216,42,17,10,110,674,48,20
8473415,2015,1.63,1.61,3,4,61,15,40,116,7,0,2,61,0,124,8
8473419,2015,25.36,24.75,15,9,250,71,74,395,61,37,8,213,21,65,43
8473422,2015,15.5,14.49,13,12,149,52,43,244,37,12,19,137,83,152,27
8473426,2015,1.1,1.04,3,1,40,15,22,77,5,1,2,39,0,108,2
8473431,2015,0.01,0.01,0,0,1,0,0,1,0,0,0,1,0,0,2
8473432,2015,7.97,7.87,5,6,91,34,22,147,16,5,4,86,3,127,11
8473446,2015,7.96,7.79,9,7,175,51,81,307,27,11,9,164,0,126,30
8473449,2015,23.1,22.12,23,19,202,70,104,376,64,22,11,180,23,90,42
8473453,2015,16.49,16.41,5,3,167,59,39,265,16,8,12,159,103,168,17
8473463,2015,19.95,19.47,7,10,130,58,29,217,36,19,3,111,62,283,42
8473465,2015,22.09,21.47,8,9,156,58,30,244,39,22,9,134,4,164,18
8473466,2015,11.67,11.25,2,3,89,34,50,173,16,11,7,78,184,208,14
8473468,2015,2.38,2.31,2,3,58,29,56,143,6,1,4,57,0,132,16
8473473,2015,18.71,18.2,25,10,124,85,60,269,55,20,13,104,7,244,22
8473482,2015,3.61,3.47,2,0,38,12,14,64,4,2,3,36,0,39,8
8473485,2015,6.69,6.62,9,3,78,32,23,133,20,8,8,70,3,72,12
8473492,2015,17.6,17.08,11,11,168,98,96,362,37,15,13,153,6,260,27
8473504,2015,6.46,6.47,4,4,80,29,42,151,23,15,3,65,1,288,21
8473507,2015,4.49,4.37,5,6,98,44,91,233,16,5,10,93,1,86,16
8473512,2015,19.82,19,25,20,241,68,110,419,67,22,19,219,1081,83,41
8473533,2015,22.16,21.3,20,8,151,66,54,271,48,20,15,131,806,165,55
8473534,2015,9.25,9.16,2,3,80,26,22,128,15,10,6,70,139,48,22
8473537,2015,13.47,13.29,5,6,125,50,36,211,20,9,10,116,2,144,29
8473542,2015,0.1,0.11,0,1,1,0,0,1,1,0,0,1,0,13,0
8473544,2015,17.73,17.44,18,13,182,52,73,307,58,27,11,155,676,103,47
8473546,2015,14.59,14.28,5,4,116,47,23,186,18,9,8,107,3,41,66
8473548,2015,25.92,24.53,22,11,274,82,123,479,59,26,22,248,2,9,26
8473550,2015,0.35,0.34,3,1,9,5,19,33,4,0,0,9,0,44,2
8473560,2015,0.64,0.66,3,0,17,11,14,42,3,0,2,17,0,57,2
8473562,2015,0,0,0,0,0,0,0,0,0,0,0,0,0,0,0
8473563,2015,13.82,13.31,29,21,129,47,46,222,70,20,6,109,659,51,42
8473564,2015,13.42,12.94,9,8,155,37,77,269,32,15,8,140,5,49,27
8473565,2015,1.73,1.69,1,4,43,26,41,110,6,1,3,42,0,106,9
8473571,2015,2.04,1.93,3,4,32,19,27,78,9,2,6,30,0,20,2
8473573,2015,16.3,16.05,9,13,121,41,51,213,42,20,4,101,507,53,28
8473574,2015,12.36,11.7,8,8,101,34,25,160,28,12,10,89,9,68,34
8473579,2015,11.57,11.3,8,5,92,28,41,161,22,9,2,83,23,107,32
8473584,2015,1.2,1.18,5,2,20,17,22,59,8,1,1,19,0,14,4
8473588,2015,4.92,4.91,3,2,58,18,20,96,11,6,2,52,1,20,15
8473589,2015,0.41,0.37,0,0,5,1,1,7,0,0,0,5,0,4,0
8473604,2015,22.22,21.4,17,13,179,49,50,278,58,28,13,151,921,81,57
8473618,2015,15.5,14.62,14,18,133,45,80,258,41,9,8,124,94,83,31
8473646,2015,5.64,5.54,4,1,62,15,19,96,12,7,6,55,21,87,17
8473658,2015,0.52,0.52,0,0,8,6,2,16,0,0,1,8,0,21,0
8473673,2015,4.72,4.66,10,3,104,34,44,182,19,6,2,98,0,47,16
8473722,2015,0.41,0.39,1,0,6,0,0,6,1,0,1,6,0,23,1
8473914,2015,10.83,10.13,7,8,107,45,46,198,25,10,9,97,596,68,28
8473933,2015,2.96,2.8,1,5,90,38,44,172,10,4,4,86,0,154,20
8473962,2015,13.74,13.1,15,14,149,63,72,284,43,14,10,135,2,31,31
8473970,2015,1.69,1.63,0,0,10,6,10,26,1,1,0,9,1,47,3
8473986,2015,18.51,16.49,18,8,154,64,60,278,40,14,9,140,31,76,31
8473989,2015,1.85,1.8,0,0,18,3,6,27,1,1,1,17,0,35,2
8473991,2015,4.03,3.94,8,9,75,40,70,185,21,4,5,71,0,135,24
8473992,2015,0.53,0.55,4,0,16,9,19,44,4,0,1,16,0,37,3
8473994,2015,36.09,34.62,26,22,247,96,88,431,89,41,18,206,226,156,65
8474000,2015,1.66,1.63,0,4,54,19,25,98,4,0,1,54,1,70,5
8474005,2015,0.33,0.33,0,0,4,1,5,10,0,0,0,4,0,7,1
8474008,2015,0.22,0.23,0,0,5,0,0,5,1,1,0,4,0,6,0
8474009,2015,11.89,11.62,12,8,97,33,37,167,29,9,8,88,463,22,32
8474013,2015,2.24,2.17,4,8,72,33,40,145,12,0,4,72,0,122,8
8474019,2015,0,0,1,0,0,0,3,3,1,0,0,0,0,3,0
8474024,2015,0.13,0.13,0,0,3,0,2,5,0,0,0,3,29,7,0
8474025,2015,0,0,0,0,0,0,0,0,0,0,0,0,0,1,0
8474027,2015,4.81,4.74,11,8,114,43,87,244,23,4,3,110,0,95,33
8474031,2015,9.42,9.17,18,12,180,70,100,350,44,14,12,166,0,82,37
8474034,2015,11.81,11.69,7,8,104,34,30,168,27,12,10,92,17,151,10
8474037,2015,14.7,13.38,10,5,129,49,50,228,29,14,14,115,1,52,29
8474038,2015,7.48,7.12,6,1,51,17,23,91,18,11,2,40,3,112,23
8474040,2015,6.73,6.27,4,4,87,36,39,162,16,8,5,79,34,17,20
8474052,2015,7.91,7.79,2,1,78,34,39,151,11,8,5,70,1,82,21
8474053,2015,14.26,13.61,10,11,137,54,66,257,36,15,21,122,271,29,39
8474056,2015,7.49,6.99,22,23,176,72,130,378,51,6,10,170,0,102,23
8474061,2015,1.68,1.68,1,3,16,10,7,33,5,1,3,15,0,81,3
8474062,2015,8.21,7.91,6,7,76,21,32,129,22,9,8,67,193,58,47
8474066,2015,3.23,3.14,7,5,55,45,51,151,18,6,0,49,0,65,18
8474068,2015,13.62,13.13,10,7,122,48,55,225,30,13,5,109,536,44,16
8474074,2015,1.06,1.05,0,0,24,13,21,58,2,2,1,22,0,13,4
8474089,2015,3.81,3.72,3,1,31,22,21,74,6,2,1,29,40,124,4
8474090,2015,5.06,4.9,6,6,82,33,57,172,15,3,6,79,0,94,10
8474091,2015,4.01,3.97,0,4,45,16,10,71,9,5,2,40,146,12,4
8474094,2015,3.23,3.17,3,0,39,8,8,55,3,0,1,39,1,38,5
8474096,2015,6.52,6.32,3,7,53,24,31,108,13,3,1,50,309,65,31
8474098,2015,11.28,11.02,8,4,125,38,58,221,23,11,11,114,9,71,30
8474100,2015,6.23,6.09,3,3,48,26,20,94,13,7,8,41,2,73,5
8474102,2015,16.32,16.12,15,9,147,49,44,240,36,12,14,135,2,142,22
8474113,2015,0.49,0.45,0,0,11,7,8,26,1,1,1,10,0,7,2
8474125,2015,2.45,2.37,2,4,51,25,40,116,9,3,3,48,0,67,14
8474134,2015,6.04,5.41,5,2,65,34,59,158,7,0,2,65,0,49,10
8474138,2015,0.41,0.41,1,0,5,0,1,6,2,1,0,4,35,2,0
8474141,2015,29.35,28.8,41,19,287,80,94,461,106,46,14,241,11,37,34
8474145,2015,2.25,2.21,0,1,47,22,19,88,3,2,4,45,0,93,5
8474150,2015,17.23,16.28,17,9,155,57,62,274,47,21,13,134,539,68,57
8474151,2015,5.31,5.06,16,9,113,62,87,262,34,9,8,104,1,98,31
8474157,2015,32.65,31.47,23,11,303,122,115,540,64,30,31,273,6,102,35
8474161,2015,18.75,17.68,27,17,213,67,107,387,55,11,25,202,3,51,26
8474162,2015,7.65,7.41,15,17,203,94,150,447,40,8,13,195,0,197,13
8474166,2015,7.36,7.11,13,8,124,73,116,313,31,10,8,114,0,164,8
8474168,2015,2.06,1.95,1,1,17,8,5,30,3,1,0,16,32,14,1
8474176,2015,15.66,15.49,15,10,178,58,61,297,39,14,11,164,6,84,30
8474189,2015,13.88,13.69,7,6,149,60,66,275,26,13,6,136,207,111,46
8474190,2015,32.6,30.44,18,10,229,89,75,393,60,32,29,197,5,192,25
8474207,2015,4.85,4.59,8,8,98,37,65,200,22,6,4,92,0,217,21
8474218,2015,5.62,5.42,10,6,95,58,79,232,23,7,5,88,0,86,28
8474230,2015,1.13,1.03,0,0,10,2,3,15,1,1,1,9,11,39,0
8474250,2015,17.51,17.09,7,4,121,55,44,220,36,25,8,96,380,175,33
8474291,2015,9.17,8.82,5,4,74,36,13,123,17,8,4,66,370,55,20
8474497,2015,1.05,0.91,0,1,9,4,4,17,1,0,1,9,0,7,0
8474516,2015,0.18,0.17,0,0,4,1,2,7,0,0,0,4,17,13,0
8474520,2015,3.7,3.4,3,3,99,47,54,200,11,5,8,94,0,88,15
8474554,2015,0.04,0.04,0,0,1,0,0,1,0,0,0,1,0,3,0
8474563,2015,10.93,10.65,18,19,197,107,127,431,51,14,15,183,0,125,10
8474564,2015,26.4,25.93,17,11,216,95,93,404,64,36,9,180,463,109,45
8474565,2015,8.89,8.47,19,11,182,55,82,319,37,7,10,175,0,48,41
8474567,2015,6.09,5.85,6,11,121,39,58,218,24,7,7,114,0,86,17
8474568,2015,2.7,2.62,3,9,76,33,92,201,16,4,9,72,1,234,11
8474569,2015,11.64,11.42,10,8,108,40,36,184,24,6,6,102,14,61,24
8474570,2015,6.43,6.25,4,1,65,30,27,122,8,3,2,62,46,25,7
8474571,2015,16.59,15.88,21,13,166,68,75,309,51,17,19,149,1,51,38
8474573,2015,15.01,14.38,11,9,105,40,45,190,32,12,6,93,14,45,41
8474574,2015,8.4,8.23,7,11,140,55,93,288,27,9,14,131,0,54,45
8474577,2015,10.69,10.7,15,10,100,29,34,163,44,19,7,81,85,122,27
8474578,2015,13.23,12.73,35,31,248,132,206,586,82,16,20,232,0,84,61
8474579,2015,0.91,0.89,3,3,29,10,33,72,8,2,0,27,0,71,5
8474581,2015,7.43,7.11,11,13,122,86,112,320,31,7,9,115,2,87,33
8474584,2015,4.16,3.74,4,5,98,33,83,214,13,4,4,94,0,140,14
8474586,2015,23.13,22.16,12,10,173,60,63,296,47,25,14,148,5,28,30
8474588,2015,6.21,5.97,1,2,41,27,16,84,6,3,6,38,45,54,12
8474589,2015,4.51,4.44,3,5,57,23,22,102,11,3,7,54,2,30,11
8474590,2015,6.22,6.09,17,14,124,58,75,257,39,8,9,116,0,46,24
8474597,2015,1.2,1.14,1,6,40,22,36,98,8,1,1,39,0,31,3
8474600,2015,15.52,14.98,33,14,198,73,127,398,61,14,9,184,0,59,21
8474602,2015,5.01,4.89,6,8,82,41,55,178,18,4,9,78,0,36,21
8474604,2015,0.28,0.29,0,2,8,5,5,18,2,0,0,8,0,4,0
8474605,2015,2.07,2,2,3,56,26,54,136,5,0,3,56,0,53,7
8474610,2015,0.22,0.2,0,0,3,0,0,3,1,1,0,2,11,3,0
8474612,2015,5.71,5.7,5,11,147,70,114,331,21,5,5,142,0,148,44
8474613,2015,17.7,17.1,16,15,192,62,52,306,53,22,12,170,515,38,62
8474616,2015,0.31,0.3,0,0,1,0,1,2,0,0,0,1,3,1,0
8474618,2015,5.43,5.21,7,9,126,64,107,297,21,5,8,121,0,66,23
8474625,2015,16.62,15.32,5,11,127,34,24,185,29,13,9,114,42,128,25
8474627,2015,9.18,8.96,11,14,83,19,38,140,34,9,4,74,485,43,29
8474628,2015,6.55,6.33,15,15,161,85,118,364,36,6,7,155,0,137,15
8474638,2015,0.12,0.11,0,1,1,2,0,3,1,0,0,1,0,5,1
8474641,2015,23.06,21.68,7,13,149,46,43,238,50,30,8,119,617,66,38
8474642,2015,5.51,5.41,3,2,49,17,17,83,7,2,5,47,5,110,6
8474660,2015,1.32,1.28,0,1,40,24,19,83,2,1,3,39,0,5,4
8474661,2015,1.19,1.13,0,0,36,13,27,76,1,1,1,35,0,24,6
8474668,2015,12.28,11.96,8,5,136,34,50,220,27,14,10,122,16,127,18
8474673,2015,6.71,6.55,16,23,79,34,84,197,45,6,4,73,0,15,47
8474679,2015,16.9,16.4,17,9,161,43,58,262,43,17,12,144,0,58,28
8474683,2015,2.63,2.7,0,1,22,7,7,36,1,0,0,22,61,25,3
8474685,2015,12.1,11.64,8,5,114,35,43,192,24,11,5,103,7,91,36
8474688,2015,1.23,1.16,5,1,32,16,37,85,7,1,0,31,0,100,12
8474697,2015,1.11,1.06,1,0,27,14,19,60,2,1,2,26,0,271,3
8474698,2015,0.2,0.2,0,0,7,1,2,10,0,0,0,7,0,4,0
8474709,2015,9.08,9.03,7,2,86,31,25,142,19,10,5,76,1,365,8
8474715,2015,30.92,28.63,19,7,226,79,66,371,53,27,25,199,2,47,43
8474716,2015,7.4,7.22,8,10,122,57,69,248,29,11,10,111,0,51,19
8474717,2015,1.81,1.78,2,6,32,17,39,88,10,2,5,30,0,12,11
8474722,2015,0.03,0.03,0,0,1,2,1,4,0,0,0,1,0,8,0
8474727,2015,2.38,2.29,2,2,17,9,8,34,6,2,1,15,100,18,8
8474736,2015,3.36,3.31,1,1,38,16,10,64,3,1,2,37,0,154,8
8474739,2015,10.61,10.53,7,4,111,44,22,177,18,7,12,104,38,203,21
8474743,2015,1.07,1.05,4,0,22,18,22,62,6,2,4,20,0,47,6
8474744,2015,0.08,0.07,0,0,0,1,0,1,0,0,0,0,0,0,0
8474749,2015,3.91,3.84,5,7,85,37,76,198,18,6,2,79,0,141,18
8474774,2015,1.86,1.84,4,2,69,22,60,151,9,3,2,66,0,139,7
8474818,2015,2.05,1.9,6,3,58,23,42,123,12,3,3,55,0,90,12
8474849,2015,13.16,12.5,10,6,111,54,37,202,29,13,8,98,15,123,30
8474850,2015,3.14,3.2,0,1,25,7,8,40,5,4,2,21,0,62,6
8474870,2015,16.1,15,19,5,167,65,60,292,38,14,13,153,479,46,19
8474884,2015,23.17,21.59,19,11,242,90,133,465,59,29,17,213,8,22,44
8475060,2015,0.09,0.09,0,0,2,2,1,5,0,0,0,2,0,1,0
8475098,2015,12.9,12.28,12,11,99,37,47,183,35,12,10,87,597,46,33
8475119,2015,0.82,0.8,0,0,13,3,7,23,1,1,0,12,33,20,4
8475147,2015,1.84,1.89,1,1,30,7,10,47,4,2,1,28,1,15,1
8475149,2015,16.48,16.25,18,11,132,44,37,213,46,17,11,115,128,38,35
8475150,2015,0.11,0.11,0,0,1,0,1,2,0,0,0,1,0,6,0
8475151,2015,22.14,21.54,16,11,222,78,91,391,57,30,15,192,10,129,43
8475153,2015,0.17,0.17,1,0,9,2,2,13,1,0,0,9,0,6,0
8475155,2015,2,1.94,1,3,32,16,19,67,4,0,2,32,0,67,11
8475157,2015,7.61,7.34,3,2,77,30,25,132,10,5,2,72,29,101,16
8475158,2015,15.79,15.23,24,12,147,41,42,230,56,20,7,127,980,15,47
8475160,2015,5.85,5.67,3,3,68,25,24,117,9,3,5,65,3,111,5
8475161,2015,0.09,0.09,0,0,1,0,1,2,0,0,0,1,0,2,0
8475163,2015,10.04,9.74,5,1,88,33,21,142,14,8,3,80,3,103,26
8475164,2015,20.86,20.21,11,8,215,78,74,367,39,20,16,195,4,87,44
8475165,2015,4.6,4.43,1,1,54,16,23,93,3,1,1,53,378,58,23
8475166,2015,30.34,29.35,31,6,250,83,124,457,70,33,25,217,741,51,69
8475167,2015,11.51,11.2,22,15,181,88,139,408,47,10,15,171,0,62,48
8475168,2015,22.07,21.71,16,13,200,62,63,325,59,30,14,170,428,41,43
8475169,2015,22.36,22.01,9,6,271,91,111,473,35,20,11,251,62,171,37
8475170,2015,28.14,26.88,19,14,178,72,73,323,59,26,9,152,52,187,30
8475171,2015,12.34,12,16,18,228,103,178,509,55,21,21,207,0,154,40
8475172,2015,28.2,27.27,20,8,260,96,129,485,45,17,13,243,641,148,47
8475174,2015,0.94,0.87,2,2,23,12,28,63,4,0,3,23,0,116,7
8475175,2015,8.02,7.79,6,0,88,33,21,142,9,3,5,85,0,44,8
8475176,2015,5.89,5.75,13,9,152,48,97,297,32,10,10,142,0,61,24
8475177,2015,3.52,3.19,7,7,102,43,68,213,16,2,5,100,0,128,19
8475178,2015,4.82,4.68,2,3,42,15,20,77,8,3,2,39,1,95,11
8475179,2015,4.31,4.22,9,7,99,40,50,189,17,1,7,98,0,122,31
8475180,2015,16.61,15.77,13,5,138,59,41,238,27,9,13,129,216,78,34
8475181,2015,6.09,5.96,19,16,121,53,90,264,40,5,9,116,0,83,40
8475182,2015,0.54,0.52,0,2,13,5,7,25,2,0,1,13,0,3,4
8475184,2015,18.85,18.86,13,9,158,62,60,280,43,21,11,137,5,177,23
8475185,2015,9.25,9.13,3,7,86,34,27,147,14,4,7,82,323,67,19
8475186,2015,4.66,4.25,7,8,106,47,65,218,19,4,9,102,0,93,23
8475188,2015,3.71,3.62,6,6,91,54,82,227,14,2,8,89,0,206,19
8475191,2015,19.93,18.38,17,8,173,58,68,299,50,25,13,148,0,85,51
8475192,2015,0.09,0.08,0,0,0,2,1,3,0,0,0,0,0,6,0
8475193,2015,19.68,19.37,10,14,166,62,58,286,45,21,12,145,6,74,30
8475194,2015,0.13,0.13,0,0,5,1,1,7,0,0,0,5,0,3,1
8475197,2015,9.1,8.42,20,16,172,59,122,353,49,13,11,159,0,37,29
8475199,2015,1.93,1.92,3,2,55,24,39,118,6,1,6,54,0,61,7
8475200,2015,4.18,4.13,10,11,90,37,71,198,29,8,4,82,0,121,37
8475204,2015,11.39,10.98,10,5,128,64,79,271,29,14,7,114,66,66,20
8475206,2015,1.76,1.73,3,1,37,10,24,71,6,2,3,35,0,12,4
8475208,2015,4.3,4.13,8,8,101,38,68,207,16,0,9,101,1,77,32
8475209,2015,4.05,3.93,1,1,39,17,10,66,8,6,3,33,1,54,6
8475213,2015,0.07,0.07,1,0,3,0,0,3,1,0,0,3,4,0,1
8475218,2015,6.75,6.23,12,15,114,56,75,245,35,8,9,106,0,67,26
8475220,2015,8.71,8.6,7,6,81,32,24,137,23,10,5,71,1,193,30
8475222,2015,8.58,8.22,13,16,140,57,101,298,38,9,10,131,0,85,34
8475223,2015,5.02,4.89,7,4,40,20,15,75,15,4,1,36,193,4,16
8475225,2015,19.65,19.13,14,2,199,75,73,347,37,21,9,178,76,84,42
8475227,2015,3.71,3.52,4,3,87,22,68,177,13,6,12,81,0,57,5
8475231,2015,9.99,9.78,12,9,84,34,32,150,29,8,3,76,469,158,58
8475233,2015,5.22,5.09,10,11,122,60,76,258,25,4,7,118,0,122,14
8475235,2015,7.02,6.7,2,4,72,34,30,136,12,6,3,66,0,206,14
8475236,2015,15.34,15.2,13,6,133,47,51,231,35,16,7,117,567,98,42
8475246,2015,3.03,2.97,3,9,109,43,78,230,17,5,6,104,0,100,15
8475247,2015,3.37,3.24,1,3,29,6,16,51,7,3,1,26,102,58,8
8475250,2015,11.99,11.67,9,5,105,44,49,198,23,9,15,96,8,27,29
8475253,2015,2.88,2.88,0,0,28,10,8,46,0,0,1,28,0,75,2
8475260,2015,1.36,1.36,3,2,11,6,2,19,7,2,0,9,54,18,6
8475268,2015,2.65,2.62,2,1,25,8,9,42,4,1,0,24,0,55,3
8475274,2015,0.4,0.39,1,0,9,9,4,22,1,0,0,9,0,46,2
8475278,2015,7.19,6.79,3,0,64,29,25,118,5,2,4,62,310,51,20
8475279,2015,3.17,3.06,2,7,75,40,52,167,10,1,2,74,0,130,15
8475287,2015,8.6,8.42,13,7,100,27,37,164,34,14,7,86,416,57,34
8475292,2015,1.31,1.32,0,0,18,2,1,21,6,6,0,12,0,39,6
8475310,2015,0.31,0.3,0,0,3,1,1,5,0,0,1,3,0,4,1
8475314,2015,20.16,19.32,13,8,183,57,42,282,36,15,12,168,1,164,32
8475321,2015,0.23,0.18,2,0,2,0,1,3,3,1,0,1,10,4,1
8475323,2015,4.2,3.98,3,1,50,18,15,83,4,0,3,50,233,25,10
8475325,2015,4.72,4.61,3,2,49,25,23,97,5,0,4,49,0,78,4
8475343,2015,0.22,0.18,0,0,3,2,3,8,0,0,0,3,18,6,3
8475414,2015,0.93,0.94,0,1,13,3,2,18,1,0,0,13,2,15,2
8475430,2015,2.56,2.49,2,4,67,28,54,149,7,1,6,66,0,94,7
8475455,2015,3.67,3.63,5,4,93,40,79,212,11,2,3,91,0,154,12
8475461,2015,0.4,0.39,0,2,3,2,6,11,2,0,0,3,24,8,0
8475462,2015,4.32,4.2,5,4,150,68,122,340,14,5,7,145,0,304,11
8475598,2015,0,0,0,0,0,0,0,0,0,0,0,0,0,0,0
8475613,2015,0.63,0.64,1,2,20,9,16,45,3,0,0,20,0,34,5
8475625,2015,0.05,0.04,0,0,3,1,1,5,0,0,0,3,0,1,0
8475650,2015,2.81,2.77,0,2,56,23,16,95,4,2,1,54,2,117,11
8475661,2015,0.98,0.96,1,2,14,5,2,21,4,1,0,13,3,55,2
8475690,2015,2.3,2.26,6,8,42,19,35,96,18,4,4,38,0,18,14
8475692,2015,14.41,14.05,27,8,166,72,83,321,61,26,9,140,5,88,59
8475714,2015,13.87,13.3,6,8,125,36,32,193,30,16,3,109,366,35,32
8475715,2015,10.43,10.07,9,6,114,41,24,179,28,13,6,101,134,132,16
8475716,2015,1.6,1.55,3,3,55,34,91,180,7,1,3,54,0,37,25
8475722,2015,19.17,18.44,7,3,158,76,46,280,23,13,10,145,1,83,40
8475726,2015,26.9,26.18,16,11,213,102,98,413,58,31,17,182,0,70,32
8475727,2015,14.09,13.5,29,7,162,55,58,275,49,13,8,149,304,53,25
8475728,2015,11.83,11.33,5,2,95,49,47,191,17,10,6,85,388,113,21
8475730,2015,0.59,0.57,0,2,13,10,7,30,3,1,0,12,0,55,6
8475735,2015,1.33,1.29,0,0,14,4,5,23,2,2,0,12,50,20,4
8475736,2015,1,1.05,4,0,13,4,1,18,5,1,0,12,0,46,4
8475738,2015,0.58,0.57,0,0,4,5,2,11,0,0,0,4,33,5,5
8475744,2015,20.46,19.76,43,14,193,58,67,318,77,20,10,173,543,73,61
8475745,2015,18.18,17.82,11,10,140,47,46,233,42,21,5,119,228,131,36
8475747,2015,1.59,1.6,3,5,36,21,25,82,8,0,3,36,0,58,5
8475749,2015,0.27,0.27,2,0,9,0,3,12,2,0,0,9,0,5,1
8475750,2015,1.04,1.01,3,1,30,12,15,57,5,1,2,29,0,48,7
8475753,2015,12.11,11.49,10,11,184,74,137,395,37,16,13,168,0,109,45
8475754,2015,17.49,17.21,7,7,165,49,79,293,40,26,9,139,186,59,48
8475755,2015,1.71,1.68,9,6,53,25,37,115,17,2,5,51,0,157,9
8475756,2015,0.3,0.28,0,0,2,2,0,4,0,0,0,2,0,5,0
8475757,2015,0.03,0.03,0,0,2,0,0,2,0,0,0,2,0,2,0
8475758,2015,8.5,8.37,5,6,94,31,25,150,25,14,8,80,2,105,7
8475759,2015,0.47,0.46,0,1,11,10,11,32,1,0,0,11,0,18,5
8475760,2015,17.04,15.9,14,5,171,49,54,274,34,15,17,156,449,87,25
8475761,2015,3.99,3.95,1,5,52,16,25,93,12,6,5,46,2,65,5
8475762,2015,0.59,0.58,0,1,14,4,12,30,2,1,1,13,0,9,0
8475763,2015,11.51,11.3,14,8,133,56,56,245,36,14,13,119,137,59,24
8475764,2015,4.74,4.48,11,12,113,45,93,251,28,5,13,108,0,43,17
8475765,2015,29.67,28.64,16,18,292,102,157,551,74,40,12,252,0,32,38
8475766,2015,4.98,4.87,4,3,55,16,21,92,10,3,3,52,6,74,11
8475768,2015,7.34,7.39,9,5,63,21,21,105,22,8,5,55,15,26,16
8475769,2015,5.54,5.53,3,2,54,15,13,82,11,6,2,48,3,116,9
8475770,2015,10.82,10.66,6,2,100,35,47,182,15,7,3,93,2,87,20
8475772,2015,14.53,14.38,5,6,128,38,33,199,25,14,7,114,358,72,20
8475774,2015,0.32,0.32,2,0,12,5,5,22,2,0,1,12,0,48,0
8475775,2015,0.03,0.03,0,0,1,1,0,2,0,0,0,1,0,0,1
8475780,2015,3.95,3.89,1,1,55,16,18,89,6,4,6,51,148,95,3
8475782,2015,0.1,0.1,0,0,3,1,3,7,0,0,0,3,0,1,0
8475784,2015,30.13,28.92,20,3,258,80,97,435,51,28,22,230,20,21,77
8475786,2015,5.03,4.76,2,0,37,20,11,68,6,4,2,33,1,31,9
8475788,2015,10.28,10.17,6,8,102,51,51,204,21,7,10,95,205,125,36
8475790,2015,2.6,2.58,3,4,73,34,49,156,9,2,5,71,0,150,11
8475791,2015,31.62,30.34,29,10,286,82,106,474,65,26,13,260,14,82,64
8475792,2015,12.87,12.63,10,6,95,42,34,171,25,9,8,86,14,137,11
8475793,2015,16.69,15.43,25,21,185,52,63,300,60,14,11,171,652,115,38
8475794,2015,31.32,29.55,26,14,278,105,130,513,73,33,15,245,470,80,21
8475795,2015,0.87,0.85,1,1,28,18,23,69,4,2,1,26,0,93,9
8475796,2015,2.38,2.27,6,4,44,27,31,102,11,1,1,43,0,37,9
8475797,2015,0.12,0.12,0,0,3,5,2,10,0,0,0,3,0,22,1
8475798,2015,19.49,18.4,25,6,160,51,61,272,44,13,22,147,528,86,51
8475799,2015,21.1,20.81,13,10,159,62,48,269,43,20,9,139,11,129,35
8475800,2015,6.6,6.31,3,3,65,39,31,135,12,6,4,59,0,5,12
8475807,2015,10.95,10.39,8,6,81,53,37,171,24,10,5,71,6,98,26
8475808,2015,1.39,1.3,0,1,10,0,2,12,2,1,2,9,49,13,0
8475810,2015,7.34,7.37,4,3,68,28,18,114,11,4,3,64,1,62,10
8475815,2015,0.26,0.25,0,0,12,4,5,21,0,0,0,12,0,18,2
8475816,2015,2.9,2.88,3,0,30,16,10,56,3,0,1,30,0,14,6
8475820,2015,14.52,14.11,16,9,107,43,39,189,36,11,9,96,2,31,33
8475829,2015,0,0,0,0,0,0,0,0,0,0,0,0,0,0,0
8475832,2015,6.01,5.93,7,3,52,17,10,79,15,5,2,47,0,57,5
8475836,2015,0.1,0.09,0,0,1,0,1,2,0,0,0,1,0,1,1
8475842,2015,0.25,0.25,0,0,4,0,0,4,0,0,0,4,1,4,0
8475844,2015,0.17,0.17,0,0,3,0,0,3,0,0,0,3,0,3,2
8475848,2015,22.47,21.05,12,9,173,42,60,275,40,19,20,154,12,43,30
8475855,2015,9.91,9.81,10,10,75,37,29,141,30,10,0,65,1,109,35
8475857,2015,0.13,0.13,0,0,2,6,4,12,0,0,0,2,0,4,0
8475868,2015,0.88,0.84,1,4,19,11,11,41,6,1,1,18,0,62,2
8475869,2015,2.86,2.78,2,5,63,39,64,166,11,4,5,59,0,74,19
8475878,2015,0.78,0.78,1,0,7,0,3,10,2,1,1,6,12,8,1
8475902,2015,1.69,1.67,2,3,60,17,46,123,7,2,3,58,0,71,2
8475906,2015,11.64,10.57,21,27,171,63,131,365,58,10,18,161,0,44,36
8475907,2015,11.49,11.02,7,7,122,38,29,189,18,4,9,118,7,207,37
8475913,2015,22.54,21.39,21,17,151,65,56,272,61,23,8,128,8,55,128
8475949,2015,0.33,0.35,0,1,3,0,2,5,1,0,0,3,3,6,0
8475958,2015,0,0,0,0,0,0,0,0,0,0,0,0,2,0,0
8475980,2015,0.54,0.54,0,0,7,2,0,9,0,0,0,7,9,21,1
8476043,2015,0.43,0.42,0,0,8,1,1,10,0,0,0,8,26,6,0
8476062,2015,2.58,2.5,0,1,43,13,14,70,4,3,3,40,132,22,9
8476116,2015,10.5,10.48,7,0,134,60,46,240,14,7,6,127,1,163,12
8476147,2015,0.17,0.18,0,0,1,0,0,1,0,0,0,1,5,4,1
8476158,2015,0.15,0.16,0,0,1,0,0,1,0,0,0,1,0,3,0
8476166,2015,0,0,1,0,0,0,0,0,1,0,0,0,0,3,0
8476177,2015,15.86,15.54,8,7,127,61,27,215,26,11,8,116,24,81,34
8476191,2015,2.66,2.68,6,7,69,38,53,160,18,5,3,64,0,165,13
8476200,2015,0.05,0.05,0,0,3,0,1,4,0,0,0,3,0,3,1
8476209,2015,2.76,2.75,0,1,29,18,6,53,4,3,1,26,0,25,3
8476235,2015,5.57,5.5,7,4,54,25,17,96,16,5,7,49,1,9,17
8476279,2015,1.39,1.38,6,4,45,14,39,98,12,2,4,43,0,69,14
8476288,2015,3.07,3.02,2,4,23,9,14,46,9,3,0,20,2,54,6
8476289,2015,1.88,1.89,5,4,40,28,39,107,11,2,3,38,0,47,7
8476292,2015,12.87,12.71,16,8,117,42,55,214,40,16,9,101,2,108,32
8476293,2015,3.08,2.97,1,0,39,10,10,59,6,5,3,34,0,38,5
8476300,2015,3.43,3.38,4,2,57,30,55,142,9,3,5,54,0,95,8
8476302,2015,1.83,1.8,2,3,46,28,38,112,6,1,6,45,0,46,2
8476312,2015,5.88,5.75,3,7,88,38,45,171,15,5,7,83,0,158,18
8476323,2015,2.47,2.38,0,2,37,8,9,54,4,2,2,35,39,46,8
8476326,2015,0,0,0,0,0,0,1,1,0,0,0,0,0,1,0
8476331,2015,1.94,1.9,1,1,42,19,36,97,4,2,2,40,0,39,8
8476336,2015,7.4,7.15,5,3,76,32,32,140,13,5,8,71,5,152,10
8476344,2015,0.13,0.13,0,0,2,1,3,6,0,0,0,2,13,1,2
8476346,2015,22.75,21.21,31,17,217,70,84,371,78,30,14,187,2,26,41
8476352,2015,1.84,1.84,1,1,23,9,1,33,3,1,1,22,1,26,3
8476356,2015,20.35,19.62,14,9,189,79,81,349,37,14,16,175,10,54,31
8476368,2015,0.51,0.49,0,2,15,6,14,35,2,0,2,15,0,33,9
8476370,2015,0.96,0.91,1,0,10,1,4,15,2,1,0,9,0,19,0
8476379,2015,0.41,0.4,2,2,13,5,6,24,5,1,3,12,0,38,3
8476381,2015,18.4,17.45,8,12,153,58,64,275,34,14,8,139,146,148,21
8476384,2015,0.1,0.1,0,0,1,3,2,6,0,0,0,1,0,7,0
8476386,2015,7.45,7.15,6,5,88,27,40,155,17,6,6,82,4,24,19
8476388,2015,0.3,0.28,0,0,11,6,10,27,0,0,0,11,0,40,0
8476389,2015,20.33,19.9,17,11,175,65,60,300,53,25,19,150,547,125,43
8476392,2015,8.46,8.04,6,4,73,21,27,121,17,7,9,66,391,187,33
8476393,2015,4.67,4.6,2,3,41,10,16,67,11,6,2,35,109,38,18
8476394,2015,0.03,0.02,0,0,2,0,0,2,0,0,0,2,0,0,0
8476400,2015,8.01,7.52,1,1,72,25,15,112,7,5,2,67,16,88,21
8476401,2015,0.64,0.49,0,0,7,1,0,8,0,0,0,7,2,22,2
8476403,2015,1.72,1.69,2,4,64,28,45,137,8,2,2,62,0,178,10
8476404,2015,5.43,5.32,2,0,46,21,22,89,10,8,3,38,134,82,12
8476406,2015,8.73,8.39,5,2,90,34,31,155,10,3,7,87,384,97,13
8476409,2015,0.74,0.72,0,0,5,5,2,12,1,1,0,4,16,3,1
8476410,2015,2.77,2.73,0,0,20,9,9,38,5,5,0,15,1,7,4
8476414,2015,1.14,1.12,0,0,9,3,1,13,0,0,1,9,1,5,3
8476415,2015,1.51,1.49,0,0,15,8,5,28,0,0,2,15,0,4,3
8476419,2015,15.93,15.3,15,9,133,32,47,212,43,19,9,114,614,166,30
8476422,2015,1.31,1.26,2,4,27,6,18,51,7,1,2,26,0,3,2
8476423,2015,6.34,6.08,7,4,74,25,24,123,19,8,4,66,1,32,9
8476427,2015,1.55,1.5,2,0,16,6,2,24,6,4,1,12,0,6,2
8476428,2015,2.31,2.3,0,2,29,8,11,48,5,3,0,26,47,17,10
8476429,2015,0.1,0.1,0,0,4,2,6,12,1,1,0,3,0,12,0
8476430,2015,4.17,4.15,2,0,43,15,18,76,6,4,2,39,1,50,6
8476431,2015,1.52,1.49,1,5,43,17,23,83,7,1,0,42,0,19,5
8476432,2015,28.63,26.63,12,7,225,56,63,344,49,30,28,195,156,213,39
8476435,2015,0.21,0.21,0,0,4,2,4,10,0,0,0,4,0,2,0
8476436,2015,9.12,9.11,5,4,92,30,37,159,13,4,12,88,8,126,21
8476437,2015,18.51,17.58,10,17,160,75,60,295,48,21,10,139,479,32,42
8476438,2015,28.38,27.26,11,11,233,79,84,396,53,31,13,202,19,43,33
8476439,2015,1.07,1.08,0,1,15,5,5,25,1,0,2,15,0,30,2
8476440,2015,6.45,6.28,4,0,56,28,29,113,10,6,0,50,202,31,19
8476441,2015,3.52,3.52,4,4,90,43,54,187,9,1,9,89,0,165,7
8476442,2015,9.4,9.16,4,5,90,27,34,151,17,8,5,82,2,33,17
8476443,2015,0.34,0.34,1,0,4,3,3,10,1,0,0,4,0,5,3
8476447,2015,7.1,6.96,2,3,61,30,30,121,10,5,5,56,2,164,17
8476448,2015,11.34,10.89,6,5,108,38,33,179,20,9,4,99,416,40,42
8476449,2015,0.42,0.39,0,1,9,8,14,31,1,0,1,9,0,23,1
8476451,2015,1.32,1.25,0,1,14,4,6,24,2,1,0,13,0,24,2
8476452,2015,0.44,0.44,0,1,9,6,15,30,1,0,1,9,0,14,1
8476453,2015,22.99,22.4,25,11,209,82,111,402,66,30,18,179,0,61,34
8476454,2015,11.65,11.05,15,7,109,38,68,215,34,12,5,97,369,39,43
8476455,2015,15.22,14.53,18,15,170,41,39,250,53,20,14,150,31,141,37
8476456,2015,24.18,23,21,18,175,51,44,270,59,20,17,155,7,53,32
8476457,2015,3.52,3.47,6,9,65,38,51,154,18,3,5,62,0,163,22
8476458,2015,12.48,12.01,11,9,132,44,44,220,28,8,9,124,39,77,35
8476459,2015,22.02,20.66,16,14,184,81,66,331,51,21,20,163,659,111,39
8476460,2015,24.36,23.58,20,12,194,69,57,320,61,29,16,165,515,53,61
8476461,2015,14.32,13.47,16,12,119,30,51,200,39,11,9,108,537,31,27
8476462,2015,10,9,11,20,190,80,111,381,43,12,13,178,0,78,15
8476463,2015,2.12,2.12,3,2,58,31,52,141,7,2,4,56,0,34,27
8476465,2015,2.58,2.25,5,5,47,18,34,99,10,0,4,47,0,25,11
8476466,2015,11.8,11.46,8,5,108,43,37,188,28,15,3,93,0,30,26
8476467,2015,0.68,0.65,1,1,13,6,9,28,2,0,2,13,0,54,4
8476468,2015,13.05,12.72,12,9,135,51,67,253,43,22,8,113,68,174,40
8476469,2015,4.87,4.83,3,3,52,17,28,97,10,4,1,48,0,59,23
8476470,2015,3.53,3.5,8,9,74,25,45,144,19,2,7,72,0,59,17
8476471,2015,0,0,0,0,0,0,1,1,0,0,0,0,0,3,1
8476472,2015,2.1,2.07,4,4,48,29,27,104,12,4,4,44,0,21,10
8476473,2015,3.84,3.8,4,7,101,51,92,244,17,6,7,95,0,175,21
8476474,2015,0,0,0,0,0,0,0,0,0,0,0,0,0,3,0
8476476,2015,1.28,1.25,3,3,44,9,28,81,7,1,3,43,0,28,9
8476477,2015,2.81,2.62,0,1,26,11,15,52,3,2,1,24,1,18,6
8476478,2015,0.04,0.03,0,0,1,1,3,5,0,0,0,1,0,4,1
8476479,2015,6.4,6.3,2,4,72,26,25,123,10,4,6,68,247,45,18
8476480,2015,11.25,11.11,11,10,106,35,36,177,35,14,12,92,175,49,15
8476483,2015,18.31,18.04,13,10,170,77,61,308,43,20,10,150,197,121,29
8476495,2015,0.07,0.07,0,1,2,1,1,4,1,0,0,2,0,4,0
8476505,2015,0,0,0,1,0,0,0,0,1,0,0,0,0,2,0
8476525,2015,2.19,2.15,6,7,54,27,44,125,16,3,1,51,0,44,5
8476539,2015,9.14,8.83,3,8,81,29,24,134,18,7,10,74,38,61,10
8476545,2015,0.01,0.01,0,0,1,0,0,1,0,0,0,1,0,4,1
8476624,2015,0.59,0.59,2,1,7,5,0,12,3,0,1,7,4,8,3
8476766,2015,0.53,0.5,0,0,5,2,0,7,0,0,0,5,0,3,0
8476769,2015,4.9,4.83,1,1,50,23,13,86,10,8,2,42,2,93,11
8476772,2015,1.72,1.64,1,1,14,4,6,24,2,0,1,14,2,36,4
8476779,2015,0.36,0.34,0,0,12,4,10,26,0,0,0,12,0,7,2
8476792,2015,10.93,10.46,26,14,244,98,149,491,44,4,17,240,2,61,20
8476806,2015,11.91,11.5,10,4,140,49,49,238,22,8,15,132,23,103,21
8476807,2015,1.3,1.27,1,2,23,13,27,63,4,1,1,22,0,23,1
8476808,2015,5.08,5.03,3,3,73,19,16,108,10,4,5,69,200,23,20
8476819,2015,0,0,0,0,0,0,1,1,0,0,0,0,1,4,1
8476822,2015,12.45,12.29,6,7,88,39,25,152,21,8,5,80,614,143,20
8476826,2015,0.12,0.13,1,0,0,1,0,1,1,0,0,0,0,2,0
8476850,2015,4.1,3.84,8,13,90,34,74,198,25,4,10,86,0,51,17
8476851,2015,23.17,22.09,16,10,201,80,79,360,56,30,14,171,359,62,31
8476852,2015,1.16,1.1,0,1,24,10,27,61,1,0,1,24,0,62,6
8476853,2015,8.79,8.39,8,19,167,120,136,423,36,9,11,158,0,58,35
8476854,2015,9.68,9.15,8,10,149,62,105,316,28,10,15,139,0,68,18
8476855,2015,11.54,11.09,6,9,127,32,61,220,23,8,14,119,0,54,27
8476856,2015,9.06,8.63,11,5,152,72,104,328,26,10,10,142,0,83,13
8476858,2015,6.98,6.84,7,3,68,32,20,120,17,7,2,61,7,113,17
8476867,2015,3.91,3.6,0,0,34,9,9,52,1,1,2,33,49,34,11
8476869,2015,0.31,0.31,0,0,6,3,8,17,0,0,0,6,0,11,4
8476870,2015,2.23,2.18,0,1,27,11,15,53,2,1,3,26,0,67,2
8476871,2015,14.86,14.57,14,7,137,64,64,265,36,15,6,122,8,104,27
8476872,2015,7.24,7.18,7,7,85,25,35,145,21,7,9,78,170,86,23
8476874,2015,4.13,4.09,7,6,95,35,60,190,19,6,5,89,0,81,8
8476875,2015,0.21,0.19,0,0,4,1,3,8,0,0,0,4,0,1,1
8476878,2015,10.74,10.11,9,2,110,31,38,179,18,7,8,103,153,125,16
8476879,2015,5.8,5.66,8,8,116,44,72,232,26,10,7,106,0,70,15
8476880,2015,10.24,10.06,13,3,99,40,50,189,23,7,7,92,8,253,16
8476881,2015,23.91,23.5,12,13,202,66,80,348,46,21,14,181,256,90,35
8476882,2015,13.02,12.63,16,6,136,47,62,245,35,13,3,123,125,24,35
8476884,2015,1.72,1.73,2,5,25,10,25,60,7,0,0,25,0,16,6
8476885,2015,6.98,6.75,9,6,133,44,106,283,21,6,11,127,0,144,29
8476886,2015,0.43,0.41,1,0,11,5,6,22,1,0,1,11,0,6,3
8476887,2015,29.82,28.05,14,17,247,128,115,490,64,33,15,214,2,114,72
8476888,2015,7.07,6.64,13,8,84,32,27,143,27,6,6,78,151,23,21
8476889,2015,9.35,9.26,2,5,67,33,16,116,12,5,7,62,197,48,20
8476890,2015,0.01,0.01,0,0,1,0,2,3,1,1,0,0,0,3,0
8476892,2015,6.38,6.29,14,10,165,74,111,350,33,9,15,156,0,102,33
8476894,2015,0.67,0.68,2,0,11,4,4,19,3,1,1,10,2,12,3
8476897,2015,1.1,1.11,2,1,13,6,2,21,4,1,1,12,64,18,6
8476902,2015,0.05,0.05,0,0,2,2,5,9,0,0,0,2,0,4,0
8476905,2015,0.43,0.45,0,0,2,1,1,4,0,0,0,2,30,5,3
8476906,2015,10.69,10.19,14,15,152,79,110,341,46,17,10,135,1,27,28
8476910,2015,0.9,0.79,2,1,9,2,1,12,3,0,1,9,0,7,1
8476913,2015,0.38,0.34,0,0,1,0,1,2,0,0,1,1,0,2,0
8476915,2015,1.63,1.61,2,0,14,6,10,30,2,0,0,14,0,29,6
8476917,2015,0.19,0.19,2,0,8,2,8,18,2,0,0,8,0,16,1
8476919,2015,12.08,11.71,10,3,96,30,18,144,20,7,8,89,368,24,31
8476921,2015,13.11,12.57,12,3,109,53,45,207,24,9,15,100,18,52,52
8476923,2015,4.96,4.83,11,9,94,47,60,201,21,1,3,93,0,66,16
8476925,2015,2.44,2.39,0,2,25,9,10,44,6,4,0,21,141,35,7
8476931,2015,2.56,2.5,7,3,62,32,52,146,14,4,2,58,0,114,17
8476934,2015,2.08,2.09,0,1,25,7,3,35,4,3,2,22,0,28,4
8476941,2015,1.53,1.43,1,1,21,16,22,59,4,2,0,19,0,38,6
8476944,2015,0.29,0.28,0,0,5,0,0,5,0,0,0,5,0,3,1
8476948,2015,0.31,0.3,1,1,3,4,0,7,2,0,1,3,0,7,2
8476953,2015,0.06,0.06,0,0,3,1,2,6,0,0,0,3,0,1,4
8476955,2015,0.66,0.65,0,0,3,2,4,9,0,0,0,3,0,2,3
8476958,2015,4.21,3.9,7,11,84,41,60,185,20,2,7,82,0,41,54
8476960,2015,5.48,5.37,2,3,53,18,14,85,14,9,2,44,53,17,11
8476967,2015,0.24,0.23,0,0,9,3,6,18,0,0,1,9,0,2,3
8476975,2015,5.17,4.98,2,3,50,25,25,100,11,6,3,44,141,137,16
8476979,2015,1.65,1.6,7,7,58,24,48,130,14,0,1,58,0,29,9
8476981,2015,1.35,1.31,0,3,11,5,6,22,4,1,1,10,0,40,4
8476989,2015,0.13,0.12,0,0,9,5,10,24,0,0,0,9,0,14,2
8476994,2015,0.46,0.48,0,0,6,3,1,10,0,0,0,6,13,2,3
8477006,2015,0.1,0.1,0,0,3,1,0,4,0,0,0,3,0,7,0
8477010,2015,6.67,6.27,9,3,43,22,16,81,17,5,5,38,11,39,19
8477015,2015,0.71,0.69,3,2,11,3,6,20,6,1,1,10,0,1,4
8477018,2015,4.35,4.31,12,12,104,43,90,237,25,1,5,103,0,42,30
8477033,2015,0.08,0.07,0,2,1,4,2,7,2,0,0,1,0,8,0
8477076,2015,0.2,0.2,0,1,4,0,3,7,1,0,0,4,0,29,1
8477126,2015,1.2,1.16,0,1,9,6,6,21,2,1,0,8,1,6,1
8477205,2015,2.68,2.68,5,12,65,34,42,141,21,4,3,61,0,29,16
8477210,2015,0.37,0.39,0,1,5,0,2,7,2,1,0,4,0,11,0
8477213,2015,1.22,1.21,1,1,18,4,4,26,3,1,0,17,40,13,3
8477215,2015,3,2.98,7,5,72,30,43,145,20,8,6,64,0,88,17
8477220,2015,4.39,4.33,8,6,80,46,58,184,16,2,6,78,0,69,34
8477244,2015,0.04,0.04,0,0,1,0,1,2,0,0,0,1,0,3,0
8477249,2015,0.51,0.48,0,0,3,1,0,4,0,0,0,3,13,4,1
8477290,2015,17.75,17.16,10,8,132,61,46,239,31,13,10,119,33,135,31
8477300,2015,1.18,1.17,0,2,40,14,35,89,4,2,3,38,0,11,7
8477326,2015,0.2,0.2,0,1,1,2,2,5,1,0,0,1,1,6,0
8477392,2015,1.12,1.16,1,0,9,5,1,15,2,1,0,8,0,8,4
8477406,2015,12.87,12.27,10,4,108,51,53,212,29,15,9,93,94,4,26
8477407,2015,16.91,15.65,13,11,105,51,29,185,44,20,13,85,0,27,26
8477413,2015,6.65,6.38,5,5,74,27,30,131,17,7,5,67,3,71,9
8477415,2015,0.7,0.7,1,0,5,4,7,16,1,0,0,5,1,13,2
8477416,2015,2.6,2.63,2,2,25,7,12,44,8,4,2,21,0,9,6
8477425,2015,0.12,0.12,0,0,2,0,0,2,0,0,0,2,0,1,0
8477426,2015,3,2.89,2,1,28,11,12,51,5,2,3,26,31,43,9
8477427,2015,0.79,0.75,1,1,12,6,7,25,2,0,0,12,0,10,2
8477429,2015,6.36,6.3,4,2,55,14,21,90,13,7,2,48,224,87,10
8477433,2015,0.08,0.08,1,0,3,1,0,4,1,0,0,3,0,9,0
8477444,2015,13.39,13.13,8,13,126,50,62,238,38,17,13,109,17,37,34
8477445,2015,1.94,1.78,0,1,12,7,4,23,3,2,1,10,0,9,1
8477446,2015,3.59,3.3,1,0,41,8,7,56,2,1,6,40,85,49,4
8477447,2015,2,1.81,3,2,28,12,21,61,8,3,0,25,0,6,10
8477448,2015,5.05,4.83,1,4,54,21,17,92,10,5,2,49,2,62,10
8477450,2015,0.27,0.27,0,0,2,0,1,3,1,1,0,1,1,0,0
8477451,2015,0.2,0.17,1,0,3,4,3,10,1,0,0,3,1,5,3
8477453,2015,1.59,1.36,0,2,21,14,12,47,3,1,2,20,0,17,4
8477455,2015,1.66,1.65,1,0,20,12,13,45,1,0,0,20,67,39,6
8477460,2015,0.97,0.94,0,0,7,3,6,16,1,1,1,6,32,6,3
8477463,2015,0.04,0.04,0,0,1,0,0,1,0,0,0,1,0,0,0
8477464,2015,3.59,3.46,2,2,25,15,12,52,6,2,3,23,12,7,11
8477467,2015,0.24,0.19,0,0,1,2,2,5,0,0,0,1,0,2,0
8477473,2015,2.12,1.89,0,0,22,3,3,28,0,0,3,22,0,8,4
8477486,2015,0.39,0.41,0,0,3,4,1,8,0,0,0,3,0,4,1
8477488,2015,4.33,4.16,4,8,85,44,51,180,16,4,12,81,0,30,43
8477492,2015,24.14,23.54,15,16,245,92,80,417,52,21,22,224,507,46,28
8477493,2015,20.38,19.27,19,12,171,47,37,255,59,28,10,143,569,43,45
8477494,2015,2.66,2.48,4,2,25,15,16,56,10,4,0,21,9,18,8
8477495,2015,6.77,6.5,12,16,157,66,121,344,31,3,11,154,0,86,25
8477496,2015,17.86,17.33,15,13,176,60,59,295,39,11,14,165,213,112,33
8477497,2015,27.78,26.64,25,11,197,72,67,336,63,27,17,170,887,38,55
8477498,2015,4.52,4.52,3,4,120,52,69,241,10,3,3,117,0,160,13
8477499,2015,8.87,8.49,15,17,202,61,133,396,41,9,12,193,0,139,20
8477500,2015,16.83,16.36,13,11,155,43,47,245,40,16,9,139,760,69,27
8477501,2015,15.12,14.6,10,10,139,58,50,247,29,9,9,130,0,68,33
8477503,2015,16.81,15.97,24,10,156,61,80,297,52,18,10,138,20,34,28
8477504,2015,0.01,0.01,0,0,1,0,0,1,0,0,0,1,0,1,0
8477505,2015,12.87,11.02,23,9,97,41,32,170,40,8,12,89,400,32,42
8477506,2015,0.53,0.52,1,1,15,13,13,41,4,2,0,13,0,13,3
8477507,2015,0.97,0.98,2,0,18,10,15,43,2,0,1,18,0,53,6
8477508,2015,11.72,11.44,10,4,78,33,30,141,20,6,6,72,168,118,24
8477509,2015,0.34,0.33,0,0,8,3,8,19,0,0,0,8,0,2,1
8477510,2015,4.16,3.94,6,1,32,11,12,55,9,2,5,30,1,39,9
8477511,2015,1.75,1.72,0,1,18,6,5,29,3,2,0,16,0,4,4
8477512,2015,0.6,0.57,1,0,3,4,0,7,1,0,0,3,52,10,1
8477527,2015,0,0,0,0,0,0,0,0,0,0,0,0,0,6,2
8477566,2015,0.13,0.14,1,0,1,0,2,3,1,0,0,1,0,1,1
8477589,2015,0.53,0.5,0,0,6,4,3,13,0,0,0,6,1,19,3
8477591,2015,6.88,6.55,3,6,80,20,29,129,13,4,8,76,114,62,14
8477642,2015,0.19,0.19,0,0,7,3,8,18,0,0,0,7,0,9,1
8477715,2015,0.57,0.55,1,1,6,5,3,14,3,1,0,5,43,23,2
8477810,2015,0.28,0.28,3,3,10,5,2,17,6,0,0,10,0,6,2
8477816,2015,0.3,0.3,1,0,2,1,0,3,1,0,0,2,6,7,0
8477839,2015,5.26,5.25,2,1,51,14,24,89,10,7,2,44,1,15,7
8477845,2015,3.91,3.75,7,4,85,37,72,194,14,3,7,82,0,44,17
8477846,2015,0,0,0,0,0,0,0,0,0,0,0,0,0,1,0
8477850,2015,0.32,0.32,2,2,14,5,17,36,4,0,2,14,0,38,4
8477851,2015,1.12,1.05,3,2,24,8,19,51,5,0,3,24,0,11,8
8477887,2015,1.18,0.95,0,1,8,4,1,13,2,1,4,7,0,11,2
8477901,2015,5.31,5.09,0,3,39,22,15,76,9,6,1,33,0,25,7
8477902,2015,0.89,0.91,0,0,9,3,4,16,0,0,2,9,0,11,0
8477903,2015,1.38,1.36,3,0,11,5,3,19,3,0,0,11,1,50,4
8477916,2015,0.09,0.09,0,0,1,1,1,3,0,0,0,1,0,1,1
8477922,2015,11.12,10.31,6,3,96,45,26,167,19,10,6,86,11,76,24
8477923,2015,0,0,0,0,0,0,0,0,0,0,0,0,0,1,0
8477929,2015,4.04,4.02,1,4,42,11,14,67,9,4,4,38,144,36,7
8477930,2015,10.23,9.77,6,1,102,49,48,199,14,7,7,95,272,65,37
8477931,2015,0.1,0.1,0,0,2,1,2,5,0,0,0,2,4,6,3
8477932,2015,9.61,9.36,8,13,182,58,84,324,36,15,8,167,0,87,24
8477933,2015,22.2,21.05,13,6,165,58,52,275,42,23,8,142,36,26,19
8477934,2015,15.94,15.21,16,16,133,43,38,214,51,19,15,114,502,38,40
8477935,2015,17.18,16.27,12,6,136,44,60,240,36,18,12,118,160,110,34
8477937,2015,7.8,7.65,5,1,94,42,38,174,13,7,4,87,2,128,22
8477939,2015,4.78,4.5,5,2,43,28,28,99,13,6,4,37,143,5,16
8477940,2015,15.04,14.77,16,7,167,73,64,304,38,15,10,152,0,29,20
8477941,2015,3.78,3.84,1,1,55,24,22,101,4,2,4,53,1,93,8
8477942,2015,0.86,0.89,0,0,11,5,3,19,1,1,0,10,0,2,0
8477946,2015,18.86,18.44,16,6,221,80,89,390,45,23,6,198,41,65,43
8477947,2015,0.13,0.12,1,0,2,3,0,5,1,0,1,2,0,4,1
8477952,2015,12.77,12.82,8,11,114,41,38,193,37,18,6,96,6,51,27
8477953,2015,1.69,1.43,0,0,14,3,6,23,0,0,0,14,0,10,4
8477955,2015,8.64,8.66,4,5,106,36,57,199,18,9,3,97,181,45,30
8477956,2015,8.78,8.51,6,5,108,28,38,174,26,15,6,93,0,52,35
8477958,2015,0.79,0.82,1,0,7,6,3,16,2,1,2,6,0,0,3
8477997,2015,1.21,1.13,0,1,11,13,11,35,2,1,0,10,0,31,1
8478004,2015,0,0,0,0,0,0,0,0,0,0,0,0,0,1,0
8478029,2015,0.08,0.08,0,0,2,0,0,2,0,0,0,2,1,3,0
8478042,2015,10.48,10.21,5,3,139,37,52,228,16,8,9,131,0,27,15
8478137,2015,3.63,3.54,2,3,49,15,22,86,6,1,1,48,2,50,14
8478366,2015,8.49,8.29,2,1,99,25,26,150,11,8,6,91,0,61,16
8478373,2015,3.04,2.88,1,2,33,9,11,53,5,2,0,31,0,34,2
8478393,2015,0,0,0,0,1,0,0,1,0,0,0,1,0,3,0
8478396,2015,6.07,5.95,15,3,122,57,101,280,22,4,8,118,0,67,42
8478401,2015,0.27,0.26,1,1,3,1,0,4,2,0,0,3,3,1,2
8478402,2015,14.94,14.32,16,16,105,32,19,156,48,16,8,89,249,12,33
8478403,2015,20.18,19.81,22,10,238,90,106,434,56,24,13,214,402,43,43
8478420,2015,0.64,0.62,0,0,9,2,6,17,0,0,0,9,13,0,1
8478430,2015,0.02,0.02,0,0,1,0,1,2,0,0,0,1,0,0,0
8478466,2015,1.2,1.17,0,0,23,8,12,43,2,2,2,21,1,14,4
8478528,2015,2.19,2.11,2,0,26,7,9,42,3,1,5,25,55,19,8
8478541,2015,0.04,0.04,0,0,3,0,0,3,0,0,0,3,0,7,1
8478542,2015,0.36,0.34,0,1,8,2,2,12,2,1,0,7,0,3,0
8478550,2015,21.47,21.44,29,18,187,64,82,333,77,30,8,157,0,46,29
8478561,2015,4.32,4.2,4,3,52,23,15,90,11,4,2,48,1,155,11
8478562,2015,1.49,1.46,1,2,42,17,29,88,5,2,1,40,0,41,4
8478563,2015,4.75,4.4,4,4,71,44,74,189,12,4,5,67,0,38,13
8478564,2015,2.53,2.47,2,1,35,7,10,52,5,2,4,33,227,36,28
8478566,2015,10.34,9.74,3,4,70,30,22,122,15,8,5,62,134,146,25
8478567,2015,0.13,0.12,0,0,3,2,1,6,0,0,0,3,0,7,4
8478569,2015,1.55,1.52,1,0,18,6,4,28,1,0,0,18,60,52,1
8478584,2015,0.17,0.17,0,0,6,2,1,9,0,0,0,6,0,12,0
8478585,2015,0.7,0.7,0,0,5,0,4,9,2,2,0,3,35,2,4
8478866,2015,0.38,0.35,1,0,2,0,0,2,1,0,0,2,0,1,0
8478928,2015,3.33,3.28,2,1,41,21,16,78,3,0,2,41,1,107,12
8478963,2015,0.02,0.02,0,0,1,0,4,5,0,0,0,1,0,2,0
8479268,2015,0.11,0.11,1,3,5,2,7,14,4,0,0,5,0,5,1
8479293,2015,0.21,0.21,0,0,4,2,5,11,0,0,0,4,0,7,0
8448208,2014,20.68,19.64,21,9,169,57,74,300,47,17,15,152,1,30,38
8458951,2014,1.72,1.69,6,7,46,30,47,123,14,1,2,45,1,45,5
8459670,2014,0.16,0.16,0,0,10,1,6,17,0,0,0,10,0,15,0
8460542,2014,13.06,12.77,12,9,114,47,36,197,34,13,6,101,263,23,18
8460626,2014,0.33,0.34,2,0,13,4,10,27,2,0,1,13,0,22,1
8460720,2014,1.12,1.07,0,0,9,2,2,13,2,2,1,7,0,10,1
8462038,2014,19.81,18.9,16,6,189,67,59,315,36,14,19,175,3,189,43
8462042,2014,18.52,18.12,23,7,189,56,105,350,59,29,12,160,57,99,31
8462196,2014,1.25,1.22,1,5,34,23,31,88,7,1,3,33,0,141,8
8464956,2014,0.74,0.74,2,1,29,12,28,69,3,0,0,29,0,70,7
8464975,2014,6.75,6.49,1,3,69,27,17,113,12,8,4,61,13,19,23
8464977,2014,6.47,6.43,4,2,72,20,13,105,10,4,8,68,37,99,19
8464989,2014,8.87,8.68,7,11,90,40,32,162,25,7,2,83,155,10,26
8465009,2014,7.62,7.11,5,7,138,40,76,254,20,8,3,130,1,125,14
8465058,2014,2.1,1.91,4,8,56,24,56,136,13,1,4,55,0,103,17
8465166,2014,4.43,4.33,3,3,51,13,12,76,7,1,1,50,17,183,6
8465185,2014,2.78,2.69,2,3,78,31,74,183,8,3,4,75,0,99,17
8465951,2014,2.73,2.71,3,3,24,7,17,48,10,4,1,20,3,39,11
8465978,2014,3.69,3.57,1,3,53,15,17,85,5,1,1,52,3,93,10
8466138,2014,15.47,15.15,28,21,131,56,71,258,65,16,12,115,554,39,60
8466139,2014,28.52,26.29,21,17,233,76,103,412,57,19,21,214,171,85,44
8466140,2014,7.89,7.79,6,0,110,38,34,182,10,4,6,106,134,64,11
8466142,2014,1.71,1.66,3,5,33,21,36,90,11,3,2,30,0,87,8
8466148,2014,26.79,26.16,21,18,247,73,130,450,61,22,16,225,4,62,68
8466149,2014,0.71,0.74,0,1,17,5,6,28,2,1,1,16,2,21,2
8466158,2014,2.09,2.06,3,2,53,16,27,96,7,2,4,51,0,32,8
8466160,2014,5.31,5.07,4,1,28,19,13,60,8,3,3,25,0,112,11
8466251,2014,8.46,8.45,9,3,96,39,44,179,19,7,5,89,43,132,27
8466285,2014,4.76,4.67,13,11,118,38,63,219,27,3,4,115,0,44,16
8466333,2014,2.42,2.31,0,11,58,47,60,165,14,3,5,55,0,156,12
8466378,2014,20.5,19.22,19,12,144,52,45,241,52,21,7,123,51,13,41
8466393,2014,4.1,4.06,3,2,44,10,11,65,11,6,1,38,1,20,6
8467096,2014,7.81,7.73,3,8,116,48,80,244,20,9,11,107,0,49,20
8467329,2014,11.71,11.2,9,3,103,41,43,187,20,8,7,95,95,40,11
8467330,2014,10.34,9.61,11,7,91,28,43,162,27,9,8,82,451,43,30
8467331,2014,3.38,3.09,4,6,64,30,34,128,13,3,5,61,1,177,15
8467332,2014,0.23,0.22,1,1,6,9,15,30,2,0,1,6,0,20,0
8467334,2014,2.76,2.76,1,2,46,17,16,79,4,1,2,45,537,37,14
8467338,2014,14.72,14.22,19,14,104,28,37,169,55,22,9,82,12,45,34
8467344,2014,1.66,1.67,4,6,63,30,36,129,13,3,2,60,0,203,12
8467346,2014,2.27,2.18,0,1,27,4,15,46,4,3,1,24,1,20,3
8467351,2014,6.16,5.97,13,14,70,23,18,111,34,7,2,63,367,24,22
8467370,2014,13.38,12.18,15,5,111,43,37,191,39,19,7,92,601,125,27
8467371,2014,11.49,11.11,27,20,96,44,29,169,62,15,5,81,582,42,32
8467389,2014,13.5,13.27,15,10,199,53,70,322,37,12,10,187,399,32,22
8467396,2014,13.48,13.18,14,4,122,40,51,213,39,21,14,101,5,134,24
8467400,2014,4.85,4.74,4,8,110,45,58,213,23,11,7,99,1,105,18
8467407,2014,16.02,15.57,12,10,153,49,51,253,35,13,10,140,69,61,31
8467423,2014,10.4,10.14,10,8,82,34,34,150,29,11,5,71,237,80,20
8467452,2014,1.27,1.26,4,5,52,18,48,118,10,1,1,51,0,41,8
8467493,2014,3.46,3.25,2,1,23,12,12,47,7,4,2,19,3,136,4
8467496,2014,7.95,7.67,24,16,135,76,116,327,50,10,8,125,0,53,46
8467514,2014,19.94,18.71,24,15,165,58,68,291,65,26,6,139,601,51,59
8467545,2014,9.49,9.17,9,4,89,39,28,156,19,6,9,83,2,53,10
8467875,2014,20.05,18.98,35,21,226,74,70,370,76,20,13,206,2,21,19
8467876,2014,16.65,16.08,28,27,101,29,35,165,73,18,4,83,704,25,33
8467890,2014,2.46,2.39,6,7,86,27,46,159,15,2,9,84,0,108,17
8467899,2014,7.24,7.15,5,4,49,23,12,84,14,5,4,44,0,11,20
8467917,2014,1.04,1,2,1,39,6,27,72,4,1,0,38,0,33,9
8467967,2014,10.64,10.31,9,12,112,42,34,188,28,7,10,105,262,126,28
8467977,2014,0.46,0.44,0,0,10,4,1,15,0,0,0,10,0,11,3
8467988,2014,1.04,0.94,0,0,6,2,0,8,0,0,1,6,1,14,0
8468001,2014,8.72,8.34,2,4,72,29,24,125,11,5,6,67,543,273,26
8468064,2014,10.48,9.96,14,9,91,38,51,180,32,9,7,82,0,96,27
8468083,2014,20.18,19.81,30,19,227,90,102,419,66,17,12,210,541,55,37
8468085,2014,24.64,23.77,18,14,267,88,96,451,63,31,9,236,5,44,33
8468208,2014,19.75,18.52,10,5,138,57,38,233,34,19,16,119,60,53,39
8468309,2014,10.05,8.98,24,19,144,52,120,316,52,9,12,135,0,63,16
8468478,2014,0.35,0.35,0,4,8,10,15,33,4,0,0,8,0,35,5
8468482,2014,0.9,0.85,0,0,8,3,2,13,0,0,1,8,0,5,1
8468483,2014,24.03,23.1,14,6,174,59,55,288,47,27,15,147,1,39,18
8468486,2014,22.21,21.52,21,11,204,53,51,308,60,28,16,176,7,160,36
8468493,2014,3.14,3.05,5,3,83,35,57,175,10,2,6,81,1,110,22
8468498,2014,1.82,1.8,7,12,66,24,78,168,19,0,8,66,0,306,11
8468501,2014,1.16,1.16,1,6,35,16,28,79,7,0,2,35,0,93,3
8468504,2014,16.8,16.29,18,6,151,62,48,261,38,14,9,137,97,60,41
8468505,2014,4.14,4.08,4,5,49,24,32,105,12,3,2,46,160,184,21
8468508,2014,15.96,15.47,10,13,174,66,67,307,41,18,10,156,3,29,25
8468509,2014,6.27,5.87,13,22,101,39,75,215,44,9,7,92,1,91,11
8468513,2014,3.42,3.19,4,9,69,39,47,155,15,2,0,67,0,113,6
8468518,2014,8.7,8.5,5,1,106,38,40,184,8,2,6,104,3,88,11
8468526,2014,8.58,8.3,6,5,83,30,22,135,17,6,6,77,592,167,11
8468535,2014,13.76,13.35,15,10,109,39,40,188,38,13,6,96,872,80,30
8468542,2014,3.61,3.54,11,6,61,43,59,163,20,3,6,58,0,60,24
8468575,2014,10.85,10.77,9,8,116,41,47,204,27,10,8,106,585,55,30
8468598,2014,4.09,3.98,9,6,85,35,61,181,20,5,6,80,0,38,46
8468611,2014,9.42,9.27,6,2,103,37,32,172,16,8,4,95,98,220,31
8468635,2014,3.23,3.15,4,2,34,12,9,55,9,3,0,31,0,62,7
8468639,2014,4.16,3.92,6,14,90,45,59,194,22,2,4,88,0,71,19
8468674,2014,1.57,1.53,3,6,51,25,41,117,11,2,1,49,0,132,20
8468700,2014,4.57,4.54,5,5,54,20,28,102,14,4,4,50,619,143,19
8468778,2014,0,0,0,0,0,0,0,0,0,0,0,0,0,0,0
8469455,2014,22.93,22.03,19,26,204,109,99,412,62,17,23,187,682,16,51
8469457,2014,7.15,6.9,7,9,52,18,21,91,25,9,4,43,10,19,9
8469459,2014,17.02,16.38,17,17,179,57,65,301,48,14,14,165,989,40,60
8469462,2014,6.96,6.94,2,4,74,28,20,122,13,7,3,67,4,174,15
8469465,2014,2.89,2.79,10,12,82,30,66,178,23,1,6,81,0,82,18
8469466,2014,9.65,9.43,8,13,140,39,76,255,32,11,7,129,0,22,30
8469469,2014,11.43,11.01,5,1,96,41,40,177,15,9,7,87,9,114,9
8469470,2014,2.77,2.65,4,2,42,30,36,108,8,2,3,40,0,46,10
8469473,2014,5.84,5.67,1,5,77,29,24,130,9,3,4,74,372,87,18
8469476,2014,1.71,1.68,4,4,54,26,30,110,9,1,4,53,0,167,11
8469485,2014,15.99,15.41,15,5,113,44,39,196,32,12,7,101,407,32,42
8469490,2014,5.48,5.41,0,2,55,29,17,101,7,5,3,50,10,110,6
8469492,2014,2.05,2.01,4,8,56,36,39,131,15,3,1,53,0,106,10
8469500,2014,20.12,19.75,7,8,157,47,55,259,42,27,6,130,119,30,29
8469501,2014,5.65,5.63,2,5,67,24,35,126,14,7,6,60,36,126,9
8469506,2014,17.64,17.14,23,13,252,84,97,433,54,18,15,234,39,44,35
8469508,2014,7.8,7.6,8,6,68,28,25,121,21,7,10,61,549,79,42
8469521,2014,21.94,21.41,20,14,248,68,76,392,60,26,12,222,777,47,30
8469531,2014,2.33,2.33,4,2,50,29,51,130,9,3,3,47,0,76,16
8469542,2014,0.52,0.47,0,1,9,1,2,12,2,1,0,8,0,9,2
8469544,2014,19.76,19.25,15,12,230,76,107,413,43,16,8,214,53,74,38
8469547,2014,6.98,6.48,4,1,75,24,19,118,15,10,6,65,1,127,17
8469555,2014,4.86,4.78,6,5,110,57,59,226,14,3,8,107,0,73,12
8469591,2014,2.54,2.48,3,0,31,9,15,55,4,1,2,30,147,77,3
8469598,2014,5.31,5.09,4,6,99,40,67,206,14,4,7,95,0,109,19
8469619,2014,3.16,3.04,3,8,103,33,73,209,14,3,2,100,0,212,8
8469622,2014,1.51,1.5,2,1,15,3,8,26,4,1,1,14,0,21,3
8469623,2014,8.71,8,12,15,130,59,100,289,34,7,7,123,0,95,20
8469638,2014,11.4,10.98,19,17,134,36,47,217,44,8,9,126,126,52,29
8469639,2014,12.43,12.04,7,6,106,29,36,171,20,7,6,99,87,107,25
8469664,2014,11.36,10.66,5,3,96,35,35,166,12,4,10,92,6,115,18
8469665,2014,2.98,2.92,5,3,76,34,89,199,10,2,3,74,0,69,22
8469707,2014,10.32,10.13,9,5,97,35,45,177,22,8,6,89,10,32,18
8469759,2014,13.23,13.07,12,4,132,50,45,227,29,13,6,119,569,43,32
8469760,2014,2.45,2.41,4,4,86,34,69,189,12,4,5,82,0,85,16
8469770,2014,9.25,9.01,15,26,173,78,162,413,56,15,13,158,0,94,51
8470018,2014,1.9,1.87,1,0,29,6,5,40,2,1,0,28,100,10,12
8470039,2014,10.63,10.17,16,3,131,46,56,233,27,8,6,123,4,64,30
8470041,2014,30.52,29.35,20,7,304,80,110,494,69,42,22,262,2,45,74
8470047,2014,11.96,11.71,18,18,91,29,40,160,48,12,7,79,621,25,50
8470054,2014,0.16,0.16,0,1,5,2,3,10,1,0,0,5,0,15,2
8470063,2014,1.41,1.4,2,0,22,9,7,38,3,1,0,21,57,11,4
8470065,2014,0.41,0.43,0,0,2,1,0,3,0,0,0,2,0,2,0
8470104,2014,2.59,2.53,3,5,70,31,53,154,12,4,1,66,0,55,11
8470105,2014,8.2,8.15,4,3,93,32,38,163,15,8,6,85,34,128,19
8470110,2014,8.18,7.78,14,8,113,61,70,244,38,16,9,97,0,29,29
8470120,2014,8.57,8.2,7,6,93,44,70,207,19,6,13,87,3,30,48
8470121,2014,1.99,1.93,2,4,69,47,59,175,9,3,9,66,0,209,8
8470144,2014,15.13,14.72,18,11,157,70,83,310,43,14,10,143,506,48,56
8470151,2014,4.62,4.43,6,5,92,56,51,199,13,2,4,90,0,42,14
8470152,2014,4.29,4.16,3,3,61,23,34,118,10,4,4,57,7,14,20
8470159,2014,7.58,7.11,3,4,65,29,20,114,13,6,4,59,681,31,21
8470162,2014,5.68,5.15,6,4,46,16,29,91,17,7,7,39,303,72,33
8470169,2014,6.82,6.64,3,3,64,17,25,106,12,6,2,58,339,119,13
8470171,2014,8.46,8.12,9,4,97,21,27,145,18,5,5,92,76,132,44
8470176,2014,10.87,10.6,6,4,108,49,30,187,19,9,8,99,2,73,34
8470180,2014,6.08,5.98,2,3,60,21,16,97,12,7,2,53,4,104,9
8470187,2014,9.01,8.86,13,13,192,79,117,388,35,9,19,183,2,171,24
8470189,2014,0.11,0.1,0,0,1,0,0,1,0,0,0,1,0,1,0
8470201,2014,22.17,21.66,29,16,158,65,47,270,76,31,5,127,21,27,43
8470207,2014,11.25,10.33,7,4,97,42,31,170,21,10,7,87,4,78,36
8470222,2014,9.4,8.99,13,13,147,54,109,310,34,8,10,139,0,115,12
8470230,2014,8.74,8.61,6,1,66,36,15,117,13,6,5,60,2,77,29
8470257,2014,18.95,18.49,29,11,223,82,110,415,64,24,15,199,218,32,39
8470274,2014,16.87,16.26,16,8,171,62,50,283,36,12,12,159,3,73,28
8470281,2014,9.07,8.63,19,16,171,71,163,405,45,10,8,161,0,16,43
8470289,2014,6.22,5.92,6,2,51,27,11,89,13,5,3,46,448,134,13
8470302,2014,5.62,5.4,4,3,77,28,33,138,12,5,6,72,5,145,26
8470317,2014,1.18,1.15,2,11,38,11,36,85,15,2,3,36,0,94,19
8470318,2014,2.82,2.77,8,4,82,39,58,179,15,3,8,79,0,114,13
8470324,2014,1.32,1.24,1,5,28,20,15,63,6,0,0,28,0,75,7
8470358,2014,16.65,15.99,9,6,145,54,37,236,33,18,10,127,6,73,33
8470378,2014,2.05,2.01,3,5,45,24,37,106,9,1,5,44,0,38,10
8470543,2014,17.64,16.75,16,7,170,64,70,304,40,17,15,153,7,211,31
8470595,2014,27.64,26.3,18,13,241,102,101,444,53,22,25,219,333,65,38
8470598,2014,19.98,19.09,23,8,171,59,61,291,52,21,16,150,10,32,28
8470599,2014,15.42,15.04,12,9,130,55,50,235,34,13,10,117,11,64,23
8470600,2014,6.28,5.81,12,24,150,79,131,360,38,2,7,148,0,69,33
8470601,2014,2.2,2.12,4,6,46,28,43,117,11,1,1,45,0,62,10
8470602,2014,7.93,7.65,14,12,138,79,85,302,29,3,10,135,0,166,30
8470604,2014,25.37,24.84,18,16,218,113,89,420,62,28,21,190,627,76,29
8470606,2014,15.4,15.2,12,4,189,79,72,340,27,11,11,178,15,242,29
8470607,2014,7.1,6.87,10,13,181,80,118,379,31,8,9,173,0,135,27
8470609,2014,16.89,16.6,10,6,107,25,28,160,32,16,6,91,1,123,17
8470610,2014,37.22,35.18,15,14,259,82,66,407,62,33,31,226,2,86,47
8470611,2014,16.83,16.25,9,5,142,48,55,245,33,19,11,123,449,84,48
8470612,2014,18.02,17.13,31,14,191,88,78,357,70,25,11,166,632,100,55
8470613,2014,15.61,14.78,24,19,245,140,208,593,60,17,19,228,0,148,46
8470614,2014,2.28,2.26,7,5,51,28,74,153,14,2,2,49,0,166,13
8470616,2014,20.59,20.15,16,11,205,89,90,384,47,20,10,185,937,169,47
8470617,2014,7.58,7.4,8,3,63,38,25,126,16,5,5,58,289,62,22
8470619,2014,13.47,13.23,7,2,140,38,46,224,24,15,9,125,460,136,33
8470621,2014,25,24.3,15,7,193,76,80,349,55,33,14,160,3,64,25
8470622,2014,12.83,12.28,6,7,91,51,40,182,27,14,4,77,2,69,18
8470626,2014,22.85,21.48,16,9,169,62,34,265,47,22,12,147,4,29,45
8470630,2014,3.83,3.88,6,11,76,30,69,175,26,9,4,67,0,126,15
8470638,2014,25.59,24.67,22,10,234,90,104,428,55,23,21,211,1175,57,48
8470640,2014,4.16,4.09,6,8,73,28,45,146,18,4,10,69,0,26,13
8470642,2014,10.71,10.42,11,19,237,99,140,476,45,15,10,222,0,166,23
8470644,2014,2.62,2.5,4,2,29,10,9,48,8,2,3,27,2,72,2
8470647,2014,3.74,3.71,1,2,43,16,24,83,6,3,3,40,1,68,7
8470654,2014,6.42,6.27,6,3,86,24,22,132,11,2,10,84,305,153,11
8470655,2014,20.01,19.77,18,14,183,77,45,305,58,26,14,157,617,227,38
8470662,2014,0.01,0.01,0,0,1,0,0,1,0,0,0,1,0,1,0
8470666,2014,3.19,3.22,3,1,42,19,11,72,8,4,4,38,0,36,6
8470667,2014,15.15,14.78,13,7,140,47,57,244,36,16,11,124,8,70,31
8470699,2014,2.87,2.79,4,8,84,34,57,175,13,1,2,83,0,170,22
8470714,2014,0.09,0.1,0,0,2,2,1,5,0,0,1,2,0,6,1
8470719,2014,0.16,0.17,0,0,3,0,0,3,0,0,0,3,10,17,0
8470724,2014,3.97,3.93,11,4,90,41,86,217,18,3,9,87,0,104,15
8470729,2014,0.95,0.93,1,4,38,16,20,74,5,0,2,38,0,67,13
8470740,2014,12.71,12.52,5,8,115,33,59,207,28,15,14,100,12,78,17
8470750,2014,11.17,10.98,8,7,105,39,59,203,26,11,7,94,374,143,38
8470755,2014,7.92,7.71,6,7,66,17,28,111,21,8,6,58,276,58,12
8470760,2014,1.33,1.31,2,8,49,18,24,91,11,1,5,48,0,94,12
8470775,2014,9.17,8.86,7,6,87,36,27,150,18,5,3,82,557,204,26
8470778,2014,8.33,8.25,5,3,98,23,29,150,13,5,7,93,6,119,24
8470794,2014,35.78,33.73,22,11,261,98,81,440,70,37,21,224,642,97,57
8470798,2014,0.05,0.05,0,0,3,1,2,6,0,0,0,3,0,2,2
8470803,2014,8.38,8,6,5,86,30,26,142,20,9,8,77,338,56,28
8470828,2014,3.44,3.29,11,8,58,31,43,132,23,4,5,54,0,27,12
8470834,2014,17.09,16.68,8,19,209,97,117,423,45,18,11,191,0,203,47
8470839,2014,0.07,0.07,1,0,4,0,1,5,1,0,0,4,0,36,0
8470852,2014,19.89,18.55,17,11,156,51,46,253,41,13,14,143,13,34,26
8470854,2014,3.75,3.59,3,2,53,17,20,90,6,1,3,52,7,213,8
8470867,2014,0.04,0.04,0,0,1,0,1,2,0,0,0,1,0,4,0
8470871,2014,2.43,2.37,1,0,24,14,6,44,2,1,1,23,4,63,1
8470877,2014,14.27,13.95,10,6,114,47,45,206,30,14,9,100,15,125,24
8470886,2014,1.79,1.74,7,0,68,32,57,157,8,1,5,67,0,128,10
8470920,2014,11.68,11.12,1,4,95,48,26,169,15,10,9,85,25,133,11
8470966,2014,8.89,8.19,17,20,157,73,131,361,48,11,9,146,0,59,35
8471185,2014,13.9,13.22,12,10,108,45,41,194,35,13,7,95,8,124,34
8471214,2014,45.68,43.78,21,7,395,202,228,825,81,53,21,342,2,259,45
8471215,2014,23.16,22.44,21,21,212,94,81,387,70,28,18,184,322,24,45
8471217,2014,25.46,24.82,24,14,224,82,76,382,62,24,14,200,7,212,26
8471218,2014,27.44,26.77,24,11,244,101,71,416,61,26,20,218,22,128,35
8471222,2014,0.9,0.85,0,1,21,11,10,42,1,0,1,21,0,51,4
8471226,2014,13.82,13.33,13,12,147,43,42,232,43,18,17,129,86,81,21
8471231,2014,6.72,6.35,4,6,81,19,28,128,14,4,4,77,473,130,41
8471232,2014,12.19,11.71,8,7,82,39,42,163,21,6,14,76,11,141,26
8471233,2014,13.37,13.1,9,5,112,36,54,202,25,11,7,101,641,70,51
8471236,2014,3.84,3.78,3,4,67,25,47,139,14,7,3,60,0,67,8
8471240,2014,0.22,0.2,1,0,7,4,5,16,1,0,0,7,0,10,0
8471241,2014,0.11,0.11,0,0,1,6,3,10,0,0,0,1,0,28,4
8471242,2014,8.9,8.72,21,14,159,67,82,308,45,10,6,149,0,82,30
8471245,2014,8.05,7.82,11,6,76,30,22,128,23,6,5,70,414,88,26
8471254,2014,10.6,10.37,6,8,113,35,47,195,28,14,6,99,0,205,26
8471260,2014,13.91,13.67,10,5,147,45,77,269,31,16,10,131,7,188,16
8471262,2014,18.44,17.91,19,12,163,60,89,312,44,13,10,150,369,76,33
8471266,2014,9.74,9.45,5,1,107,38,36,181,13,7,7,100,6,87,27
8471269,2014,1.97,1.96,1,8,43,20,41,104,14,5,3,38,0,132,10
8471273,2014,9.1,8.87,11,12,100,29,41,170,36,13,8,87,436,152,19
8471274,2014,6.3,6.06,17,15,122,65,95,282,36,4,6,118,0,100,30
8471276,2014,7.54,7.53,12,12,70,32,39,141,31,7,3,63,316,35,20
8471283,2014,7.94,7.64,11,3,78,28,24,130,18,4,7,74,16,122,15
8471284,2014,3.88,3.69,7,13,100,54,115,269,23,3,6,97,0,59,43
8471296,2014,1.39,1.38,3,8,43,27,50,120,14,3,3,40,0,204,16
8471299,2014,0.31,0.26,0,1,3,2,0,5,1,0,0,3,1,3,3
8471303,2014,7.65,7.47,8,15,175,64,125,364,31,8,13,167,0,94,24
8471309,2014,7.81,7.57,6,9,74,34,18,126,22,7,7,67,5,45,4
8471311,2014,4.36,4.24,6,2,79,23,39,141,14,6,6,73,13,49,20
8471326,2014,0,0,0,0,0,0,0,0,0,0,0,0,0,2,0
8471338,2014,4.94,4.75,5,3,55,16,24,95,14,6,4,49,399,58,25
8471339,2014,21.87,21,21,9,191,51,63,305,54,24,12,167,15,184,43
8471346,2014,12.45,12.25,13,7,134,41,53,228,34,14,8,120,15,31,31
8471348,2014,3.57,3.48,3,3,80,23,46,149,10,4,7,76,0,21,17
8471362,2014,9.78,9.69,3,7,81,44,43,168,19,9,6,72,38,11,26
8471371,2014,0.9,0.89,0,0,11,9,4,24,0,0,1,11,4,42,1
8471385,2014,1.3,1.27,5,4,29,12,38,79,9,0,3,29,0,74,10
8471388,2014,1.8,1.63,2,1,25,5,10,40,3,0,2,25,3,88,8
8471390,2014,15.79,15.19,10,11,145,39,39,223,33,12,7,133,86,55,44
8471392,2014,4.13,4.03,1,3,61,32,36,129,9,5,2,56,1,225,23
8471426,2014,21.21,20.31,10,12,146,66,58,270,43,21,8,125,251,206,44
8471436,2014,3.33,3.24,5,4,72,25,43,140,11,2,3,70,0,55,15
8471474,2014,0.63,0.64,0,0,10,5,6,21,0,0,1,10,28,3,2
8471476,2014,9.54,9.34,18,7,97,43,33,173,34,9,3,88,107,124,44
8471482,2014,0.8,0.78,3,1,22,7,27,56,4,0,2,22,0,46,5
8471490,2014,1.13,1.07,1,0,17,9,3,29,1,0,3,17,20,43,5
8471498,2014,14.3,14.08,13,4,145,53,53,251,33,16,6,129,1,80,42
8471504,2014,9.29,9.11,7,1,85,41,40,166,14,6,7,79,4,71,6
8471636,2014,0.92,0.91,2,0,10,3,3,16,2,0,1,10,48,22,3
8471657,2014,9.43,9.05,1,4,94,20,20,134,12,7,4,87,1,268,11
8471663,2014,0,0,0,0,0,0,1,1,0,0,0,0,0,7,0
8471664,2014,7.54,7.49,7,4,123,24,65,212,23,12,9,111,0,7,24
8471669,2014,19.94,19.21,17,13,143,54,35,232,46,16,11,127,671,22,28
8471675,2014,29.25,28.52,31,25,237,78,65,380,84,28,19,209,797,66,37
8471676,2014,17.8,17.17,18,18,221,62,85,368,54,18,12,203,4,110,59
8471677,2014,7.46,7.12,11,21,141,56,76,273,40,8,7,133,0,157,18
8471678,2014,14.45,13.92,11,4,105,51,18,174,34,19,8,86,13,71,40
8471681,2014,6.3,6.19,2,0,95,30,21,146,8,6,4,89,3,96,17
8471682,2014,1.09,1.08,0,0,12,6,8,26,0,0,2,12,1,12,0
8471685,2014,13.64,13.31,30,18,134,57,63,254,64,16,10,118,752,105,29
8471686,2014,4.5,4.28,3,12,97,37,64,198,20,5,4,92,1,99,43
8471691,2014,9.46,8.89,10,6,85,32,27,144,24,8,11,77,346,105,17
8471693,2014,2.82,2.76,3,5,54,20,44,118,13,5,2,49,0,31,2
8471698,2014,18.49,17.99,23,13,162,69,58,289,55,19,17,143,3,99,48
8471699,2014,13.95,13.54,12,2,134,59,52,245,29,15,12,119,16,139,30
8471702,2014,5.59,5.35,17,10,117,75,93,285,31,4,7,113,0,143,34
8471703,2014,10.07,9.89,8,6,104,18,36,158,28,14,3,90,4,108,16
8471707,2014,22.63,21.68,9,5,222,91,116,429,37,23,12,199,7,71,37
8471709,2014,5.6,5.45,5,9,98,47,92,237,23,9,6,89,0,51,11
8471710,2014,0.21,0.23,0,0,4,5,4,13,0,0,2,4,0,5,0
8471716,2014,19.74,19.18,15,6,154,47,36,237,44,23,8,131,7,153,16
8471717,2014,1.61,1.57,2,4,60,26,49,135,7,1,2,59,0,141,7
8471718,2014,3.66,3.51,4,1,68,10,23,101,7,2,2,66,377,27,31
8471724,2014,12.07,11.21,20,23,197,59,126,382,54,11,16,186,0,131,39
8471729,2014,5.23,4.97,11,19,111,41,97,249,34,4,11,107,0,61,51
8471733,2014,0,0,0,0,0,0,0,0,0,0,0,0,0,3,0
8471735,2014,10.36,10.04,16,30,232,120,152,504,52,6,19,226,0,53,35
8471742,2014,7.06,6.81,13,16,127,48,77,252,36,7,12,120,0,177,46
8471748,2014,0.63,0.64,2,2,19,14,17,50,4,0,1,19,0,85,1
8471761,2014,1.63,1.62,3,3,54,10,27,91,9,3,0,51,0,31,5
8471762,2014,7.08,6.79,3,3,70,26,25,121,15,9,2,61,21,121,13
8471766,2014,2.62,2.54,3,1,28,12,15,55,5,1,2,27,0,131,5
8471767,2014,0.01,0.01,0,0,0,1,2,3,0,0,0,0,5,7,1
8471769,2014,3.4,3.36,6,10,97,47,93,237,19,3,3,94,0,39,41
8471794,2014,15.97,15.52,13,5,160,50,60,270,33,15,10,145,223,132,33
8471804,2014,15.93,15.33,10,8,235,66,81,382,28,10,17,225,9,73,51
8471816,2014,2.94,2.9,1,5,78,29,78,185,8,2,7,76,0,81,21
8471817,2014,6.64,6.52,3,3,55,22,16,93,12,6,1,49,0,276,14
8471840,2014,0.3,0.3,3,0,6,2,2,10,3,0,0,6,0,16,0
8471856,2014,6.08,5.87,4,2,55,23,17,95,9,3,6,52,354,104,30
8471862,2014,3.22,3.17,0,0,40,9,14,63,1,1,1,39,6,85,8
8471873,2014,8.07,7.89,15,15,138,44,92,274,39,9,10,129,0,104,23
8471879,2014,0.23,0.23,0,0,5,4,3,12,0,0,0,5,0,3,1
8471887,2014,27.63,26.87,14,12,220,73,76,369,51,25,13,195,2,87,31
8471916,2014,0,0,0,0,0,0,0,0,0,0,0,0,7,5,0
8471956,2014,4.97,4.87,0,5,59,12,30,101,10,5,1,54,158,128,14
8471958,2014,5.97,5.71,9,7,111,38,76,225,20,4,11,107,0,224,33
8471976,2014,12.52,12.18,16,18,90,31,51,172,48,14,12,76,629,43,27
8472365,2014,0,0,0,0,0,0,0,0,0,0,0,0,0,6,0
8472368,2014,0.31,0.31,0,0,3,2,2,7,0,0,0,3,0,0,1
8472382,2014,3.51,3.45,7,12,83,57,76,216,22,3,7,80,0,82,21
8472394,2014,1.56,1.53,1,1,31,15,16,62,5,3,1,28,0,40,6
8472410,2014,7.42,7.36,6,2,84,22,21,127,13,5,8,79,159,92,19
8472424,2014,2.22,2.21,1,0,12,4,4,20,2,1,0,11,1,27,2
8473412,2014,20.09,18.99,15,13,148,55,70,273,52,24,10,124,762,56,25
8473415,2014,0.38,0.37,0,0,7,7,5,19,1,1,0,6,0,34,1
8473419,2014,16.55,16.2,14,4,180,65,67,312,42,24,8,156,13,72,52
8473422,2014,22.83,21.87,22,20,182,43,48,273,73,31,10,151,125,193,51
8473426,2014,2.09,1.87,1,5,41,25,47,113,7,1,4,40,0,172,10
8473432,2014,9.19,9.18,10,8,89,48,29,166,25,7,8,82,7,166,18
8473446,2014,7.17,6.49,5,6,115,37,74,226,23,12,8,103,0,93,26
8473449,2014,19.42,18.93,19,14,195,79,75,349,51,18,15,177,80,53,30
8473453,2014,11.85,11.77,8,8,143,40,38,221,25,9,13,134,76,192,16
8473463,2014,6.59,6.47,12,6,84,25,29,138,26,8,1,76,95,250,51
8473465,2014,3.9,3.78,0,2,36,13,2,51,6,4,0,32,1,29,9
8473466,2014,3.38,3.32,4,2,45,13,13,71,12,6,2,39,65,108,8
8473468,2014,2.15,2.17,7,5,64,29,58,151,12,0,1,64,0,171,12
8473473,2014,15.83,15.53,17,9,141,73,61,275,44,18,6,123,34,259,31
8473482,2014,15.64,14.62,5,12,123,52,55,230,31,14,8,109,5,80,30
8473485,2014,18.48,17.79,17,5,155,47,39,241,36,14,8,141,10,110,21
8473492,2014,13.35,13.01,5,5,145,85,83,313,32,22,7,123,8,159,9
8473504,2014,11.21,10.72,8,1,124,52,43,219,16,7,3,117,6,343,25
8473507,2014,5.52,5.31,10,5,126,58,110,294,22,7,9,119,0,145,43
8473512,2014,24.95,24.27,20,28,279,81,152,512,73,25,17,254,1063,110,40
8473514,2014,2.8,2.62,0,2,18,10,2,30,4,2,2,16,0,37,9
8473533,2014,12.9,12.08,10,8,95,44,42,181,25,7,7,88,509,85,39
8473534,2014,12.6,12.46,8,7,145,50,39,234,27,12,11,133,160,93,37
8473536,2014,9.26,8.78,7,4,79,39,29,147,18,7,9,72,278,121,42
8473537,2014,1.88,1.89,6,2,27,12,12,51,10,2,1,25,1,54,7
8473542,2014,0.72,0.67,0,1,1,1,0,2,1,0,0,1,0,10,0
8473544,2014,15.48,14.9,16,25,168,49,64,281,60,19,5,149,671,106,42
8473546,2014,7.55,7.36,1,4,63,30,27,120,13,8,4,55,0,62,25
8473548,2014,22.17,21.13,17,19,280,90,138,508,61,25,17,255,2,18,34
8473560,2014,0.87,0.84,5,1,32,10,8,50,6,0,3,32,0,117,11
8473563,2014,16.75,16.47,31,29,153,78,52,283,78,18,9,135,862,91,55
8473564,2014,19.65,19.13,11,12,206,68,99,373,42,19,17,187,14,63,58
8473565,2014,2.19,2.11,0,5,59,20,33,112,7,2,4,57,0,124,14
8473571,2014,1.19,1.18,1,5,18,20,22,60,9,3,2,15,0,21,3
8473573,2014,9.6,9.17,15,5,88,48,39,175,27,7,9,81,102,33,24
8473574,2014,14.79,14.49,7,2,132,53,30,215,27,18,0,114,84,66,36
8473579,2014,17.28,16.82,7,9,115,50,47,212,31,15,5,100,7,129,53
8473584,2014,3.1,2.98,4,6,62,36,54,152,12,2,7,60,0,35,12
8473588,2014,11.09,11.06,9,5,106,35,52,193,23,9,7,97,2,33,37
8473589,2014,0.3,0.29,2,1,15,4,14,33,3,0,1,15,0,49,1
8473604,2014,26.91,25.65,23,15,192,66,46,304,66,28,9,164,947,56,45
8473618,2014,15.49,14.54,18,5,129,39,53,221,41,18,16,111,226,78,43
8473646,2014,6.21,5.81,5,5,47,26,15,88,13,3,3,44,29,77,14
8473647,2014,0.11,0.11,0,1,2,0,6,8,1,0,0,2,0,2,0
8473658,2014,1.03,1.01,7,3,28,17,20,65,10,0,2,28,0,77,2
8473673,2014,1.16,1.15,0,3,45,11,41,97,4,1,0,44,0,45,6
8473682,2014,1.33,1.3,3,2,21,5,11,37,6,1,2,20,39,10,6
8473700,2014,0.23,0.22,0,0,3,2,3,8,0,0,0,3,0,6,0
8473722,2014,2.34,2.21,1,0,19,8,13,40,4,3,1,16,0,94,7
8473911,2014,1.32,1.15,1,1,15,1,1,17,4,2,1,13,0,32,2
8473914,2014,5.05,5.09,4,2,63,15,23,101,13,7,2,56,319,51,21
8473921,2014,0.01,0.01,0,0,0,1,3,4,0,0,0,0,0,0,0
8473933,2014,3.03,3.01,4,8,86,39,50,175,14,2,3,84,0,170,15
8473942,2014,5.66,5.36,2,1,46,19,20,85,5,2,2,44,293,75,18
8473962,2014,14.31,13.77,16,6,146,51,73,270,34,12,11,134,4,24,46
8473970,2014,5.88,5.66,3,1,64,30,24,118,9,5,4,59,10,236,13
8473986,2014,16.47,16.05,13,10,130,50,45,225,38,15,9,115,35,60,29
8473989,2014,2.07,2.07,0,1,26,12,8,46,3,2,4,24,0,76,1
8473991,2014,2.5,2.44,6,10,72,36,62,170,21,5,3,67,0,120,15
8473992,2014,0.58,0.57,0,1,18,5,9,32,2,1,0,17,0,12,1
8473994,2014,34.29,33.09,32,20,253,103,110,466,87,35,22,218,298,120,76
8474000,2014,1.72,1.65,1,1,28,18,20,66,4,2,1,26,0,49,6
8474001,2014,2.77,2.77,0,0,35,11,9,55,1,1,2,34,2,38,11
8474008,2014,0.17,0.15,1,0,5,6,3,14,1,0,0,5,0,12,3
8474009,2014,14,13.23,14,10,149,47,50,246,39,15,10,134,590,31,54
8474013,2014,3.78,3.68,4,8,83,44,58,185,17,5,6,78,0,73,12
8474025,2014,0.25,0.24,0,0,5,1,2,8,0,0,1,5,1,12,0
8474027,2014,3.41,3.36,8,14,94,42,75,211,23,1,8,93,0,79,19
8474031,2014,5.78,5.25,18,18,135,49,78,262,44,8,10,127,0,42,25
8474034,2014,15.04,14.31,19,6,120,56,26,202,34,9,16,111,7,120,16
8474037,2014,28.97,28.02,23,6,248,85,69,402,56,27,13,221,21,83,46
8474038,2014,10.81,10.35,6,7,62,23,29,114,19,6,3,56,34,101,46
8474040,2014,16.84,16.4,19,7,183,76,64,323,41,15,20,168,361,63,36
8474048,2014,1.06,1.05,0,1,25,15,19,59,1,0,2,25,0,59,4
8474052,2014,8.12,7.88,7,2,71,33,29,133,20,11,7,60,6,44,21
8474053,2014,30.39,29.03,23,17,264,116,118,498,67,27,21,237,477,85,56
8474056,2014,8.29,8.1,21,24,170,86,158,414,60,15,8,155,0,97,29
8474061,2014,3.09,3.15,1,0,23,9,10,42,2,1,2,22,0,100,4
8474062,2014,11.95,11.41,11,6,94,30,48,172,25,8,7,86,488,88,52
8474066,2014,4.39,4.15,10,10,82,32,67,181,22,2,3,80,1,117,39
8474068,2014,22.6,22.1,25,15,215,83,122,420,64,24,12,191,737,48,48
8474074,2014,2.46,2.46,1,3,40,20,49,109,6,2,2,38,0,17,17
8474089,2014,6.13,6.06,5,3,65,34,19,118,15,7,2,58,30,162,16
8474090,2014,3.61,3.57,3,6,88,34,65,187,13,4,4,84,0,60,19
8474091,2014,18.82,18.38,6,6,180,52,45,277,33,21,16,159,688,86,41
8474094,2014,4.81,4.66,1,4,59,13,11,83,8,3,5,56,1,55,11
8474095,2014,0.01,0.01,0,0,1,0,0,1,0,0,0,1,0,5,0
8474096,2014,10.21,9.98,6,12,90,36,46,172,27,9,9,81,84,134,24
8474098,2014,12.94,12.7,5,12,113,55,62,230,26,9,12,104,30,77,24
8474100,2014,15.03,14.28,9,4,127,38,34,199,26,13,8,114,3,124,20
8474102,2014,18.32,17.77,14,10,196,50,77,323,41,17,8,179,3,171,35
8474113,2014,0.23,0.23,0,1,11,3,9,23,1,0,0,11,0,2,1
8474125,2014,2.34,2.26,4,6,54,22,37,113,12,2,5,52,0,42,11
8474130,2014,3.35,3.28,4,3,22,14,10,46,8,1,2,21,1,80,12
8474134,2014,7.51,7.31,5,5,118,47,79,244,21,11,5,107,0,66,14
8474135,2014,1.57,1.55,5,3,26,22,14,62,10,2,5,24,0,148,9
8474137,2014,0.05,0.04,0,0,0,1,0,1,0,0,0,0,0,3,0
8474141,2014,18.78,18.38,25,12,186,55,82,323,64,27,8,159,3,22,36
8474145,2014,1.95,1.94,3,2,56,26,42,124,8,3,1,53,1,157,3
8474150,2014,11.02,10.28,8,9,103,41,48,192,27,10,8,93,423,41,58
8474151,2014,7.87,7.74,12,13,148,50,78,276,33,8,12,140,0,77,40
8474157,2014,32.05,31.59,17,13,302,108,151,561,67,37,20,265,2,106,43
8474161,2014,22.76,21.91,31,28,221,70,133,424,81,22,19,199,6,55,34
8474162,2014,8.02,7.85,12,19,173,79,133,385,41,10,14,163,0,186,18
8474164,2014,0.06,0.06,1,0,3,1,0,4,1,0,0,3,0,1,0
8474166,2014,5,4.93,9,7,103,48,81,232,22,6,11,97,0,95,11
8474168,2014,5.93,5.37,5,0,74,14,15,103,8,3,4,71,192,27,8
8474176,2014,19.18,19.2,10,8,185,70,62,317,35,17,7,168,6,85,51
8474184,2014,0,0,0,1,0,0,1,1,1,0,0,0,0,1,0
8474189,2014,12.63,12.21,8,4,150,48,45,243,27,15,12,135,405,76,29
8474190,2014,22.65,20.81,11,11,188,68,67,323,50,28,13,160,4,168,33
8474192,2014,0.26,0.26,0,0,6,1,4,11,0,0,0,6,1,4,0
8474207,2014,7.16,6.9,5,4,94,44,61,199,14,5,6,89,0,156,24
8474218,2014,5.59,5.42,8,12,99,65,87,251,25,5,4,94,0,118,37
8474230,2014,0.34,0.33,0,0,1,0,1,2,0,0,0,1,2,6,0
8474250,2014,3.4,3.24,0,1,38,11,16,65,3,2,1,36,103,64,15
8474291,2014,11.32,11.03,7,3,84,23,19,126,20,10,7,74,217,73,30
8474497,2014,0.57,0.52,0,1,7,1,5,13,1,0,1,7,0,6,2
8474516,2014,0.73,0.75,0,0,8,1,0,9,1,1,1,7,4,3,0
8474519,2014,0.89,0.88,1,4,24,11,36,71,5,0,1,24,0,38,6
8474520,2014,4.98,4.87,9,17,111,50,75,236,30,4,9,107,0,46,21
8474535,2014,1.44,1.42,0,1,10,3,4,17,2,1,0,9,38,3,1
8474563,2014,9.86,9.55,21,18,219,104,165,488,46,7,20,212,0,152,12
8474564,2014,32.79,32.28,22,7,268,119,122,509,72,43,15,225,469,91,34
8474565,2014,9.89,9.67,16,23,195,89,81,365,46,7,18,188,0,70,33
8474567,2014,5.51,5.46,6,11,125,40,82,247,20,3,9,122,0,189,14
8474568,2014,2.62,2.59,5,6,67,21,66,154,14,3,5,64,0,194,7
8474569,2014,19.02,18.03,17,5,172,49,63,284,42,20,12,152,71,52,29
8474570,2014,10.92,10.53,5,2,127,40,62,229,13,6,5,121,173,40,24
8474571,2014,8.52,8.39,6,8,79,28,43,150,28,14,4,65,0,66,24
8474573,2014,14.24,13.84,14,12,140,46,75,261,41,15,10,125,30,66,53
8474574,2014,6.78,6.51,12,9,124,35,61,220,28,7,14,117,0,65,44
8474576,2014,2.75,2.73,2,1,35,10,12,57,6,3,3,32,0,40,9
8474577,2014,8.93,8.67,12,8,67,30,31,128,28,8,6,59,176,158,25
8474578,2014,14.59,13.82,25,20,292,145,217,654,66,21,20,271,0,93,59
8474579,2014,2.89,2.85,1,7,79,29,63,171,11,3,5,76,0,151,14
8474581,2014,5.24,5.09,7,13,100,56,97,253,24,4,4,96,0,109,39
8474584,2014,5.96,5.75,11,11,119,41,64,224,32,10,11,109,0,153,14
8474586,2014,20.07,19.67,25,14,183,53,67,303,63,24,10,159,1,62,37
8474589,2014,17.07,16.17,21,5,185,46,67,298,46,20,12,165,67,87,30
8474590,2014,10.53,10.1,24,19,193,89,112,394,55,12,15,181,0,74,41
8474594,2014,0.27,0.27,1,1,5,6,8,19,2,0,1,5,0,11,1
8474597,2014,1.25,1.17,5,4,23,24,20,67,9,0,4,23,0,44,3
8474600,2014,9.26,8.95,22,18,201,55,134,390,55,15,15,186,0,53,25
8474602,2014,8.95,8.65,14,11,122,71,108,301,31,6,9,116,1,41,20
8474603,2014,0.41,0.42,1,0,6,5,4,15,1,0,0,6,18,14,8
8474605,2014,3.76,3.7,4,6,79,38,64,181,13,3,8,76,0,50,10
8474606,2014,0.6,0.6,0,1,8,4,4,16,1,0,0,8,0,16,2
8474609,2014,0,0,0,0,0,0,1,1,0,0,0,0,0,2,0
8474610,2014,2.07,1.96,0,2,29,6,8,43,3,1,2,28,20,15,5
8474612,2014,5.66,5.2,14,14,132,55,119,306,33,5,17,127,0,213,27
8474613,2014,12.07,11.53,26,13,155,49,60,264,55,16,7,139,543,36,46
8474616,2014,0,0,0,0,0,0,0,0,0,0,0,0,3,1,0
8474618,2014,6.05,5.83,6,6,112,55,86,253,23,11,9,101,0,90,30
8474625,2014,19.57,18.3,11,5,166,49,33,248,35,19,15,147,4,147,22
8474627,2014,9.99,9.51,19,11,104,29,42,175,44,14,2,90,543,43,40
8474628,2014,4.96,4.81,10,5,144,73,115,332,18,3,10,141,1,202,12
8474638,2014,1.18,1.11,0,1,28,16,18,62,1,0,3,28,0,67,2
8474641,2014,15.43,15.14,16,11,127,38,59,224,43,16,7,111,270,59,31
8474642,2014,13.81,13.47,12,6,104,44,30,178,34,16,8,88,29,264,22
8474646,2014,6.59,6.29,0,3,51,24,27,102,4,1,7,50,10,91,15
8474659,2014,0.8,0.78,3,0,12,11,15,38,3,0,1,12,0,22,3
8474660,2014,0.2,0.19,0,1,7,1,6,14,1,0,0,7,0,2,0
8474661,2014,2.94,2.85,0,4,44,8,33,85,6,2,3,42,0,35,8
8474668,2014,9.44,9.3,15,4,91,31,33,155,29,10,6,81,5,145,26
8474673,2014,10.58,9.93,15,15,133,49,101,283,41,11,11,122,0,27,71
8474679,2014,21.36,20.54,14,13,195,57,89,341,54,27,8,168,1,43,34
8474685,2014,11.42,11.32,6,4,93,31,32,156,23,13,8,80,6,92,26
8474688,2014,0.26,0.26,0,0,10,3,8,21,0,0,2,10,0,48,0
8474697,2014,0.95,0.92,4,6,30,20,27,77,11,1,4,29,0,233,9
8474709,2014,11.43,11.03,3,3,90,28,24,142,14,8,7,82,5,382,24
8474715,2014,25.54,24.97,9,9,212,63,62,337,40,22,12,190,4,55,40
8474716,2014,7.32,6.96,9,7,128,53,81,262,25,9,6,119,0,48,31
8474717,2014,2.42,2.41,2,4,53,25,42,120,7,1,4,52,0,35,13
8474722,2014,0.31,0.31,0,0,10,6,12,28,0,0,1,10,0,37,2
8474727,2014,12.25,12.17,5,2,92,37,32,161,14,7,7,85,310,72,22
8474736,2014,3.35,3.26,4,1,45,18,13,76,6,1,1,44,1,216,9
8474739,2014,20.41,19.64,14,7,158,65,41,264,36,15,9,143,70,263,33
8474743,2014,4.81,4.59,9,6,93,26,58,177,20,5,5,88,0,59,20
8474744,2014,0.24,0.24,0,2,4,1,2,7,2,0,0,4,2,18,0
8474748,2014,0.16,0.15,0,2,5,2,6,13,2,0,0,5,0,35,2
8474749,2014,2.47,2.42,4,0,67,43,33,143,4,0,5,67,0,88,6
8474772,2014,0.16,0.17,1,0,3,1,1,5,1,0,0,3,0,10,1
8474774,2014,2.06,1.98,4,4,64,16,50,130,8,0,5,64,0,166,3
8474793,2014,0.8,0.72,0,0,3,1,0,4,1,1,0,2,25,8,0
8474818,2014,3.27,3.06,7,7,70,52,63,185,16,2,5,68,0,92,16
8474849,2014,14.72,14.15,6,6,113,56,37,206,25,13,5,100,3,115,31
8474870,2014,22.75,22.26,30,13,203,63,77,343,72,29,15,174,537,64,26
8474873,2014,0.2,0.2,0,2,7,3,2,12,2,0,0,7,0,7,3
8474884,2014,20.17,19.53,14,7,199,65,107,371,48,27,18,172,7,40,57
8475098,2014,22.69,21.24,16,10,154,51,42,247,49,23,5,131,944,83,68
8475119,2014,3.57,3.51,3,0,43,19,16,78,4,1,4,42,46,173,15
8475147,2014,4.32,4.31,3,2,48,10,7,65,8,3,2,45,0,24,13
8475148,2014,2.13,2.07,1,4,36,16,37,89,7,2,2,34,0,34,8
8475149,2014,15.23,14.72,8,19,138,52,63,253,47,20,8,118,7,69,29
8475150,2014,1.12,1.17,0,0,12,5,10,27,0,0,0,12,0,41,1
8475151,2014,12.49,12.2,7,8,112,60,42,214,29,14,8,98,6,97,15
8475153,2014,1.26,1.23,2,4,44,16,31,91,8,2,4,42,0,77,9
8475154,2014,0.32,0.32,0,0,4,1,2,7,0,0,1,4,1,6,2
8475155,2014,4.02,3.96,10,10,103,41,71,215,23,3,5,100,0,233,11
8475157,2014,0.22,0.24,0,0,4,0,2,6,1,1,0,3,0,3,3
8475158,2014,21.39,20.11,25,13,171,49,53,273,55,17,10,154,713,38,98
8475159,2014,0,0,0,0,0,0,0,0,0,0,0,0,0,2,0
8475160,2014,10.44,10.2,6,3,117,36,39,192,15,6,5,111,2,200,17
8475161,2014,0.25,0.24,0,0,4,0,0,4,1,1,0,3,1,6,0
8475162,2014,0.04,0.04,1,0,2,1,4,7,1,0,0,2,0,10,1
8475163,2014,11.74,11.17,9,6,105,36,34,175,26,11,9,94,3,93,22
8475164,2014,17.41,17.34,17,9,189,77,68,334,39,13,13,176,23,42,41
8475165,2014,8.39,8.17,6,8,61,14,13,88,20,6,5,55,226,59,8
8475166,2014,37.08,35.6,30,18,278,96,97,471,86,38,22,240,753,48,94
8475167,2014,5.77,5.46,11,17,115,51,82,248,38,10,6,105,0,51,29
8475168,2014,20.81,20.65,19,15,207,75,62,344,55,21,15,186,635,43,49
8475169,2014,10.81,10.71,7,5,126,60,58,244,22,10,8,116,30,119,18
8475170,2014,23.25,22.03,21,8,156,76,67,299,47,18,18,138,86,199,28
8475171,2014,14.34,13.53,13,7,264,127,180,571,43,23,17,241,0,167,30
8475172,2014,20.18,19.54,11,10,176,71,80,327,39,18,7,158,528,118,44
8475174,2014,1.58,1.59,2,4,47,19,38,104,9,3,0,44,0,159,13
8475175,2014,0.61,0.57,0,1,9,5,2,16,1,0,0,9,1,8,0
8475176,2014,6.58,6.44,11,7,118,40,54,212,27,9,8,109,0,41,21
8475177,2014,3.15,3.1,5,6,92,43,74,209,12,1,4,91,0,140,19
8475178,2014,6.27,5.94,4,2,55,16,21,92,16,10,4,45,0,88,10
8475179,2014,3.71,3.56,7,12,83,35,65,183,22,3,6,80,0,114,17
8475180,2014,7.81,7.4,9,5,93,27,28,148,25,11,3,82,312,99,67
8475181,2014,5.28,5.15,9,18,120,46,70,236,37,10,8,110,0,73,39
8475182,2014,1.84,1.82,7,4,58,26,53,137,14,3,3,55,0,23,10
8475184,2014,22.32,21.9,16,9,180,74,43,297,46,21,10,159,9,162,25
8475185,2014,6.57,6.44,2,3,61,26,24,111,11,6,3,55,289,55,15
8475186,2014,4.17,3.86,3,6,77,39,65,181,11,2,6,75,0,77,7
8475188,2014,2.66,2.62,8,14,74,50,72,196,24,2,7,72,1,175,12
8475191,2014,15.64,14.99,17,10,143,58,92,293,40,13,7,130,2,74,34
8475192,2014,6.87,6.87,7,1,78,34,31,143,16,8,6,70,5,61,15
8475193,2014,24.83,23.67,16,11,211,101,100,412,56,29,11,182,6,90,27
8475194,2014,0.12,0.11,0,0,4,0,1,5,0,0,0,4,0,2,0
8475197,2014,9.39,8.89,18,23,139,63,110,312,53,12,11,127,0,80,40
8475199,2014,4.31,4.18,10,3,112,46,86,244,19,6,6,106,0,82,13
8475203,2014,0,0,0,0,0,0,0,0,0,0,0,0,0,1,0
8475204,2014,14.63,14,1,1,143,56,44,243,24,22,8,121,86,39,18
8475206,2014,0.27,0.26,0,0,10,3,6,19,0,0,0,10,0,2,1
8475208,2014,0.08,0.08,0,0,4,0,1,5,1,1,0,3,0,11,0
8475209,2014,10.52,10.19,4,2,87,32,33,152,17,11,8,76,2,101,30
8475213,2014,0.81,0.83,2,0,13,1,7,21,3,1,0,12,29,10,1
8475214,2014,5.84,5.71,4,0,73,15,21,109,6,2,5,71,2,45,14
8475218,2014,3.44,3.43,3,8,86,25,87,198,18,7,7,79,0,57,30
8475220,2014,7.98,7.62,9,3,66,25,17,108,20,8,5,58,57,193,28
8475222,2014,6.82,6.56,7,18,122,50,70,242,37,12,13,110,1,75,27
8475223,2014,7.04,6.68,7,7,61,27,37,125,24,10,0,51,215,14,25
8475224,2014,0.55,0.55,0,0,8,0,2,10,1,1,0,7,0,5,1
8475225,2014,24.13,23.37,9,12,251,87,83,421,44,23,19,228,12,77,41
8475231,2014,11.45,10.64,4,5,90,30,39,159,18,9,3,81,446,144,42
8475233,2014,4.23,4.08,10,15,112,64,72,248,36,11,7,101,1,195,14
8475235,2014,6.82,6.53,6,4,76,34,33,143,15,5,4,71,0,261,9
8475236,2014,16.44,16.09,6,15,142,64,62,268,40,19,7,123,656,62,68
8475243,2014,0.14,0.14,0,0,1,2,0,3,0,0,0,1,0,0,1
8475246,2014,3.15,3.08,7,5,96,38,65,199,21,9,10,87,0,83,11
8475247,2014,1.93,1.94,4,2,24,11,16,51,6,0,3,24,160,91,15
8475250,2014,9.78,9.13,9,4,82,47,19,148,20,7,12,75,55,54,31
8475253,2014,0.34,0.33,0,0,5,1,2,8,0,0,1,5,0,5,0
8475254,2014,0.4,0.37,0,0,4,0,1,5,0,0,0,4,11,8,0
8475260,2014,0.02,0.02,0,0,2,1,1,4,0,0,0,2,9,4,0
8475266,2014,0.18,0.18,1,0,2,3,1,6,1,0,0,2,0,5,1
8475268,2014,8.53,8.37,7,3,76,30,20,126,13,3,3,73,3,141,27
8475274,2014,0.36,0.36,1,1,11,7,10,28,2,0,0,11,0,42,3
8475279,2014,1.56,1.5,4,2,37,17,34,88,8,2,3,35,0,70,8
8475287,2014,9.09,8.91,5,2,92,39,25,156,14,7,6,85,260,31,38
8475294,2014,0.07,0.06,0,0,3,1,5,9,0,0,0,3,0,25,0
8475295,2014,0.46,0.43,1,1,8,0,8,16,4,2,0,6,1,21,7
8475309,2014,0.41,0.42,0,0,7,1,1,9,0,0,0,7,0,8,3
8475310,2014,4.53,4.48,1,0,41,25,11,77,5,4,4,37,3,85,10
8475314,2014,25.31,24.23,9,7,197,65,41,303,41,25,14,172,1,169,23
8475321,2014,2.75,2.66,1,1,28,8,9,45,5,3,0,25,147,30,8
8475323,2014,9.77,9.43,6,4,126,29,36,191,17,7,2,119,357,29,30
8475325,2014,4.54,4.58,2,1,44,23,22,89,9,6,1,38,1,102,11
8475342,2014,0.14,0.13,0,0,2,1,0,3,0,0,0,2,0,2,0
8475414,2014,4.03,3.63,3,1,54,12,10,76,7,3,4,51,69,107,8
8475430,2014,0.4,0.38,2,1,10,6,8,24,3,0,1,10,0,19,0
8475455,2014,3.99,3.7,3,5,91,63,112,266,10,2,3,89,0,154,15
8475461,2014,0.11,0.09,0,1,1,1,0,2,1,0,1,1,0,1,1
8475462,2014,2.07,2.05,1,2,63,36,33,132,5,2,4,61,0,115,9
8475567,2014,0,0,0,0,0,0,0,0,0,0,0,0,0,1,0
8475598,2014,2.59,2.5,4,4,59,22,27,108,11,3,1,56,0,93,10
8475613,2014,1.43,1.47,3,2,38,15,20,73,7,2,3,36,0,34,7
8475619,2014,0.08,0.08,0,0,1,2,0,3,0,0,0,1,0,3,0
8475625,2014,4.6,4.55,6,5,93,30,68,191,19,8,8,85,0,55,14
8475650,2014,3.75,3.67,1,3,67,20,25,112,5,1,2,66,3,137,15
8475671,2014,6.05,5.96,1,3,92,23,26,141,12,8,2,84,3,111,13
8475690,2014,2.84,2.8,7,11,53,31,43,127,20,2,1,51,0,23,26
8475692,2014,13.82,13.6,21,13,154,62,73,289,49,15,7,139,16,120,60
8475714,2014,9.32,9.21,5,6,95,40,43,178,18,7,4,88,296,32,18
8475715,2014,0.08,0.08,0,0,2,0,1,3,0,0,0,2,2,3,0
8475716,2014,1.72,1.68,2,2,38,29,47,114,5,1,2,37,1,17,16
8475722,2014,15.76,15.57,5,0,124,47,23,194,26,21,11,103,2,67,21
8475723,2014,0.39,0.36,2,0,2,1,2,5,2,0,1,2,0,4,1
8475726,2014,19.44,18.92,17,9,200,70,75,345,49,23,17,177,4,86,37
8475727,2014,5.34,5.3,4,6,73,19,21,113,18,8,2,65,100,17,8
8475728,2014,4.76,4.63,4,6,50,22,16,88,16,6,3,44,150,59,10
8475729,2014,0.05,0.05,0,0,0,3,3,6,0,0,0,0,0,1,0
8475732,2014,0.39,0.37,0,2,7,7,11,25,2,0,0,7,0,27,1
8475733,2014,0.46,0.43,0,0,3,6,2,11,0,0,0,3,6,1,0
8475734,2014,0,0,0,0,0,0,0,0,0,0,0,0,0,4,0
8475735,2014,0.08,0.08,0,0,1,0,0,1,0,0,0,1,17,3,0
8475739,2014,2.43,2.42,1,1,27,6,13,46,5,3,0,24,4,26,6
8475744,2014,12.38,12.12,17,9,127,49,54,230,37,11,5,116,304,43,32
8475745,2014,13.98,13.63,13,11,120,51,43,214,35,11,15,109,334,137,24
8475747,2014,0.65,0.66,1,2,16,7,18,41,3,0,0,16,0,28,3
8475749,2014,2.09,1.98,0,0,26,7,14,47,1,1,2,25,0,8,5
8475750,2014,3.07,3.02,4,8,47,31,37,115,14,2,3,45,0,59,18
8475752,2014,1.56,1.49,0,0,18,13,9,40,2,2,2,16,5,55,4
8475753,2014,13.16,12.7,17,17,238,87,138,463,49,15,19,223,0,157,70
8475754,2014,24.27,23.28,10,12,190,61,68,319,42,20,14,170,354,99,53
8475755,2014,0.8,0.75,0,3,29,8,23,60,3,0,2,29,0,76,4
8475758,2014,8.94,8.7,5,9,104,45,28,177,20,6,6,98,23,205,18
8475759,2014,2.04,1.99,1,1,39,8,27,74,4,2,1,37,0,26,6
8475760,2014,22.44,21.88,8,11,207,64,54,325,43,24,13,183,486,148,23
8475761,2014,6.39,6.21,6,2,81,29,35,145,12,4,8,77,0,68,9
8475763,2014,12.64,12.24,25,3,111,33,36,180,45,17,10,94,247,57,45
8475764,2014,6.17,6.01,11,16,87,34,67,188,34,7,6,80,0,47,23
8475765,2014,27.06,26.62,17,19,264,120,147,531,73,37,17,227,0,32,35
8475767,2014,2.07,1.74,0,1,19,5,5,29,2,1,0,18,35,3,5
8475768,2014,22.28,21.66,23,12,184,47,65,296,63,28,14,156,68,54,59
8475770,2014,7.24,6.96,3,2,77,25,33,135,10,5,4,72,2,63,12
8475772,2014,15.3,14.8,14,9,123,49,48,220,36,13,10,110,484,21,22
8475774,2014,0.01,0.01,0,0,1,0,1,2,0,0,0,1,0,16,2
8475775,2014,5.65,5.43,3,2,60,23,36,119,7,2,8,58,1,71,8
8475780,2014,0.26,0.27,0,0,7,3,4,14,0,0,0,7,33,22,1
8475784,2014,21.73,20.63,9,4,235,101,117,453,31,18,22,217,21,47,62
8475790,2014,4.26,3.9,1,8,110,50,69,229,13,4,4,106,0,212,6
8475791,2014,16.37,15.62,16,8,158,58,96,312,38,14,9,144,45,67,35
8475792,2014,8.61,8.41,2,3,83,28,32,143,17,12,4,71,18,90,9
8475793,2014,21.8,20.87,24,21,202,69,83,354,71,26,9,176,851,84,60
8475794,2014,30.68,29.12,33,7,280,110,139,529,77,37,26,243,275,63,45
8475795,2014,0,0,0,0,0,0,0,0,0,0,0,0,0,2,0
8475796,2014,0.41,0.42,0,1,4,3,3,10,3,2,1,2,0,1,1
8475797,2014,0.3,0.3,1,1,5,5,6,16,2,0,0,5,0,20,1
8475798,2014,8.77,8.34,18,13,99,38,56,193,39,8,8,91,476,47,34
8475799,2014,20.3,20.08,7,6,149,66,57,272,37,24,8,125,2,155,28
8475800,2014,6.88,5.75,1,2,67,30,38,135,8,5,4,62,0,3,2
8475807,2014,3.87,3.79,1,2,42,20,25,87,3,0,4,42,2,73,12
8475808,2014,2.32,2.33,2,2,23,12,5,40,5,1,2,22,143,59,4
8475810,2014,3.2,3.01,0,1,34,5,9,48,2,1,2,33,0,21,2
8475816,2014,0.35,0.32,0,0,2,1,1,4,1,1,0,1,0,3,2
8475826,2014,0.44,0.4,0,0,3,1,0,4,0,0,1,3,0,3,0
8475829,2014,0.1,0.1,0,0,4,0,0,4,0,0,1,4,0,2,0
8475842,2014,1.33,1.3,0,1,17,5,2,24,2,1,0,16,38,30,7
8475848,2014,31.01,28.85,16,7,254,79,129,462,47,24,32,230,43,48,43
8475855,2014,8.42,8.22,4,4,52,19,18,89,14,6,3,46,4,102,13
8475868,2014,0.16,0.15,0,0,2,2,3,7,0,0,0,2,1,9,1
8475869,2014,0.48,0.49,0,0,7,7,6,20,1,1,0,6,0,18,0
8475878,2014,0.97,1.01,0,0,11,3,8,22,1,1,0,10,24,25,2
8475896,2014,0.02,0.02,0,0,0,1,1,2,0,0,0,0,0,2,0
8475902,2014,1.24,1.23,0,4,46,24,39,109,5,1,4,45,0,44,2
8475906,2014,6.47,6.16,18,11,98,42,97,237,40,11,8,87,0,54,32
8475907,2014,3.91,3.81,3,0,34,16,13,63,5,2,2,32,0,67,19
8475913,2014,22.59,21.83,22,16,157,64,40,261,64,26,9,131,7,49,98
8475917,2014,0.6,0.58,0,0,9,5,6,20,0,0,1,9,1,11,1
8475958,2014,0.04,0.04,0,1,2,1,3,6,1,0,0,2,9,0,0
8475980,2014,0.03,0.03,0,0,0,1,1,2,0,0,0,0,7,3,0
8475996,2014,0.58,0.57,0,1,10,5,8,23,1,0,0,10,42,12,4
8476043,2014,0.13,0.13,0,0,4,1,2,7,0,0,0,4,17,3,1
8476062,2014,11.04,10.77,7,7,129,57,57,243,31,17,5,112,471,111,39
8476116,2014,14.48,14.24,11,6,143,71,50,264,25,8,17,135,16,82,27
8476147,2014,0.24,0.22,0,1,1,2,1,4,2,1,0,0,16,8,4
8476158,2014,0.08,0.09,0,0,1,0,2,3,0,0,0,1,0,6,1
8476162,2014,0.01,0.01,0,0,1,0,1,2,0,0,0,1,0,2,0
8476166,2014,0.76,0.74,1,3,12,5,9,26,4,0,2,12,0,0,3
8476177,2014,13.72,13.25,12,10,142,59,55,256,30,8,11,134,11,108,32
8476179,2014,0.03,0.03,0,0,2,0,1,3,0,0,0,2,4,3,2
8476191,2014,1.32,1.31,1,4,37,19,31,87,7,2,1,35,0,87,7
8476195,2014,1.73,1.7,0,2,23,6,3,32,3,1,2,22,1,19,6
8476207,2014,2.16,2.15,3,2,21,10,7,38,5,0,1,21,4,14,7
8476209,2014,0.63,0.63,1,0,13,3,3,19,1,0,0,13,0,12,2
8476214,2014,0.14,0.14,0,0,2,1,1,4,0,0,0,2,0,0,1
8476227,2014,0.04,0.04,0,0,1,0,1,2,1,1,0,0,0,5,0
8476235,2014,12.04,11.43,13,9,104,39,39,182,31,9,7,95,1,9,22
8476244,2014,2.21,2.14,1,1,52,34,46,132,4,2,5,50,0,24,12
8476279,2014,2.1,2.04,4,6,40,23,38,101,10,0,6,40,0,42,16
8476289,2014,0.24,0.25,0,1,7,4,8,19,2,1,0,6,0,9,4
8476292,2014,18.01,17.34,25,22,139,62,66,267,63,16,11,123,10,124,43
8476293,2014,0,0,0,0,0,0,0,0,0,0,0,0,0,0,0
8476300,2014,2.27,2.25,1,4,44,18,21,83,7,2,2,42,0,42,16
8476302,2014,0.38,0.36,0,0,8,5,3,16,1,1,1,7,0,15,1
8476312,2014,0.86,0.81,1,2,26,8,21,55,3,0,0,26,0,44,9
8476336,2014,2.41,2.4,0,2,34,4,15,53,3,1,2,33,1,51,0
8476339,2014,0,0,0,0,0,0,0,0,0,0,0,0,0,2,0
8476344,2014,0.29,0.3,0,0,4,1,1,6,0,0,1,4,6,0,2
8476346,2014,19.5,18.8,24,16,167,50,65,282,64,24,9,143,3,14,67
8476356,2014,17.41,16.99,2,6,189,66,63,318,21,13,8,176,1,123,40
8476363,2014,0.63,0.53,1,0,6,3,6,15,1,0,0,6,0,20,1
8476381,2014,21.43,20.54,4,7,146,41,43,230,26,15,12,131,357,127,17
8476384,2014,0,0,0,0,0,0,1,1,0,0,0,0,0,2,0
8476386,2014,0.45,0.39,0,1,2,2,2,6,1,0,0,2,0,2,0
8476389,2014,7.57,7.45,12,3,89,33,25,147,22,7,5,82,234,93,21
8476392,2014,13.44,13.1,9,3,104,41,39,184,23,11,8,93,402,256,25
8476393,2014,0.51,0.51,0,0,6,1,2,9,0,0,0,6,23,13,5
8476394,2014,0.05,0.05,0,1,2,1,0,3,1,0,0,2,0,0,0
8476397,2014,0,0,0,0,0,0,4,4,0,0,0,0,0,3,2
8476403,2014,1.21,1.21,2,1,20,19,15,54,4,1,0,19,0,64,9
8476404,2014,2.11,2.06,0,1,14,10,4,28,3,2,0,12,32,33,7
8476406,2014,2.2,2.23,2,4,33,16,8,57,7,1,3,32,127,51,8
8476410,2014,0.95,0.96,0,0,10,3,3,16,1,1,0,9,0,5,7
8476419,2014,8.38,8.2,4,5,97,27,23,147,19,10,7,87,335,158,19
8476423,2014,2.02,1.88,0,0,20,11,6,37,1,1,0,19,0,9,7
8476426,2014,0.08,0.07,1,1,3,1,3,7,2,0,0,3,0,5,1
8476427,2014,0.78,0.77,1,1,8,4,6,18,2,0,0,8,0,15,0
8476428,2014,1.26,1.29,0,0,18,4,4,26,1,1,1,17,6,7,3
8476430,2014,7.91,7.72,9,6,92,42,35,169,18,3,9,89,0,97,19
8476431,2014,1.05,1.04,1,2,17,13,19,49,4,1,1,16,0,9,2
8476432,2014,9.38,9.13,6,2,83,25,29,137,17,9,10,74,151,102,18
8476435,2014,0.02,0.02,0,0,1,0,0,1,0,0,0,1,9,1,0
8476436,2014,11,10.79,2,3,108,49,34,191,18,13,8,95,3,146,16
8476437,2014,13.77,12.97,10,12,172,55,69,296,33,11,20,161,468,42,46
8476438,2014,21.95,21.34,16,13,203,58,62,323,52,23,10,180,38,53,46
8476439,2014,7.72,7.53,1,2,78,29,32,139,9,6,9,72,1,89,9
8476440,2014,7.52,7.31,5,5,65,17,38,120,18,8,4,57,193,44,27
8476442,2014,15.22,14.91,10,7,135,45,41,221,27,10,12,125,0,24,38
8476443,2014,1.39,1.4,1,0,27,16,23,66,3,2,0,25,0,11,2
8476447,2014,0.68,0.57,0,0,4,0,0,4,1,1,1,3,0,7,0
8476448,2014,2.34,2.35,2,0,29,15,8,52,5,3,0,26,93,18,8
8476449,2014,0.41,0.38,0,0,9,4,4,17,0,0,0,9,0,12,1
8476451,2014,4.2,4.06,1,2,44,10,9,63,5,2,4,42,0,59,7
8476452,2014,0.01,0.01,0,0,1,0,2,3,0,0,0,1,0,0,0
8476453,2014,19.93,19.68,22,14,191,70,62,323,65,29,11,162,0,65,22
8476454,2014,18.95,18.27,15,17,189,62,108,359,56,24,13,165,620,92,54
8476455,2014,23.23,22.04,21,15,214,66,69,349,59,23,23,191,16,169,52
8476456,2014,18,16,27,12,170,36,59,265,54,15,13,155,2,68,34
8476457,2014,2.98,2.87,9,12,91,33,54,178,24,3,6,88,0,92,21
8476458,2014,15.24,14.82,25,8,179,42,65,286,50,17,16,162,149,92,38
8476459,2014,17.43,16.63,16,10,150,72,71,293,46,20,14,130,615,149,34
8476460,2014,19.69,18.74,15,19,170,63,77,310,49,15,6,155,492,100,54
8476461,2014,13.87,13.51,13,9,148,53,70,271,37,15,16,133,643,72,40
8476462,2014,7.15,6.9,11,21,188,75,130,393,42,10,7,178,0,106,24
8476463,2014,3.6,3.44,4,10,95,28,63,186,17,3,6,92,0,31,33
8476464,2014,0,0,0,0,0,0,0,0,0,0,0,0,0,2,0
8476465,2014,2.89,2.82,8,1,61,22,44,127,13,4,5,57,0,20,20
8476466,2014,1.25,1.27,4,0,15,4,5,24,6,2,1,13,0,8,7
8476467,2014,1.28,1.25,2,5,36,11,14,61,8,1,3,35,0,82,9
8476468,2014,10.75,10.57,8,5,92,35,28,155,23,10,2,82,93,89,27
8476469,2014,0,0,0,0,0,0,0,0,0,0,0,0,0,4,0
8476470,2014,2.64,2.52,4,4,62,36,49,147,9,1,5,61,0,50,8
8476472,2014,3.88,3.77,7,11,98,56,73,227,20,2,5,96,0,45,48
8476473,2014,2.97,2.89,1,2,72,37,51,160,7,4,5,68,0,137,8
8476474,2014,0.09,0.08,0,0,0,1,0,1,0,0,0,0,0,0,0
8476476,2014,0.76,0.75,0,0,20,10,18,48,1,1,0,19,0,18,2
8476477,2014,2.06,1.97,0,1,14,7,5,26,3,2,3,12,0,9,3
8476478,2014,0.54,0.54,3,0,13,4,7,24,3,0,2,13,0,14,7
8476479,2014,0.1,0.09,0,0,2,1,1,4,0,0,0,2,6,3,0
8476480,2014,6.61,6.36,4,3,46,14,12,72,16,9,6,37,70,41,16
8476482,2014,0.39,0.4,0,0,7,0,2,9,0,0,0,7,0,7,0
8476483,2014,9.32,9.11,11,11,105,48,39,192,31,9,4,96,310,79,18
8476495,2014,3.44,3.33,1,3,33,20,16,69,10,6,0,27,3,14,12
8476536,2014,0.02,0.02,0,0,1,0,0,1,0,0,0,1,4,1,0
8476539,2014,0.21,0.21,0,0,3,1,1,5,1,1,1,2,1,4,1
8476549,2014,0.28,0.3,0,1,5,1,1,7,1,0,0,5,1,2,1
8476624,2014,6.77,6.15,7,1,68,26,37,131,12,4,1,64,12,76,27
8476769,2014,0.76,0.7,0,0,6,4,4,14,0,0,0,6,0,26,0
8476779,2014,0.95,0.92,2,0,20,13,16,49,3,1,2,19,0,8,6
8476792,2014,9.55,9.33,14,13,205,88,128,421,39,12,14,193,0,75,15
8476798,2014,0.27,0.27,0,0,9,2,12,23,0,0,0,9,0,23,1
8476799,2014,0.1,0.1,0,0,2,2,3,7,0,0,0,2,0,4,0
8476806,2014,6.72,6.71,3,3,74,26,24,124,9,3,3,71,6,43,7
8476807,2014,1.59,1.51,2,4,37,28,20,85,8,2,2,35,0,48,11
8476808,2014,7.11,6.78,8,4,82,26,24,132,17,5,3,77,172,44,12
8476822,2014,11.58,11.13,2,4,104,26,21,151,18,12,2,92,499,147,26
8476850,2014,0.2,0.19,1,1,8,4,5,17,3,1,0,7,0,5,5
8476851,2014,18.7,17.92,15,11,163,66,71,300,46,20,10,143,82,91,24
8476852,2014,0.1,0.1,0,1,4,4,3,11,1,0,0,4,0,14,0
8476853,2014,6.43,5.89,11,10,148,61,103,312,29,8,3,140,0,98,41
8476854,2014,5.55,5.37,15,12,107,44,84,235,34,7,5,100,0,59,29
8476855,2014,17.7,17.18,12,7,191,66,80,337,33,14,15,177,0,97,34
8476856,2014,4.22,3.94,3,5,86,39,63,188,16,8,5,78,0,42,9
8476868,2014,0.33,0.32,0,0,4,1,0,5,0,0,0,4,2,5,1
8476870,2014,0.69,0.67,0,0,8,2,3,13,1,1,0,7,0,17,2
8476871,2014,6.37,6.21,2,2,68,38,25,131,16,12,2,56,5,46,18
8476872,2014,4.59,4.49,3,1,51,14,24,89,6,2,3,49,134,58,11
8476874,2014,1.61,1.6,4,4,27,11,18,56,9,1,0,26,0,18,3
8476878,2014,13.13,12.49,5,10,115,37,31,183,30,15,7,100,440,127,19
8476879,2014,5.15,5.09,9,7,130,43,72,245,21,5,8,125,0,89,14
8476880,2014,9.02,8.37,7,6,79,33,38,150,17,4,4,75,2,205,20
8476881,2014,19.43,18.71,6,12,145,66,78,289,31,13,22,132,38,106,29
8476882,2014,5.16,4.98,4,1,66,12,25,103,9,4,5,62,29,11,11
8476884,2014,3.22,3.1,3,2,56,20,38,114,7,2,2,54,0,15,11
8476885,2014,8.62,8.26,8,7,133,60,128,321,22,7,11,126,0,97,28
8476886,2014,0.14,0.14,0,0,6,1,1,8,0,0,0,6,0,2,1
8476887,2014,20.67,20.33,20,17,237,131,103,471,63,26,14,211,3,108,50
8476888,2014,3.13,3.04,0,3,35,10,12,57,6,3,1,32,153,28,2
8476906,2014,0.12,0.11,0,0,2,3,1,6,0,0,0,2,0,0,1
8476919,2014,5.05,5.02,10,5,48,18,23,89,21,6,5,42,150,11,19
8476921,2014,0.96,0.91,0,1,8,12,2,22,1,0,3,8,1,14,2
8476923,2014,3.37,3.28,2,10,93,47,65,205,17,5,2,88,0,19,14
8476931,2014,0.05,0.05,0,0,2,1,0,3,0,0,1,2,0,4,0
8476944,2014,0.14,0.14,0,0,3,0,1,4,0,0,0,3,0,2,0
8476967,2014,0,0,0,0,0,0,1,1,0,0,0,0,0,0,0
8476975,2014,11.03,10.91,4,3,91,38,24,153,19,12,9,79,112,127,24
8476981,2014,0.54,0.55,0,1,10,3,6,19,1,0,0,10,0,24,3
8476989,2014,1.3,1.28,1,0,32,8,13,53,3,2,0,30,0,26,6
8477059,2014,2.93,2.91,3,2,29,14,16,59,7,2,2,27,2,7,6
8477070,2014,1.64,1.6,1,0,16,3,3,22,2,1,0,15,1,35,3
8477126,2014,0.86,0.85,0,1,13,4,6,23,1,0,0,13,0,40,3
8477127,2014,0,0,0,0,0,0,0,0,0,0,0,0,0,1,0
8477205,2014,2.26,2.18,5,8,55,23,54,132,13,0,2,55,0,39,17
8477213,2014,1.31,1.25,1,0,19,3,4,26,2,1,1,18,74,44,3
8477214,2014,0.04,0.04,0,0,2,0,2,4,0,0,0,2,0,6,0
8477215,2014,3.26,3.21,10,19,89,56,72,217,31,2,7,87,0,74,14
8477220,2014,1.76,1.78,0,3,40,14,33,87,4,1,3,39,0,34,11
8477227,2014,0.78,0.79,0,0,10,0,0,10,0,0,1,10,1,7,1
8477228,2014,0.22,0.21,0,0,3,1,1,5,0,0,0,3,0,2,0
8477244,2014,0.09,0.09,1,0,4,0,2,6,1,0,0,4,0,6,0
8477249,2014,1.21,1.16,3,2,14,6,2,22,6,1,2,13,1,7,3
8477290,2014,17,16.58,2,5,134,46,42,222,28,21,5,113,44,172,21
8477407,2014,2.18,2.13,4,2,18,8,10,36,7,1,0,17,0,6,5
8477410,2014,0.38,0.36,0,0,1,0,0,1,0,0,0,1,3,2,0
8477413,2014,0.65,0.65,1,0,12,1,8,21,3,2,0,10,3,5,1
8477429,2014,0.26,0.25,1,0,4,0,0,4,1,0,0,4,6,0,0
8477444,2014,6.58,6.35,6,7,65,36,41,142,22,9,3,56,74,22,18
8477448,2014,8.04,7.85,8,5,84,20,25,129,21,8,4,76,16,94,18
8477451,2014,0.92,0.86,0,0,8,2,1,11,0,0,0,8,0,11,0
8477455,2014,3.61,3.63,1,1,38,10,19,67,6,4,2,34,64,71,6
8477486,2014,0.16,0.17,0,1,2,2,2,6,1,0,0,2,0,7,3
8477492,2014,18.29,17.16,15,9,192,65,66,323,38,14,16,178,201,43,45
8477493,2014,12.76,12.53,9,11,123,36,40,199,36,16,7,107,462,35,42
8477494,2014,9.24,8.92,16,12,76,32,46,154,32,4,8,72,11,55,36
8477495,2014,7.22,6.99,9,10,123,47,94,264,27,8,7,115,0,72,41
8477496,2014,17.88,17.2,13,9,170,53,79,302,39,17,12,153,115,106,36
8477497,2014,25.97,24.84,20,11,191,75,78,344,62,31,12,160,902,39,81
8477498,2014,0.02,0.02,0,0,2,0,2,4,0,0,0,2,0,5,0
8477499,2014,6.56,6.43,6,6,121,37,64,222,20,8,2,113,1,118,9
8477500,2014,12.89,11.73,7,5,93,27,22,142,25,13,6,80,436,70,13
8477501,2014,0.79,0.79,0,1,6,6,7,19,1,0,0,6,0,7,5
8477505,2014,8.27,7.93,9,7,85,22,37,144,20,4,8,81,288,58,25
8477507,2014,2.97,2.82,6,6,52,24,28,104,15,3,4,49,1,134,11
8477508,2014,9.9,9.65,7,2,92,34,39,165,15,6,6,86,129,167,24
8477509,2014,1.1,1.08,1,2,31,13,25,69,4,1,1,30,0,49,19
8477510,2014,0.37,0.39,3,0,4,3,3,10,3,0,2,4,0,11,2
8477589,2014,3.08,2.98,5,3,38,12,18,68,12,4,2,34,0,71,13
8477591,2014,11.24,11.09,6,6,89,41,33,163,24,12,7,77,276,59,39
8477715,2014,0.01,0.01,0,0,1,0,0,1,0,0,0,1,9,2,1
8477845,2014,0.81,0.78,1,0,21,5,15,41,1,0,0,21,0,4,9
8477850,2014,1.39,1.35,5,3,39,18,29,86,10,2,2,37,0,46,9
8477851,2014,0.21,0.2,1,0,7,4,5,16,1,0,1,7,0,2,2
8477887,2014,0.17,0.17,0,0,4,3,3,10,0,0,0,4,0,11,1
8477902,2014,6.53,6.43,4,5,62,25,22,109,12,3,7,59,0,73,20
8477913,2014,0.21,0.2,0,0,1,2,1,4,0,0,0,1,1,6,1
8477916,2014,0.79,0.81,1,0,6,1,4,11,2,1,0,5,0,22,5
8477922,2014,12.11,11.59,5,6,100,41,33,174,24,13,6,87,13,51,21
8477930,2014,10.2,10.12,4,2,113,46,45,204,12,6,10,107,360,121,32
8477932,2014,9.19,8.84,10,17,170,68,113,351,39,12,16,158,0,109,26
8477933,2014,0.26,0.24,0,1,3,0,3,6,1,0,0,3,21,3,2
8477934,2014,4.39,4.15,6,1,49,18,10,77,9,2,6,47,128,21,14
8477935,2014,0.2,0.2,1,0,1,1,1,3,1,0,0,1,1,0,1
8477942,2014,0.21,0.2,0,0,3,0,0,3,0,0,0,3,0,0,2
8477956,2014,9.3,9.04,8,9,93,42,40,175,27,10,2,83,5,20,25
8478042,2014,0.45,0.44,0,0,9,5,4,18,0,0,1,9,0,3,3
8478137,2014,8.78,8.67,3,11,85,45,32,162,23,9,4,76,0,75,26
8478376,2014,0.49,0.48,0,0,9,1,1,11,1,1,0,8,0,3,1
8478393,2014,0.35,0.34,0,0,4,4,0,8,0,0,0,4,0,12,1
8448208,2013,26.75,26.32,23,20,231,78,76,385,67,24,17,207,0,4,36
8457981,2013,13.1,12.6,10,8,111,47,36,194,27,9,13,102,46,15,16
8458537,2013,11.05,10.68,14,9,124,52,61,237,32,9,10,115,1,14,25
8458951,2013,3.75,3.61,8,12,89,40,81,210,22,2,5,87,0,71,10
8459442,2013,8.25,8.02,8,10,81,24,24,129,29,11,5,70,538,29,25
8459444,2013,11.11,10.6,4,3,100,32,21,153,16,9,7,91,9,72,13
8459628,2013,0.06,0.06,0,0,1,3,2,6,0,0,0,1,0,7,1
8459670,2013,6.69,6.45,16,13,152,61,80,293,35,6,12,146,0,75,13
8460492,2013,1.45,1.38,1,3,44,11,28,83,5,1,1,43,0,34,8
8460496,2013,14.34,13.73,6,7,129,46,27,202,23,10,11,119,91,58,27
8460542,2013,10.77,10.59,19,16,116,29,48,193,53,18,2,98,276,26,26
8460621,2013,15.49,14.59,16,15,151,51,69,271,49,18,7,133,5,59,24
8460626,2013,1.12,1.14,3,0,24,14,33,71,4,1,1,23,0,47,12
8460720,2013,1.48,1.43,1,1,21,3,7,31,4,2,2,19,0,32,1
8462038,2013,20.56,19.15,16,8,167,81,70,318,47,23,10,144,6,135,48
8462041,2013,4.39,4.38,4,1,52,19,21,92,9,4,3,48,6,17,26
8462042,2013,24.71,24.1,19,12,209,91,95,395,61,30,12,179,8,142,30
8462129,2013,5.03,4.96,5,7,50,10,16,76,16,4,2,46,329,35,14
8462196,2013,2.06,1.96,2,3,56,29,37,122,10,5,5,51,0,96,4
8464956,2013,3.54,3.25,6,8,90,29,54,173,15,1,5,89,0,140,10
8464966,2013,3.27,3.16,6,6,82,54,64,200,17,5,9,77,0,99,21
8464975,2013,12.32,11.86,9,3,118,32,38,188,25,13,14,105,171,23,22
8464977,2013,13.58,13.38,5,8,121,35,32,188,26,13,6,108,216,107,19
8464981,2013,1.26,1.22,1,8,48,23,40,111,10,1,3,47,0,107,14
8464989,2013,13.91,13.54,19,10,134,39,57,230,39,10,8,124,438,18,30
8465009,2013,14.48,13.16,13,10,168,72,101,341,40,17,5,151,0,163,20
8465025,2013,0.02,0.02,0,0,1,0,1,2,0,0,0,1,0,8,0
8465058,2013,1.24,1.19,3,4,39,10,26,75,8,1,2,38,0,67,15
8465166,2013,6.63,6.33,5,1,73,27,25,125,11,5,8,68,61,190,15
8465185,2013,2.81,2.77,2,9,73,42,62,177,12,1,6,72,0,102,10
8465202,2013,3.65,3.59,6,7,81,47,51,179,17,4,5,77,0,57,17
8465914,2013,1.07,1.07,2,2,34,13,28,75,6,2,1,32,0,80,7
8465951,2013,10.02,9.89,13,5,104,34,45,183,28,10,7,94,10,190,34
8465978,2013,5.91,5.87,2,1,93,34,23,150,8,5,3,88,3,111,13
8466138,2013,13.76,13.05,36,29,122,44,60,226,76,11,10,111,617,54,76
8466139,2013,32.04,31.04,23,14,285,98,99,482,70,33,29,252,163,85,50
8466140,2013,17.19,16.59,19,6,171,58,64,293,43,18,8,153,612,120,20
8466142,2013,4.79,4.74,7,6,83,44,51,178,17,4,9,79,0,139,17
8466148,2013,26.33,26.13,19,11,242,58,109,409,60,30,7,212,1,43,75
8466149,2013,5.05,5.01,3,1,64,15,20,99,8,4,3,60,12,51,12
8466158,2013,3.01,2.98,4,5,52,26,27,105,12,3,2,49,0,29,13
8466160,2013,6.56,6.36,8,4,56,16,14,86,25,13,1,43,9,110,12
8466182,2013,1.59,1.54,2,4,40,14,40,94,8,2,3,38,1,39,28
8466215,2013,1.87,1.73,4,3,54,19,30,103,10,3,2,51,0,15,5
8466251,2013,17.67,16.54,18,9,167,45,42,254,42,15,13,152,38,140,25
8466285,2013,6.54,6,17,13,116,64,99,279,37,7,9,109,0,50,43
8466309,2013,0.02,0.02,0,0,1,1,3,5,0,0,0,1,0,3,1
8466333,2013,2.93,2.86,4,11,77,22,49,148,18,3,5,74,2,135,13
8466378,2013,25.11,23.92,23,16,204,89,77,370,69,30,8,174,68,24,65
8466393,2013,8.81,8.41,11,2,97,34,30,161,20,7,7,90,2,68,12
8467096,2013,11.56,10.93,12,12,154,48,104,306,36,12,9,142,0,46,26
8467329,2013,17.3,16.95,12,5,132,56,52,240,37,20,7,112,200,77,16
8467330,2013,16.11,15.87,23,14,146,43,31,220,51,14,11,132,585,49,37
8467331,2013,2.83,2.77,4,4,64,31,70,165,11,3,4,61,0,122,13
8467332,2013,1.56,1.57,0,10,60,35,44,139,10,0,4,60,0,121,8
8467334,2013,5.43,5.23,4,2,53,15,18,86,13,7,5,46,566,82,24
8467336,2013,0.27,0.28,1,0,6,1,4,11,1,0,1,6,0,13,0
8467338,2013,1.79,1.8,1,6,24,4,10,38,11,4,1,20,1,8,9
8467344,2013,2.01,1.96,5,6,73,33,55,161,14,3,6,70,0,211,5
8467351,2013,3.03,2.86,4,6,56,15,17,88,12,2,4,54,239,16,20
8467365,2013,1.28,1.21,2,1,38,12,27,77,4,1,4,37,0,64,4
8467370,2013,17.62,17.02,16,13,177,49,54,280,49,20,12,157,596,144,34
8467371,2013,11.37,10.98,17,14,110,28,38,176,47,16,6,94,391,72,24
8467389,2013,18.77,18.11,22,9,259,105,149,513,51,20,12,239,512,24,33
8467396,2013,16.52,15.65,7,6,139,60,67,266,29,16,8,123,19,89,31
8467400,2013,4.26,4.09,6,7,100,48,77,225,17,4,6,96,0,112,17
8467407,2013,19.71,18.91,16,6,184,81,71,336,40,18,11,166,23,46,38
8467423,2013,9.41,9.07,11,2,69,17,25,111,20,7,6,62,209,63,34
8467428,2013,1.29,1.28,2,2,19,6,6,31,4,0,0,19,1,64,4
8467452,2013,0.57,0.55,4,0,28,5,17,50,4,0,2,28,0,18,7
8467463,2013,1.86,1.75,2,0,36,10,10,56,3,1,4,35,0,13,4
8467493,2013,9.46,8.98,4,2,99,35,40,174,14,8,12,91,1,253,16
8467496,2013,5.72,5.54,21,15,131,60,101,292,43,7,12,124,0,49,35
8467514,2013,13.06,12.56,12,8,126,39,50,215,37,17,9,109,446,30,59
8467545,2013,17.19,16.64,6,10,166,58,66,290,34,18,7,148,4,51,24
8467831,2013,4.07,4.03,3,4,45,12,17,74,12,5,5,40,296,65,13
8467875,2013,17.75,17.11,19,9,201,65,60,326,43,15,19,186,5,30,23
8467876,2013,14.79,14.18,20,22,120,47,54,221,54,12,4,108,577,50,31
8467881,2013,5.18,5.09,1,0,52,25,17,94,5,4,6,48,7,70,12
8467890,2013,2.32,2.3,5,7,83,35,45,163,15,3,7,80,0,96,25
8467899,2013,8.62,7.97,8,2,72,37,29,138,22,12,9,60,0,9,15
8467910,2013,0.15,0.16,0,1,3,2,1,6,1,0,0,3,0,7,1
8467917,2013,1.3,1.12,3,2,40,8,18,66,6,1,0,39,0,8,2
8467925,2013,6.19,5.97,3,2,61,19,23,103,9,4,3,57,314,77,18
8467931,2013,1.14,1.1,3,0,50,16,24,90,3,0,3,50,0,58,9
8467967,2013,7.83,7.85,6,3,69,24,29,122,18,9,3,60,283,72,32
8467977,2013,3.68,3.61,3,1,79,24,23,126,8,4,5,75,2,82,14
8467988,2013,8.1,7.97,6,4,95,24,21,140,15,5,8,90,2,75,11
8468001,2013,6.57,6.5,6,3,70,32,31,133,18,9,6,61,256,241,24
8468064,2013,6.66,6.57,14,12,53,37,21,111,29,3,5,50,97,75,16
8468083,2013,11.63,11.34,20,12,151,61,55,267,48,16,4,135,259,23,28
8468085,2013,24.22,23.09,14,17,263,114,98,475,51,20,19,243,17,68,41
8468095,2013,0.37,0.41,0,1,4,1,0,5,1,0,0,4,0,14,0
8468101,2013,0.66,0.64,1,2,12,11,17,40,3,0,1,12,0,9,5
8468114,2013,0.94,0.88,0,2,26,15,29,70,2,0,3,26,0,144,5
8468162,2013,0.56,0.56,0,0,2,6,3,11,0,0,0,2,126,36,2
8468208,2013,17.81,17.51,9,16,133,47,48,228,49,24,13,109,90,54,48
8468309,2013,8.29,8.12,18,16,121,58,100,279,44,10,14,111,0,41,16
8468478,2013,1.87,1.83,2,10,53,32,27,112,13,1,6,52,1,121,15
8468482,2013,13.75,13.08,12,4,110,46,46,202,28,12,12,98,7,33,21
8468483,2013,9.09,9.01,10,9,103,39,33,175,30,11,5,92,0,15,11
8468484,2013,0.61,0.6,1,2,22,7,18,47,4,1,0,21,0,41,1
8468485,2013,1.1,1.14,1,1,9,3,2,14,5,3,0,6,2,9,1
8468486,2013,22.09,21.09,19,13,207,89,58,354,52,20,18,187,4,155,19
8468493,2013,3.71,3.5,5,6,72,35,63,170,15,4,5,68,0,96,36
8468498,2013,1.54,1.48,3,8,50,26,51,127,13,2,4,48,0,221,11
8468501,2013,1.43,1.43,6,2,42,33,39,114,8,0,3,42,0,129,9
8468504,2013,20.21,19.48,5,10,176,75,55,306,36,21,9,155,37,46,38
8468505,2013,12.39,11.96,13,1,127,35,37,199,23,9,9,118,494,246,15
8468508,2013,24.87,24.09,10,14,239,100,65,404,43,19,18,220,2,44,25
8468509,2013,6.91,6.43,13,28,110,60,74,244,49,8,14,102,0,93,25
8468513,2013,1.15,1.1,3,2,33,17,21,71,5,0,2,33,0,69,1
8468518,2013,8.48,8.22,6,2,95,30,26,151,12,4,10,91,8,31,17
8468526,2013,11.02,10.52,14,5,109,50,48,207,27,8,12,101,678,202,14
8468535,2013,21.13,20.63,12,9,160,46,41,247,45,24,10,136,1005,90,42
8468542,2013,3.78,3.65,4,8,54,29,31,114,15,3,2,51,0,30,12
8468575,2013,7.52,7.53,8,4,96,26,23,145,18,6,10,90,354,62,18
8468598,2013,1.87,1.82,2,6,34,12,38,84,11,3,2,31,0,14,15
8468611,2013,7.47,7.09,1,1,102,30,28,160,7,5,3,97,34,180,19
8468635,2013,8.31,7.88,5,5,56,29,18,103,12,2,3,54,7,92,15
8468639,2013,2.56,2.46,4,3,56,21,37,114,9,2,4,54,1,50,14
8468674,2013,2.49,2.42,0,6,59,11,19,89,12,6,4,53,0,117,8
8468700,2013,9.92,9.33,7,4,74,16,20,110,21,10,4,64,696,122,25
8468745,2013,0.53,0.52,1,3,12,11,10,33,4,0,0,12,0,40,0
8468778,2013,1.13,1.09,0,0,12,10,5,27,0,0,1,12,1,112,3
8469455,2013,21.75,20.37,26,17,223,82,87,392,66,23,17,200,775,17,47
8469457,2013,2.86,2.73,1,1,28,4,5,37,4,2,2,26,184,4,13
8469459,2013,12.55,12.08,28,15,147,69,72,288,54,11,12,136,719,33,49
8469460,2013,0.61,0.58,1,3,20,7,24,51,4,0,1,20,0,70,3
8469462,2013,12.84,12.55,6,10,105,55,47,207,24,8,11,97,14,216,32
8469465,2013,5.63,5.44,13,4,150,58,100,308,22,5,12,145,0,87,48
8469466,2013,13.47,13.06,15,15,138,40,57,235,43,13,9,125,1,37,44
8469467,2013,3.79,3.67,0,0,37,16,15,68,2,2,2,35,1,49,10
8469469,2013,14.47,14.35,12,4,136,38,42,216,34,18,9,118,25,113,31
8469470,2013,0.74,0.72,3,0,18,10,24,52,4,1,1,17,0,29,1
8469473,2013,11.16,10.64,4,10,117,53,55,225,25,11,6,106,658,119,21
8469476,2013,1.2,1.18,1,4,43,8,29,80,6,1,1,42,0,156,9
8469483,2013,0.6,0.54,0,0,8,1,2,11,0,0,0,8,44,15,1
8469485,2013,11.66,11.41,16,12,114,50,48,212,37,9,9,105,219,13,22
8469490,2013,3.9,3.75,0,1,46,8,11,65,5,4,2,42,2,69,4
8469492,2013,4.92,4.68,6,16,87,47,48,182,26,4,6,83,0,91,16
8469500,2013,16.97,16.49,12,7,191,65,87,343,45,26,10,165,88,26,30
8469501,2013,3.69,3.59,4,5,26,15,9,50,11,2,0,24,20,108,4
8469506,2013,24.32,23.45,17,13,226,85,84,395,60,30,20,196,87,23,37
8469508,2013,7.77,7.43,5,1,67,24,45,136,10,4,3,63,676,141,36
8469521,2013,17.58,17.21,13,10,199,91,83,373,43,20,16,179,822,44,38
8469531,2013,4.55,4.44,4,7,103,39,74,216,15,4,7,99,0,141,8
8469542,2013,1.6,1.56,0,0,26,6,11,43,3,3,1,23,1,41,9
8469544,2013,25.5,25.11,27,17,313,106,148,567,78,34,12,279,83,55,41
8469547,2013,0.54,0.54,0,1,11,6,3,20,1,0,0,11,0,27,0
8469555,2013,6.76,6.45,9,18,161,75,98,334,33,6,7,155,0,49,36
8469591,2013,1.6,1.59,4,1,26,9,11,46,7,2,1,24,89,76,7
8469598,2013,8.05,7.62,9,11,167,62,109,338,24,4,11,163,1,144,32
8469619,2013,1.12,1.11,5,4,53,20,42,115,10,1,1,52,0,61,7
8469622,2013,8.63,8.55,14,5,74,19,17,110,26,7,3,67,1,82,8
8469623,2013,9.31,8.92,15,15,128,50,81,259,42,12,8,116,0,124,19
8469626,2013,0.18,0.18,0,0,5,2,6,13,0,0,0,5,0,6,0
8469638,2013,13.75,13.55,22,14,172,52,73,297,57,21,3,151,160,34,22
8469639,2013,8.58,8.22,5,2,75,19,35,129,15,8,3,67,203,62,20
8469664,2013,13.01,12.86,6,8,151,61,57,269,22,8,5,143,21,120,32
8469665,2013,2.54,2.47,5,8,83,27,51,161,16,3,1,80,1,49,15
8469707,2013,12.84,12.36,11,8,110,37,35,182,33,14,8,96,2,35,21
8469752,2013,0.1,0.09,0,0,1,0,1,2,0,0,0,1,1,3,0
8469759,2013,7.87,7.78,10,7,109,36,37,182,23,6,9,103,513,45,21
8469760,2013,1.95,1.91,5,3,78,26,58,162,10,2,7,76,0,55,27
8469770,2013,6.03,5.59,5,12,102,57,68,227,21,4,3,98,0,62,13
8469779,2013,0.05,0.05,0,0,1,0,0,1,0,0,0,1,9,0,1
8469798,2013,0.02,0.02,0,1,0,1,1,2,1,0,0,0,0,0,0
8469820,2013,1.24,1.22,1,1,21,10,5,36,3,1,1,20,345,46,7
8469992,2013,2.37,2.21,5,0,43,21,31,95,7,2,2,41,0,64,7
8470018,2013,4.42,4.36,2,0,70,20,12,102,6,4,2,66,69,37,17
8470039,2013,16.43,15.92,14,6,188,73,99,360,28,8,11,180,5,59,30
8470041,2013,21.69,21.24,10,3,258,75,82,415,39,26,11,232,2,11,51
8470047,2013,14.75,14.37,21,12,131,37,40,208,58,25,8,106,693,33,53
8470054,2013,1.58,1.49,4,3,29,15,34,78,9,2,3,27,0,58,7
8470063,2013,0.97,0.99,0,0,9,7,2,18,0,0,0,9,39,23,2
8470065,2013,0.43,0.42,0,0,4,0,1,5,0,0,0,4,0,8,0
8470085,2013,3.58,3.47,6,2,59,30,29,118,14,6,6,53,0,115,39
8470104,2013,5.3,4.91,13,12,93,54,68,215,28,3,10,90,0,59,16
8470105,2013,12.38,11.96,16,6,161,49,70,280,37,15,15,146,32,134,35
8470110,2013,6.11,5.88,9,7,107,56,69,232,25,9,3,98,0,42,15
8470120,2013,21.58,20.55,13,7,210,122,154,486,42,22,12,188,1,22,49
8470121,2013,1.89,1.9,3,1,38,28,23,89,6,2,5,36,0,118,1
8470123,2013,1.59,1.58,0,0,11,2,2,15,3,3,0,8,0,32,0
8470144,2013,19.03,17.66,23,10,167,54,61,282,58,25,12,142,534,39,50
8470151,2013,5.82,5.73,14,19,152,61,76,289,37,4,8,148,3,51,18
8470153,2013,4.13,4.03,2,3,51,12,19,82,9,4,3,47,3,7,10
8470156,2013,0.32,0.3,1,0,5,3,4,12,1,0,0,5,10,23,1
8470159,2013,7.61,7.38,7,6,81,30,31,142,21,8,7,73,843,27,21
8470162,2013,7.39,6.88,17,2,70,32,27,129,33,14,5,56,527,74,49
8470169,2013,9.93,9.91,8,5,84,30,33,147,21,8,6,76,358,134,26
8470171,2013,11.02,10.65,10,9,124,26,46,196,27,8,6,116,100,116,37
8470176,2013,19.24,18.4,10,3,190,75,45,310,29,16,20,174,2,111,27
8470180,2013,9.67,9.84,1,5,120,37,51,208,21,15,5,105,2,154,26
8470187,2013,4.06,4.03,11,7,142,54,91,287,23,5,7,137,0,158,16
8470189,2013,0.25,0.23,0,0,3,2,0,5,0,0,0,3,1,1,0
8470201,2013,12.69,12.34,23,14,109,50,45,204,54,17,4,92,4,35,29
8470207,2013,20.75,19.28,13,9,192,64,57,313,44,22,12,170,24,118,25
8470222,2013,5.59,5.32,20,23,166,75,108,349,50,7,11,159,0,101,18
8470230,2013,7.57,7.55,6,3,71,23,23,117,18,9,3,62,11,70,32
8470232,2013,0.07,0.07,1,0,1,2,0,3,1,0,0,1,6,10,0
8470257,2013,20.54,20.31,16,13,211,102,130,443,62,33,17,178,265,43,42
8470268,2013,0.05,0.04,0,1,3,0,2,5,1,0,0,3,0,3,1
8470274,2013,20.39,19.47,16,6,216,66,65,347,39,17,14,199,17,98,31
8470280,2013,0.32,0.31,1,0,4,3,4,11,1,0,1,4,1,9,2
8470281,2013,7.7,7.4,20,35,198,80,150,428,61,6,9,192,0,36,48
8470289,2013,2.19,2.12,0,1,24,5,4,33,2,1,3,23,163,41,7
8470302,2013,13.91,13.35,8,6,134,56,44,234,22,8,18,126,9,107,44
8470309,2013,0.37,0.36,0,0,8,2,6,16,0,0,0,8,0,4,0
8470310,2013,0.52,0.49,1,0,15,7,14,36,1,0,0,15,0,20,2
8470317,2013,1.23,1.19,4,4,52,18,33,103,9,1,2,51,0,119,12
8470318,2013,1.87,1.85,3,7,66,25,33,124,11,1,2,65,0,91,14
8470324,2013,1.44,1.4,8,5,35,37,34,106,14,1,0,34,0,97,11
8470358,2013,10.97,10.66,6,4,104,51,46,201,15,5,4,99,23,84,24
8470366,2013,0.09,0.08,0,0,0,1,0,1,0,0,0,0,2,1,0
8470378,2013,5.7,5.53,11,10,113,38,84,235,28,7,5,106,0,58,20
8470543,2013,26.16,25.02,17,16,218,69,68,355,68,35,12,183,3,157,24
8470595,2013,23.54,22.71,29,11,230,93,80,403,61,21,19,209,754,67,77
8470596,2013,3.79,3.71,8,6,48,20,26,94,18,4,3,44,1,53,12
8470598,2013,27.6,26.63,26,15,248,80,96,424,68,27,19,221,20,30,31
8470599,2013,17.61,16.48,10,12,169,66,63,298,39,17,11,152,6,86,32
8470600,2013,8.29,7.73,12,23,150,71,121,342,43,8,10,142,1,72,30
8470601,2013,5.07,4.88,5,7,122,57,90,269,17,5,10,117,0,109,26
8470602,2013,8.14,7.88,11,12,145,72,107,324,31,8,12,137,0,227,32
8470604,2013,29.46,28.23,14,9,256,99,106,461,50,27,21,229,336,68,32
8470606,2013,19.48,18.85,6,6,195,70,85,350,27,15,20,180,6,246,26
8470607,2013,6.9,6.85,16,18,149,72,96,317,41,7,13,142,0,171,35
8470609,2013,9.43,9.27,4,5,104,35,22,161,12,3,6,101,6,118,22
8470610,2013,31.53,30.44,16,11,245,69,64,378,56,29,20,216,10,70,46
8470611,2013,12.24,12.12,12,6,138,40,57,235,31,13,4,125,196,81,50
8470612,2013,18.52,17.54,35,21,204,83,86,373,87,31,16,173,692,110,53
8470613,2013,24.99,24.13,11,15,245,111,98,454,48,22,19,223,61,145,45
8470614,2013,2.55,2.52,4,7,73,28,51,152,13,2,7,71,0,229,6
8470616,2013,27.9,26.73,8,10,239,92,75,406,43,25,12,214,740,133,47
8470617,2013,21.24,20.66,18,12,157,79,58,294,41,11,18,146,489,73,28
8470619,2013,12.43,12,6,6,137,39,35,211,18,6,9,131,306,154,20
8470621,2013,38.02,36.13,27,12,280,121,91,492,82,43,24,237,9,81,31
8470622,2013,3.65,3.57,0,3,53,22,18,93,5,2,3,51,7,43,8
8470626,2013,12.67,12.43,11,16,115,37,26,178,37,10,7,105,0,12,31
8470630,2013,2.89,2.84,3,4,73,27,62,162,9,2,3,71,0,111,19
8470638,2013,25.98,25.73,19,13,243,93,94,430,62,30,8,213,1015,52,49
8470640,2013,4.63,4.55,11,18,115,43,60,218,31,2,7,113,0,46,21
8470642,2013,12.74,11.64,10,23,195,108,98,401,56,23,15,172,0,169,35
8470644,2013,8.61,8.28,6,4,96,36,30,162,18,8,8,88,7,217,17
8470647,2013,3.52,3.49,2,5,60,23,22,105,10,3,1,57,3,57,15
8470654,2013,6.77,6.67,5,1,78,32,25,135,15,9,3,69,301,87,19
8470655,2013,19.22,19.04,16,14,166,67,43,276,57,27,11,139,621,273,32
8470662,2013,2.16,2.06,2,0,22,11,8,41,2,0,1,22,87,58,2
8470666,2013,4.81,4.7,0,1,44,24,32,100,5,4,1,40,1,112,4
8470667,2013,21.02,20.52,22,9,159,54,53,266,55,24,19,135,15,108,33
8470685,2013,0.83,0.83,1,1,21,14,14,49,2,0,1,21,0,11,1
8470699,2013,3.64,3.35,2,9,75,31,48,154,17,6,7,69,0,170,22
8470713,2013,2.13,2.02,3,3,25,8,5,38,8,2,3,23,1,51,6
8470714,2013,0.63,0.62,3,2,17,2,7,26,5,0,1,17,0,20,6
8470724,2013,5.44,5.3,4,5,106,42,65,213,13,4,2,102,0,88,31
8470729,2013,0.97,0.97,0,2,7,9,13,29,2,0,1,7,0,31,4
8470740,2013,21.66,19.92,15,7,178,54,63,295,34,12,20,166,10,104,40
8470750,2013,10.65,10.46,13,8,107,43,56,206,32,11,10,96,374,112,38
8470755,2013,9.65,9.04,10,2,85,43,47,175,23,11,6,74,533,63,27
8470760,2013,4.16,4.01,8,9,117,37,56,210,23,6,5,111,0,181,21
8470775,2013,10.97,10.91,5,2,105,31,28,164,16,9,11,96,496,114,28
8470778,2013,11.84,11.51,6,2,117,36,27,180,15,7,10,110,9,122,26
8470794,2013,34.64,31.94,28,10,225,128,109,462,79,41,20,184,675,47,56
8470803,2013,10.36,10.2,8,8,116,54,57,227,24,8,4,108,590,73,49
8470816,2013,1.33,1.34,0,0,14,6,6,26,2,2,0,12,0,48,1
8470828,2013,7.14,6.75,7,13,106,48,71,225,30,10,7,96,1,37,13
8470834,2013,18.28,17.66,17,19,256,109,124,489,56,20,20,236,0,213,68
8470839,2013,0.75,0.71,1,2,16,14,27,57,3,0,2,16,0,56,3
8470852,2013,22.16,21.16,19,9,176,64,51,291,51,23,17,153,2,46,32
8470854,2013,5.83,5.44,5,4,56,16,22,94,13,4,6,52,9,247,10
8470867,2013,3.59,3.57,3,4,50,20,13,83,10,3,1,47,2,64,6
8470871,2013,2.39,2.38,0,1,24,11,2,37,1,0,2,24,3,68,3
8470877,2013,11.2,10.72,6,2,107,35,30,172,17,9,4,98,41,106,15
8470886,2013,1.37,1.38,2,2,48,14,37,99,5,1,1,47,0,99,11
8470920,2013,9.81,9.43,5,1,102,33,44,179,11,5,6,97,8,159,23
8470966,2013,8.97,8.57,14,19,180,74,149,403,47,14,16,166,0,73,39
8471185,2013,10.83,10.65,5,7,77,35,36,148,24,12,6,65,14,59,19
8471208,2013,11.56,11.28,11,10,119,42,34,195,35,14,4,105,15,92,22
8471214,2013,34.33,33.28,17,11,386,181,200,767,79,51,19,335,2,204,32
8471215,2013,20.53,20.05,35,14,191,61,88,340,72,23,8,168,303,27,37
8471217,2013,20.98,19.9,18,13,189,80,79,348,54,23,23,166,24,154,37
8471218,2013,25.36,24.55,27,14,225,99,84,408,69,28,21,197,15,150,36
8471220,2013,1.17,1.22,1,1,9,2,2,13,2,0,2,9,1,11,3
8471222,2013,1.48,1.44,2,4,41,17,28,86,8,2,3,39,0,193,13
8471226,2013,17.63,17.04,13,5,185,55,67,307,34,16,15,169,106,78,24
8471231,2013,4.71,4.62,8,7,46,15,24,85,20,5,1,41,176,116,30
8471232,2013,11.78,10.7,9,7,109,49,50,208,25,9,7,100,5,136,19
8471233,2013,19.47,18.8,17,13,166,51,63,280,48,18,6,148,761,53,49
8471236,2013,4.64,4.51,7,8,84,30,69,183,22,7,9,77,0,67,11
8471241,2013,0.85,0.84,3,2,21,12,12,45,5,0,2,21,0,145,5
8471242,2013,8.87,8.64,20,9,172,82,114,368,38,9,5,163,0,62,32
8471245,2013,5.4,5.27,3,1,34,12,10,56,12,8,1,26,152,38,10
8471254,2013,7.94,7.76,4,0,93,36,50,179,15,11,5,82,1,105,10
8471260,2013,6.66,6.7,6,5,107,33,54,194,16,5,3,102,10,197,22
8471262,2013,15.67,15.36,23,9,129,55,59,243,48,16,6,113,139,52,33
8471266,2013,10.76,10.52,6,4,117,55,56,228,19,9,15,108,13,121,23
8471269,2013,2.91,2.87,6,7,71,51,56,178,14,1,5,70,0,189,4
8471273,2013,17.88,17.32,22,12,189,77,76,342,50,16,17,173,586,234,33
8471274,2013,8.26,7.83,19,17,141,53,104,298,42,6,12,135,0,94,18
8471276,2013,20.68,19.59,24,26,169,61,56,286,69,19,6,150,618,75,45
8471280,2013,1.08,1.08,0,0,10,2,2,14,0,0,0,10,0,3,5
8471283,2013,3.68,3.66,5,2,49,6,12,67,13,6,4,43,65,92,12
8471284,2013,7.86,7.59,16,17,142,59,109,310,44,11,14,131,0,54,68
8471296,2013,2.43,2.38,3,11,58,34,43,135,17,3,7,55,0,189,7
8471299,2013,7.73,7.33,5,2,69,23,28,120,11,4,6,65,176,43,21
8471303,2013,7.95,7.71,5,10,178,68,158,404,22,7,5,171,2,112,28
8471309,2013,15.16,14.66,21,4,149,56,46,251,41,16,12,133,119,66,18
8471311,2013,9.67,9.56,9,4,143,54,73,270,17,4,9,139,57,54,36
8471323,2013,5.13,4.73,2,2,59,20,27,106,6,2,1,57,2,74,15
8471326,2013,2.89,2.74,3,2,37,13,14,64,11,6,2,31,1,178,8
8471331,2013,0.49,0.47,1,0,3,5,3,11,1,0,0,3,18,24,5
8471338,2013,3.99,3.88,5,3,56,14,27,97,10,2,5,54,12,60,13
8471339,2013,24.31,23.28,12,7,163,82,59,304,36,17,8,146,13,189,34
8471346,2013,12.16,12.08,12,12,157,55,58,270,36,12,3,145,56,29,37
8471348,2013,2.4,2.37,8,5,95,32,70,197,15,2,2,93,0,84,13
8471352,2013,0.04,0.04,0,0,1,1,0,2,0,0,0,1,2,3,0
8471362,2013,11.66,11.43,16,6,81,18,34,133,35,13,4,68,346,19,27
8471371,2013,4.26,3.97,2,1,45,16,16,77,5,2,3,43,2,146,8
8471385,2013,2.85,2.82,2,4,47,21,32,100,6,0,2,47,0,77,15
8471388,2013,0.05,0.04,0,0,0,1,0,1,0,0,0,0,1,11,0
8471390,2013,9.92,9.82,10,8,91,50,44,185,28,10,7,81,215,23,22
8471392,2013,3.69,3.58,3,6,83,38,40,161,13,4,5,79,0,151,10
8471426,2013,24.57,23.67,7,11,161,89,65,315,43,25,12,136,223,210,34
8471428,2013,0.11,0.1,0,0,1,0,0,1,0,0,0,1,0,0,0
8471436,2013,0.01,0.01,0,0,1,0,2,3,0,0,0,1,0,1,0
8471450,2013,0.17,0.17,0,0,1,0,0,1,0,0,0,1,0,6,1
8471474,2013,0.28,0.29,0,1,4,1,0,5,1,0,0,4,19,0,1
8471476,2013,9.43,9.23,19,5,115,43,41,199,30,6,8,109,85,61,34
8471482,2013,1.78,1.72,3,7,42,21,31,94,12,2,6,40,0,51,9
8471490,2013,1.17,1.19,1,1,16,7,5,28,2,0,0,16,10,33,3
8471498,2013,10,9.61,5,4,112,45,52,209,20,11,6,101,12,99,28
8471504,2013,11.52,11.24,5,2,118,54,49,221,16,9,8,109,4,90,13
8471514,2013,10.38,10.25,15,8,122,41,38,201,30,7,7,115,348,27,25
8471636,2013,1,0.95,2,1,13,3,3,19,3,0,2,13,20,24,1
8471657,2013,5.5,5.19,4,4,76,13,21,110,13,5,6,71,2,148,10
8471663,2013,0.17,0.16,0,0,2,1,1,4,0,0,0,2,0,16,0
8471664,2013,15.6,15.11,16,10,178,51,70,299,45,19,11,159,7,38,26
8471669,2013,21.92,20.19,25,10,151,49,41,241,60,25,14,126,655,54,35
8471675,2013,30.69,29.75,34,34,259,85,77,421,104,36,21,223,991,47,41
8471676,2013,19.71,18.97,15,10,190,83,76,349,48,23,11,167,8,104,50
8471677,2013,7.63,7.38,9,19,147,62,81,290,33,5,4,142,0,182,17
8471678,2013,18.42,17.94,8,13,141,50,32,223,36,15,10,126,20,141,31
8471680,2013,0.27,0.27,0,0,3,2,1,6,0,0,0,3,0,3,1
8471681,2013,1.34,1.4,0,0,23,9,4,36,4,4,0,19,1,19,5
8471682,2013,12.69,12.22,10,6,129,37,55,221,27,11,11,118,5,143,24
8471685,2013,23.9,22.88,24,17,200,75,65,340,70,29,22,171,773,90,52
8471686,2013,4.43,4.29,5,6,92,44,81,217,14,3,8,89,1,83,41
8471691,2013,17.95,17,17,8,169,62,37,268,40,15,14,154,599,200,32
8471693,2013,3.83,3.71,6,11,93,50,63,206,19,2,7,91,0,57,14
8471698,2013,17.12,16.91,26,13,152,64,56,272,60,21,7,131,28,77,62
8471699,2013,17.54,17.44,12,8,158,61,51,270,42,22,7,136,11,94,22
8471700,2013,0.4,0.42,0,0,3,1,1,5,1,1,0,2,0,7,1
8471702,2013,6.09,5.99,10,26,162,74,118,354,46,10,10,152,0,124,19
8471703,2013,10.06,9.94,12,8,88,33,38,159,24,4,10,84,4,70,24
8471707,2013,20.1,19.5,20,14,238,84,105,427,61,27,13,211,5,58,31
8471708,2013,0.26,0.23,0,0,2,1,1,4,0,0,0,2,0,4,0
8471709,2013,7,6.5,9,10,138,80,118,336,24,5,13,133,0,51,18
8471716,2013,13.81,13.59,12,6,147,51,25,223,28,10,9,137,23,172,21
8471717,2013,0.57,0.56,2,3,25,7,25,57,6,1,1,24,0,54,1
8471718,2013,4.68,4.65,4,2,69,18,17,104,7,1,2,68,331,25,34
8471719,2013,1.5,1.48,1,0,12,4,3,19,2,1,2,11,0,52,1
8471724,2013,8.18,7.98,6,5,108,35,47,190,22,11,7,97,0,43,9
8471729,2013,6.46,5.92,12,10,109,52,64,225,29,7,5,102,0,42,25
8471733,2013,2.01,1.97,3,1,29,9,13,51,7,3,2,26,0,132,11
8471735,2013,10.95,10.66,27,18,241,116,164,521,53,8,18,233,0,22,31
8471742,2013,4.67,4.53,15,13,115,59,97,271,33,5,10,110,0,282,50
8471743,2013,9.38,9.09,13,11,102,56,67,225,33,9,8,93,503,110,25
8471748,2013,0.6,0.6,1,0,11,12,14,37,2,1,0,10,0,118,7
8471760,2013,0,0,0,0,0,0,0,0,0,0,0,0,0,0,0
8471761,2013,2.81,2.8,9,5,81,37,70,188,16,2,2,79,0,67,13
8471762,2013,0.76,0.71,0,1,8,4,5,17,1,0,1,8,16,24,3
8471766,2013,0.94,0.9,0,1,12,5,6,23,2,1,1,11,0,55,2
8471767,2013,1.77,1.74,0,0,11,8,10,29,2,2,0,9,33,26,5
8471768,2013,3.17,3.06,2,2,27,13,9,49,7,3,3,24,101,11,2
8471769,2013,3.47,3.41,8,14,98,44,69,211,26,4,6,94,0,39,21
8471794,2013,8.66,8.58,4,4,83,30,38,151,20,12,1,71,269,73,17
8471804,2013,18.47,17.44,7,8,221,77,70,368,31,16,15,205,2,53,48
8471816,2013,2.75,2.69,3,4,88,32,68,188,11,4,2,84,0,77,12
8471817,2013,3.39,3.37,4,2,25,22,14,61,8,2,1,23,6,211,12
8471832,2013,0.26,0.24,0,0,3,0,0,3,0,0,0,3,3,1,0
8471840,2013,1.05,1.06,1,0,16,7,2,25,2,1,2,15,37,35,4
8471842,2013,4.23,4.07,4,2,42,10,11,63,8,2,4,40,18,62,15
8471851,2013,8.45,8.28,2,5,110,35,56,201,12,5,4,105,5,55,22
8471856,2013,3.34,3.27,5,8,42,19,17,78,14,1,3,41,200,89,8
8471862,2013,11.29,11.11,7,4,108,40,35,183,17,6,6,102,22,225,28
8471873,2013,3.38,3.28,4,8,104,27,66,197,13,1,5,103,0,75,29
8471887,2013,25.85,24.81,20,11,248,81,55,384,53,22,18,226,0,77,53
8471956,2013,7.7,7.6,5,9,95,28,39,162,17,3,10,92,371,103,37
8471958,2013,4.68,4.44,7,12,100,39,102,241,24,5,13,95,0,191,28
8471976,2013,13.34,13.12,22,14,96,29,33,158,52,16,3,80,611,23,34
8471996,2013,4.19,4.04,2,0,37,11,7,55,5,3,0,34,30,45,4
8472368,2013,1.88,1.81,0,1,17,7,7,31,5,4,0,13,0,21,4
8472382,2013,7.28,7.14,8,16,134,77,103,314,32,8,14,126,0,87,46
8472394,2013,1.22,1.21,1,3,32,16,24,72,4,0,2,32,0,17,3
8472410,2013,8.41,8.44,4,3,89,25,23,137,11,4,8,85,238,113,26
8472424,2013,0.25,0.23,0,0,0,4,0,4,0,0,0,0,0,3,0
8473412,2013,22.1,20.91,24,17,170,58,63,291,64,23,11,147,785,84,38
8473419,2013,17.05,16.59,18,10,149,53,45,247,53,25,9,124,6,73,46
8473422,2013,12.15,11.82,12,9,111,45,33,189,39,18,8,93,6,210,43
8473426,2013,1.52,1.46,1,7,47,34,54,135,9,1,1,46,0,208,11
8473432,2013,5.07,4.92,4,0,67,16,25,108,8,4,4,63,0,102,12
8473446,2013,7.54,7.35,15,15,157,53,101,311,39,9,12,148,0,136,49
8473449,2013,22.18,21.19,22,20,195,80,106,381,69,27,13,168,97,43,44
8473453,2013,11.69,11.39,3,2,111,57,33,201,11,6,7,105,127,145,14
8473465,2013,16.66,16.29,10,9,167,86,58,311,38,19,17,148,1,140,36
8473466,2013,3.52,3.55,2,2,51,9,20,80,6,2,2,49,197,88,10
8473468,2013,1.66,1.67,2,7,57,25,45,127,11,2,4,55,0,161,6
8473473,2013,19.12,18.67,21,14,153,63,63,279,59,24,8,129,61,240,33
8473482,2013,14.39,14.11,10,4,131,54,53,238,30,16,5,115,3,88,26
8473485,2013,12.4,12.2,9,2,110,48,32,190,26,15,3,95,12,80,12
8473492,2013,9.23,9.17,9,6,112,48,48,208,24,9,12,103,8,132,14
8473504,2013,15.88,15.44,3,4,172,56,58,286,19,12,11,160,7,270,30
8473505,2013,0.09,0.08,0,0,0,1,0,1,0,0,0,0,0,2,0
8473507,2013,5.28,5.02,5,5,96,47,77,220,17,7,10,89,0,181,29
8473512,2013,25.67,24.47,26,32,223,88,125,436,86,28,12,195,931,90,43
8473514,2013,4.82,4.39,1,1,41,17,17,75,5,3,3,38,0,63,14
8473533,2013,23.04,21.19,18,7,165,81,52,298,40,15,16,150,803,194,51
8473534,2013,14.19,13.99,5,13,144,42,59,245,32,14,3,130,373,88,42
8473536,2013,7.45,7.11,9,7,84,28,31,143,20,4,8,80,105,105,31
8473537,2013,9.79,9.7,7,3,114,43,42,199,18,8,8,106,1,55,32
8473542,2013,3.47,3.31,1,3,31,10,4,45,9,5,3,26,3,121,8
8473544,2013,15.57,15.18,15,12,159,51,64,274,45,18,11,141,469,124,28
8473546,2013,16.33,15.8,10,4,137,38,39,214,26,12,3,125,7,68,54
8473548,2013,25.51,24.83,30,13,305,100,151,556,80,37,26,268,2,25,37
8473558,2013,1.04,1.04,1,1,22,2,4,28,2,0,1,22,58,7,4
8473562,2013,4.36,4.1,1,0,49,8,20,77,2,1,2,48,71,25,9
8473563,2013,16.84,16.36,24,37,196,74,66,336,79,18,12,178,714,89,54
8473564,2013,15.69,15.18,16,11,189,70,85,344,42,15,21,174,43,41,53
8473565,2013,1.44,1.38,3,3,40,15,24,79,9,3,1,37,0,65,16
8473571,2013,5.13,4.95,4,7,98,43,83,224,17,6,5,92,0,34,12
8473573,2013,16.74,16.17,9,8,162,73,74,309,39,22,15,140,476,31,51
8473574,2013,12.75,12.32,4,7,127,35,38,200,23,12,14,115,183,93,33
8473579,2013,8.72,8.49,7,4,81,34,34,149,20,9,8,72,38,153,30
8473584,2013,5.61,5.27,10,14,92,68,103,263,28,4,7,88,0,69,23
8473588,2013,7.93,7.76,6,4,85,49,46,180,16,6,8,79,1,28,37
8473589,2013,0.66,0.68,0,1,17,4,5,26,3,2,0,15,0,33,0
8473600,2013,0,0,0,0,0,0,0,0,0,0,0,0,0,1,0
8473604,2013,23.22,22.32,25,15,194,49,42,285,68,28,15,166,884,29,51
8473618,2013,13.74,13.21,14,11,120,36,46,202,43,18,9,102,437,73,19
8473646,2013,6.28,6.26,2,1,69,29,19,117,10,7,1,62,16,72,14
8473658,2013,0.81,0.79,3,2,21,10,19,50,6,1,1,20,0,81,14
8473673,2013,1.87,1.86,4,4,61,19,43,123,9,1,3,60,0,61,8
8473682,2013,0.58,0.58,1,0,9,4,4,17,1,0,1,9,15,10,2
8473700,2013,0.76,0.79,2,4,23,5,21,49,6,0,2,23,0,53,5
8473712,2013,0.35,0.35,0,0,4,2,2,8,0,0,0,4,1,24,0
8473722,2013,1.33,1.34,0,0,16,3,5,24,1,1,1,15,0,95,3
8473908,2013,3.97,3.65,3,0,31,14,11,56,7,4,3,27,1,45,8
8473911,2013,0.17,0.17,1,1,2,2,1,5,2,0,0,2,0,10,1
8473914,2013,9.94,9.88,18,4,122,35,46,203,34,12,6,110,374,63,27
8473921,2013,0.08,0.07,0,0,2,1,1,4,0,0,0,2,0,2,0
8473927,2013,0.17,0.19,0,0,2,2,2,6,0,0,0,2,8,9,1
8473932,2013,0.03,0.03,0,0,0,1,0,1,0,0,0,0,1,1,0
8473933,2013,2.86,2.75,8,5,107,44,68,219,18,5,3,102,0,215,17
8473942,2013,2.07,2.02,3,2,24,10,8,42,9,4,2,20,115,45,4
8473953,2013,0.47,0.45,0,1,12,8,7,27,1,0,1,12,2,6,2
8473962,2013,14.39,13.3,20,10,157,66,53,276,42,12,13,145,4,13,36
8473970,2013,9.86,9.66,6,3,103,43,29,175,20,11,10,92,1,168,14
8473986,2013,18.55,17.65,9,15,174,63,66,303,41,17,14,157,74,77,32
8473989,2013,1.78,1.78,1,1,30,9,12,51,4,2,0,28,3,103,6
8473991,2013,4.06,3.94,5,11,95,48,58,201,18,2,6,93,0,73,28
8473992,2013,0.26,0.26,0,2,10,5,9,24,2,0,0,10,0,39,0
8473994,2013,28.55,27.51,23,22,278,128,108,514,79,34,26,244,411,118,70
8474001,2013,9.04,9.01,9,4,100,49,33,182,17,4,6,96,62,77,23
8474005,2013,0.07,0.07,0,0,2,1,4,7,2,2,0,0,0,1,0
8474008,2013,0.41,0.43,0,0,6,2,2,10,0,0,0,6,0,11,1
8474009,2013,15.85,15.12,14,13,159,51,51,261,49,22,12,137,583,28,37
8474012,2013,0.14,0.14,0,0,5,0,1,6,1,1,0,4,9,8,1
8474013,2013,2.21,2.23,2,6,45,27,34,106,11,3,4,42,0,24,9
8474025,2013,5.01,4.94,2,1,52,23,15,90,6,3,1,49,3,105,10
8474027,2013,5.07,4.95,5,8,121,45,103,269,17,4,13,117,0,77,40
8474030,2013,0.25,0.25,0,0,2,2,0,4,0,0,0,2,0,3,0
8474031,2013,11.22,10.88,12,23,188,68,139,395,45,10,7,178,0,72,38
8474034,2013,10.1,9.76,13,5,93,40,34,167,29,11,4,82,7,124,15
8474037,2013,30.78,30.02,18,13,279,72,51,402,61,30,16,249,46,118,36
8474038,2013,6.71,6.54,12,2,46,22,25,93,21,7,1,39,7,63,29
8474040,2013,13.04,12.07,16,11,143,59,50,252,37,10,12,133,451,33,28
8474048,2013,0.13,0.12,0,1,6,2,10,18,1,0,0,6,0,17,0
8474052,2013,0.83,0.8,1,1,13,8,9,30,2,0,0,13,0,9,7
8474053,2013,28.09,26.8,18,13,233,91,76,400,54,23,18,210,479,16,39
8474056,2013,9.06,8.85,19,24,204,82,171,457,53,10,23,194,0,135,26
8474059,2013,0.6,0.58,0,2,10,9,6,25,2,0,1,10,0,4,2
8474061,2013,3.74,3.76,2,1,24,7,1,32,5,2,3,22,1,85,7
8474062,2013,9.83,9.4,7,7,86,32,28,146,24,10,7,76,306,81,54
8474066,2013,4.63,4.36,8,10,96,55,75,226,22,4,4,92,0,72,34
8474068,2013,19.62,19.36,22,10,215,83,91,389,58,26,9,189,724,45,51
8474074,2013,0.7,0.68,1,1,19,8,18,45,3,1,1,18,0,20,3
8474077,2013,0.01,0.01,0,0,0,1,0,1,0,0,0,0,0,0,0
8474089,2013,1.31,1.31,0,2,16,9,7,32,5,3,0,13,45,79,4
8474090,2013,4.37,4.25,7,7,90,48,55,193,19,5,4,85,0,57,18
8474091,2013,14.14,14,8,5,144,40,36,220,26,13,9,131,549,69,29
8474094,2013,7.04,6.7,4,1,56,24,15,95,10,5,5,51,2,19,12
8474095,2013,0.33,0.31,0,0,4,0,0,4,0,0,0,4,2,10,1
8474096,2013,9.25,9.16,14,5,85,24,32,141,32,13,4,72,88,42,30
8474098,2013,7.86,7.88,1,3,69,20,13,102,12,8,8,61,17,19,7
8474100,2013,13.42,13.22,6,9,111,43,34,188,30,15,10,96,2,114,15
8474102,2013,26.59,25.33,20,9,220,69,94,383,57,28,16,192,13,116,52
8474125,2013,2.84,2.79,5,9,48,20,34,102,17,3,4,45,0,166,29
8474130,2013,2.97,2.94,4,5,35,6,14,55,11,2,1,33,0,112,9
8474134,2013,3.93,3.46,3,1,70,40,43,153,10,6,4,64,0,39,9
8474135,2013,1.88,1.77,2,4,54,16,36,106,8,2,4,52,0,169,21
8474137,2013,7.75,7.51,3,5,80,31,39,150,12,4,7,76,6,45,19
8474138,2013,3.87,3.84,0,2,30,15,14,59,4,2,5,28,55,6,9
8474141,2013,24.79,24.13,24,16,227,88,88,403,69,29,10,198,4,16,44
8474145,2013,2.08,2.03,5,5,50,24,29,103,10,0,4,50,0,137,6
8474150,2013,18.8,18.33,9,12,178,66,74,318,39,18,12,160,628,64,63
8474151,2013,9.47,9.16,10,19,177,50,88,315,43,14,13,163,0,88,51
8474157,2013,27.28,26.66,17,4,270,102,93,465,60,39,19,231,6,69,28
8474161,2013,22.57,21.7,22,17,235,70,139,444,62,23,19,212,4,19,33
8474162,2013,6.73,6.57,9,10,175,68,142,385,24,5,20,170,0,169,14
8474164,2013,0.52,0.52,1,0,11,7,7,25,1,0,2,11,0,10,1
8474166,2013,6.98,6.81,4,7,79,62,82,223,22,11,9,68,0,96,5
8474168,2013,7.82,7.62,5,4,78,24,17,119,17,8,3,70,345,26,18
8474176,2013,14.63,14.39,7,9,144,45,60,249,33,17,10,127,0,64,32
8474184,2013,1.31,1.26,2,2,33,11,40,84,6,2,2,31,0,76,13
8474189,2013,15.4,14.92,8,6,138,48,67,253,26,12,15,126,521,130,30
8474190,2013,28.49,27.04,18,13,209,53,73,335,60,29,21,180,1,132,36
8474192,2013,5.89,5.63,4,1,61,27,20,108,7,2,4,59,2,85,6
8474201,2013,0.01,0.01,0,0,2,0,5,7,0,0,0,2,2,24,1
8474207,2013,4.14,4.05,6,9,66,34,47,147,25,10,3,56,0,118,10
8474218,2013,5.1,4.83,14,15,105,56,68,229,34,5,4,100,0,69,40
8474236,2013,0.12,0.12,0,0,3,2,1,6,0,0,0,3,0,9,0
8474250,2013,11.17,10.92,4,5,154,51,45,250,22,13,10,141,680,175,45
8474291,2013,7.64,7.42,2,3,60,30,15,105,9,4,3,56,296,93,18
8474497,2013,1.78,1.8,4,3,49,9,26,84,11,4,3,45,0,26,4
8474498,2013,9.11,8.46,9,0,100,30,26,156,18,9,8,91,63,65,9
8474519,2013,0.4,0.4,1,0,12,8,4,24,1,0,0,12,0,10,0
8474520,2013,10.33,9.89,19,7,181,79,119,379,33,7,10,174,0,58,30
8474535,2013,0.57,0.58,0,0,8,1,7,16,0,0,1,8,29,11,1
8474551,2013,6.38,5.73,7,8,38,18,26,82,15,0,3,38,125,26,23
8474563,2013,11.61,11.19,19,8,177,97,129,403,37,10,13,167,0,180,16
8474564,2013,16.64,16.38,11,4,124,58,50,232,40,25,7,99,260,50,24
8474565,2013,10.77,10.28,24,19,164,100,157,421,51,8,8,156,0,24,37
8474567,2013,4.54,4.43,5,3,134,50,70,254,11,3,7,131,0,94,17
8474568,2013,2.75,2.72,6,2,78,31,80,189,12,4,2,74,0,260,17
8474569,2013,12.76,12.48,14,8,112,47,41,200,33,11,10,101,166,49,33
8474570,2013,18.2,17.3,18,6,182,51,88,321,44,20,11,162,453,47,24
8474571,2013,16.29,16.04,16,16,166,55,63,284,51,19,14,147,3,105,33
8474573,2013,11.53,11.02,21,9,98,36,63,197,38,8,5,90,113,44,39
8474574,2013,7.76,7.45,7,6,99,46,57,202,22,9,7,90,0,107,18
8474576,2013,1.32,1.24,3,0,15,2,6,23,4,1,2,14,0,17,4
8474577,2013,8.78,8.33,9,9,80,33,25,138,28,10,6,70,214,129,30
8474578,2013,14.81,14.29,26,28,257,126,206,589,74,20,13,237,0,122,68
8474579,2013,0.99,0.95,1,4,30,18,32,80,6,1,2,29,0,83,7
8474581,2013,8.12,7.65,10,11,136,52,87,275,31,10,5,126,0,108,33
8474582,2013,0.97,1.03,0,0,9,4,5,18,1,1,0,8,0,16,4
8474584,2013,3.46,3.27,10,3,90,32,77,199,16,3,0,87,0,78,15
8474586,2013,24.62,23.86,23,14,200,73,87,360,65,28,17,172,8,51,61
8474589,2013,21.69,20.35,12,10,210,60,77,347,43,21,19,189,242,89,38
8474590,2013,10.01,9.64,14,13,208,54,126,388,37,10,8,198,0,64,55
8474594,2013,7.17,6.66,20,10,143,85,115,343,34,4,12,139,1,165,16
8474597,2013,0.06,0.07,0,0,4,0,1,5,0,0,0,4,0,3,0
8474598,2013,0.11,0.11,0,0,2,0,1,3,0,0,0,2,0,1,0
8474600,2013,8.14,7.88,16,11,168,51,81,300,40,13,7,155,0,32,22
8474601,2013,0.01,0.01,0,0,1,0,1,2,0,0,0,1,0,5,1
8474602,2013,8.26,7.89,12,10,111,62,72,245,33,11,8,100,0,34,21
8474603,2013,2.74,2.73,0,4,17,12,2,31,7,3,2,14,78,31,15
8474604,2013,1.5,1.31,0,2,23,9,17,49,3,1,1,22,0,14,3
8474605,2013,5.06,4.9,10,9,97,45,74,216,23,4,10,93,0,54,4
8474606,2013,0.6,0.57,1,1,15,3,8,26,2,0,0,15,0,17,4
8474609,2013,1.62,1.51,0,0,16,7,12,35,1,1,1,15,10,16,1
8474610,2013,4.67,4.65,0,3,52,30,14,96,7,4,2,48,106,36,4
8474611,2013,0.23,0.22,0,0,9,2,4,15,0,0,1,9,0,11,3
8474612,2013,4.74,4.57,7,8,134,58,116,308,18,3,7,131,0,93,40
8474613,2013,16.85,16.32,23,17,199,90,67,356,57,17,10,182,682,30,50
8474616,2013,0.79,0.81,1,2,4,0,4,8,3,0,0,4,26,20,2
8474618,2013,3.09,2.99,5,9,80,41,71,192,17,3,9,77,0,70,25
8474625,2013,10.39,9.96,5,2,72,35,20,127,18,11,7,61,11,115,14
8474628,2013,4.13,4.08,8,5,105,50,84,239,21,8,10,97,0,153,9
8474638,2013,0.21,0.23,0,0,4,1,2,7,0,0,0,4,0,3,0
8474641,2013,19.28,18.81,9,9,137,44,42,223,43,25,14,112,407,73,50
8474642,2013,8.01,7.91,6,4,82,39,30,151,15,5,2,77,22,181,20
8474646,2013,3.06,3.04,1,3,35,11,6,52,6,2,1,33,7,50,6
8474659,2013,3.52,3.47,4,10,86,34,45,165,16,2,9,84,0,68,18
8474660,2013,0.22,0.22,1,0,10,3,5,18,2,1,0,9,0,0,1
8474668,2013,4.67,4.7,5,5,41,15,9,65,16,6,4,35,0,103,17
8474673,2013,8.2,7.91,11,16,104,62,89,255,31,4,14,100,0,58,48
8474674,2013,4.51,4.14,1,1,41,15,22,78,2,0,5,41,126,63,22
8474679,2013,17.9,17.38,12,8,153,60,52,265,48,28,6,125,5,18,34
8474681,2013,8.84,8.66,12,3,78,42,36,156,22,7,14,71,154,33,31
8474683,2013,1.87,1.74,2,0,31,11,9,51,2,0,2,31,79,32,5
8474685,2013,9.44,9.33,9,5,90,28,39,157,23,9,3,81,3,111,20
8474697,2013,0.12,0.12,0,0,6,1,8,15,1,1,0,5,0,41,0
8474707,2013,2.77,2.74,3,6,47,19,32,98,12,3,1,44,0,44,4
8474709,2013,10.73,10.42,5,1,120,27,40,187,14,8,11,112,3,359,22
8474715,2013,22.03,21.49,13,6,216,68,70,354,40,21,11,195,0,55,29
8474716,2013,5.25,4.88,13,8,91,59,64,214,26,5,11,86,0,80,19
8474717,2013,3.74,3.5,0,5,54,21,46,121,10,5,3,49,0,28,10
8474727,2013,12.91,12.68,7,5,90,34,33,157,26,14,4,76,200,40,22
8474736,2013,3.44,3.4,2,0,54,27,29,110,4,2,7,52,2,231,8
8474739,2013,16.73,16.04,10,12,163,62,52,277,38,16,17,147,20,218,26
8474743,2013,0.55,0.56,1,1,10,8,12,30,3,1,1,9,0,7,2
8474744,2013,0.32,0.29,0,1,6,0,1,7,1,0,1,6,0,9,2
8474749,2013,3,2.95,7,11,91,39,78,208,18,0,7,91,0,155,11
8474774,2013,1.46,1.42,1,3,56,17,37,110,6,2,2,54,0,99,13
8474818,2013,3.82,3.79,5,12,91,53,74,218,20,3,5,88,1,118,27
8474837,2013,0.18,0.17,0,0,6,2,2,10,0,0,0,6,0,10,0
8474849,2013,14.39,14.15,8,7,114,55,46,215,29,14,9,100,19,146,24
8474850,2013,0.34,0.3,0,0,3,1,1,5,0,0,0,3,0,5,0
8474870,2013,22.51,21.34,13,13,181,71,61,313,50,24,10,157,614,55,23
8474873,2013,2.24,2.23,2,3,38,26,36,100,6,1,3,37,0,65,14
8474884,2013,6.66,6.45,2,1,61,26,31,118,6,3,4,58,6,18,18
8474939,2013,0,0,0,0,0,0,0,0,0,0,0,0,0,0,0
8475060,2013,0.18,0.18,0,0,6,2,5,13,0,0,0,6,0,5,2
8475098,2013,13.37,12.86,19,11,90,34,35,159,49,19,4,71,681,62,49
8475118,2013,1.1,1.06,1,0,27,14,7,48,2,1,2,26,0,5,1
8475119,2013,0.76,0.76,0,0,14,6,7,27,0,0,0,14,34,57,4
8475147,2013,2.88,2.76,1,2,25,12,10,47,6,3,4,22,112,20,7
8475148,2013,0.06,0.05,0,0,1,1,2,4,0,0,0,1,0,1,0
8475149,2013,12.71,12.09,28,8,107,32,33,172,44,8,9,99,95,49,32
8475150,2013,4.46,4.43,2,0,52,14,20,86,3,1,1,51,1,47,11
8475151,2013,12.89,12.5,6,11,147,47,41,235,31,14,9,133,9,96,14
8475153,2013,2.23,2.13,4,5,60,13,25,98,12,3,3,57,0,116,18
8475154,2013,1.75,1.76,2,1,23,7,8,38,3,0,0,23,12,46,3
8475155,2013,1.3,1.3,2,3,41,12,30,83,5,0,3,41,0,72,10
8475157,2013,0.04,0.04,0,0,2,0,0,2,0,0,0,2,0,7,0
8475158,2013,21.92,20.89,16,20,201,50,69,320,64,28,14,173,192,22,83
8475159,2013,0.27,0.26,0,0,3,1,2,6,1,1,0,2,0,2,1
8475160,2013,5.5,5.34,3,2,74,27,31,132,8,3,7,71,6,189,12
8475161,2013,0.45,0.43,1,0,8,3,7,18,2,1,1,7,15,22,2
8475163,2013,21.38,20.54,11,11,144,74,61,279,35,13,17,131,64,76,27
8475164,2013,11.15,10.63,9,4,119,34,34,187,23,10,6,109,1,31,17
8475165,2013,2.14,2.09,1,0,18,12,9,39,1,0,0,18,71,29,6
8475166,2013,21.75,20.85,26,16,188,61,85,334,66,24,12,164,554,23,55
8475167,2013,8.74,8.56,26,16,170,72,100,342,55,13,6,157,0,86,34
8475168,2013,29.1,27.97,31,16,217,76,81,374,70,23,22,194,532,53,40
8475169,2013,25.3,24.25,19,3,250,108,120,478,41,19,19,231,45,173,28
8475170,2013,20.37,19.4,11,10,178,61,62,301,41,20,19,158,296,200,37
8475171,2013,13.3,12.31,12,17,199,86,159,444,44,15,20,184,0,134,26
8475172,2013,16.88,16.04,19,11,148,77,85,310,50,20,8,128,510,141,44
8475174,2013,3.61,3.54,4,5,68,26,31,125,15,6,5,62,0,214,11
8475175,2013,5.15,5.2,4,2,60,15,29,104,12,6,3,54,2,26,13
8475176,2013,5.27,5.14,9,12,123,38,72,233,27,6,5,117,0,57,17
8475177,2013,3.2,3.11,7,6,71,25,57,153,16,3,5,68,0,114,30
8475178,2013,8.69,8.32,10,5,91,34,38,163,29,14,4,77,6,91,19
8475179,2013,6.48,6.11,5,6,127,58,69,254,19,8,7,119,0,125,29
8475180,2013,4.01,3.94,4,1,43,17,22,82,11,6,0,37,182,46,25
8475181,2013,6.03,5.9,10,14,123,31,64,218,31,7,10,116,0,52,12
8475182,2013,0.69,0.67,0,1,21,10,20,51,1,0,0,21,0,18,3
8475183,2013,0.39,0.39,0,0,7,2,5,14,0,0,0,7,2,3,0
8475184,2013,15.59,15.2,12,8,136,60,31,227,37,17,6,119,8,146,21
8475185,2013,1.71,1.69,0,2,21,8,8,37,3,1,1,20,83,15,10
8475186,2013,5.43,5.14,5,6,115,52,83,250,15,4,9,111,0,59,4
8475188,2013,0.42,0.4,0,0,10,4,11,25,0,0,2,10,0,25,2
8475190,2013,0.07,0.07,0,0,1,0,0,1,0,0,0,1,0,2,0
8475191,2013,18.07,17.84,19,12,146,54,44,244,51,20,13,126,0,63,35
8475192,2013,0.54,0.53,0,0,9,4,2,15,0,0,0,9,0,4,0
8475193,2013,16.61,15.94,12,8,158,56,65,279,39,19,9,139,26,81,41
8475194,2013,0.09,0.09,0,0,5,1,4,10,0,0,0,5,0,5,2
8475196,2013,0.74,0.78,0,2,10,0,3,13,2,0,3,10,1,13,2
8475197,2013,8.34,8.07,11,14,101,40,66,207,38,13,11,88,0,50,26
8475198,2013,0,0,0,0,0,0,0,0,0,0,0,0,0,0,0
8475199,2013,7.05,6.92,13,9,124,52,71,247,29,7,9,117,0,99,12
8475200,2013,2.6,2.55,3,5,59,28,42,129,11,3,3,56,0,75,28
8475204,2013,8.04,7.83,4,8,80,39,40,159,25,13,6,67,204,24,16
8475206,2013,0.09,0.09,0,0,1,0,1,2,1,1,0,0,0,2,0
8475208,2013,0.18,0.18,1,0,3,5,3,11,1,0,0,3,0,1,1
8475209,2013,4.51,4.35,5,5,56,32,26,114,13,3,3,53,3,70,16
8475213,2013,1.81,1.8,0,2,23,5,12,40,7,5,2,18,86,23,6
8475214,2013,4.28,4.17,5,1,46,15,16,77,11,5,1,41,4,20,9
8475218,2013,1.97,1.93,4,4,58,20,46,124,9,1,4,57,0,42,19
8475220,2013,7.78,7.53,6,6,79,31,21,131,19,7,2,72,146,206,36
8475222,2013,4.25,4.13,9,6,73,39,54,166,21,6,6,67,0,66,15
8475223,2013,1.18,1.17,3,2,8,8,4,20,5,0,1,8,55,2,7
8475224,2013,1.99,1.98,0,0,25,7,5,37,3,3,1,22,1,23,7
8475225,2013,22.9,22.44,15,13,215,90,81,386,52,24,14,191,3,54,50
8475231,2013,11.22,10.76,7,3,79,35,27,141,16,6,5,73,489,128,33
8475233,2013,2.27,2.28,4,6,63,20,51,134,15,5,2,58,1,149,12
8475235,2013,2.26,2.21,0,0,30,10,9,49,1,1,1,29,0,51,2
8475236,2013,18.73,18.17,9,10,161,68,85,314,35,16,14,145,585,91,57
8475246,2013,2.68,2.62,2,5,56,24,40,120,8,1,3,55,0,43,9
8475247,2013,1.4,0.96,3,0,6,3,3,12,4,1,1,5,60,14,3
8475248,2013,0.65,0.6,1,0,16,9,9,34,2,1,1,15,0,25,5
8475253,2013,0.18,0.18,0,0,4,0,0,4,0,0,0,4,0,11,0
8475254,2013,0.01,0.01,0,0,1,0,0,1,0,0,0,1,3,3,1
8475260,2013,0.23,0.23,0,0,4,1,0,5,1,1,0,3,24,9,1
8475264,2013,0.06,0.06,0,0,2,0,0,2,1,1,0,1,4,0,0
8475268,2013,12.16,11.89,11,6,108,48,39,195,26,9,12,99,0,70,20
8475275,2013,0.19,0.19,1,2,5,1,9,15,3,0,0,5,0,11,1
8475279,2013,0,0,0,0,0,0,0,0,0,0,0,0,0,3,1
8475283,2013,0.13,0.13,1,1,1,0,1,2,2,0,0,1,1,10,0
8475287,2013,3.78,3.72,3,6,56,19,15,90,15,6,3,50,161,23,8
8475296,2013,0.03,0.03,0,0,0,1,2,3,0,0,0,0,0,2,1
8475309,2013,1.24,1.21,1,1,12,3,5,20,3,1,0,11,1,23,6
8475314,2013,8.32,8.03,2,3,68,21,10,99,14,9,8,59,1,48,9
8475321,2013,1.45,1.42,1,0,15,4,2,21,2,1,1,14,26,7,0
8475323,2013,8.12,7.9,14,6,96,28,30,154,28,8,6,88,438,22,27
8475325,2013,4.5,4.47,0,4,58,17,26,101,10,6,5,52,1,100,5
8475332,2013,0.18,0.18,0,0,2,0,1,3,1,1,0,1,0,1,0
8475414,2013,0.32,0.3,0,0,4,0,0,4,0,0,2,4,3,1,0
8475423,2013,0.79,0.76,1,1,11,4,5,20,3,1,1,10,0,30,2
8475455,2013,3.38,3.26,5,6,97,40,68,205,17,6,8,91,0,168,15
8475462,2013,4.29,4.2,8,11,114,52,85,251,22,3,7,111,0,273,13
8475567,2013,0.27,0.26,1,0,4,4,8,16,2,1,0,3,0,10,1
8475598,2013,1.99,1.95,5,10,65,30,52,147,16,1,5,64,1,97,20
8475602,2013,1.94,1.86,0,1,15,6,4,25,3,2,3,13,50,9,3
8475613,2013,1.27,1.23,0,6,30,21,30,81,8,2,1,28,0,22,17
8475619,2013,2.35,2.2,0,0,18,9,12,39,2,2,3,16,4,77,6
8475625,2013,5.09,4.91,9,8,147,51,97,295,19,2,9,145,0,62,15
8475637,2013,0.21,0.19,0,1,5,0,4,9,1,0,2,5,0,2,2
8475640,2013,1.42,1.4,2,6,30,18,21,69,10,2,3,28,0,11,4
8475648,2013,0.25,0.25,1,1,6,5,3,14,2,0,0,6,0,4,1
8475650,2013,7.59,7.52,6,1,109,33,46,188,14,7,5,102,1,203,5
8475671,2013,1.08,1.11,0,0,13,4,4,21,2,2,1,11,1,10,1
8475690,2013,2.33,2.24,2,9,65,24,41,130,17,6,4,59,0,25,17
8475692,2013,20.36,19.42,27,13,170,62,62,294,59,19,17,151,3,116,44
8475714,2013,1.65,1.63,3,4,13,3,6,22,9,2,1,11,58,2,2
8475716,2013,1.43,1.35,3,3,28,19,29,76,6,0,4,28,0,17,17
8475722,2013,3.42,3.36,0,1,40,18,10,68,5,4,1,36,0,16,9
8475726,2013,11.21,10.86,8,9,124,56,56,236,29,12,14,112,2,57,23
8475727,2013,2.51,2.54,4,7,42,12,10,64,11,0,0,42,59,10,8
8475728,2013,2.29,2.22,2,2,21,14,8,43,4,0,3,21,135,52,9
8475733,2013,0.9,0.86,1,1,7,6,7,20,2,0,0,7,2,1,3
8475735,2013,0.15,0.14,0,0,1,0,0,1,0,0,0,1,1,2,0
8475739,2013,5.91,5.79,5,2,78,24,24,126,14,7,3,71,28,67,15
8475744,2013,2.14,2.08,2,4,22,7,8,37,9,3,1,19,5,7,3
8475745,2013,12.65,12.26,9,9,135,42,36,213,30,12,7,123,192,108,32
8475747,2013,0.15,0.15,0,0,3,2,1,6,0,0,0,3,0,16,1
8475749,2013,0.03,0.03,0,0,1,0,2,3,0,0,0,1,0,1,1
8475750,2013,1.73,1.7,5,4,45,24,54,123,11,2,2,43,0,27,9
8475752,2013,0.47,0.44,0,0,9,3,6,18,1,1,0,8,1,26,2
8475753,2013,7.25,6.96,8,19,152,65,120,337,32,5,8,147,0,94,41
8475754,2013,15.83,15.31,4,8,132,56,73,261,26,14,9,118,191,74,32
8475755,2013,0.27,0.27,1,0,4,3,4,11,1,0,0,4,0,24,0
8475757,2013,0.18,0.18,0,0,7,3,2,12,0,0,0,7,0,14,1
8475758,2013,2.33,2.35,3,5,23,14,5,42,10,2,1,21,0,50,2
8475759,2013,0.1,0.1,0,0,4,3,4,11,0,0,0,4,0,5,1
8475760,2013,18.19,17.58,14,8,185,58,58,301,38,16,11,169,549,117,37
8475761,2013,2.56,2.52,2,2,27,12,13,52,7,3,1,24,2,32,2
8475764,2013,6.14,5.99,12,18,100,46,77,223,36,6,10,94,0,46,24
8475765,2013,18.66,18.28,15,7,136,79,61,276,43,21,4,115,2,22,32
8475768,2013,21.15,20.47,18,13,188,57,57,302,56,25,13,163,44,54,66
8475769,2013,2.33,2.21,2,0,23,4,6,33,6,4,1,19,2,32,9
8475770,2013,4.73,4.69,2,2,44,20,20,84,11,7,5,37,0,50,8
8475772,2013,6.45,6.31,13,2,59,27,20,106,24,9,5,50,251,25,17
8475774,2013,0.01,0.01,0,0,0,1,0,1,0,0,0,0,0,3,0
8475775,2013,2.18,2.07,1,0,16,8,8,32,5,4,1,12,0,26,4
8475784,2013,26.03,25,16,5,274,87,113,474,54,33,22,241,23,22,48
8475790,2013,4.17,4.02,3,3,92,56,61,209,9,3,3,89,0,158,14
8475791,2013,24.35,23.69,25,28,250,77,100,427,80,27,13,223,37,54,76
8475792,2013,1.28,1.26,0,0,12,5,1,18,1,1,0,11,25,9,3
8475793,2013,24.55,24.04,18,12,237,82,72,391,63,33,13,204,692,114,39
8475794,2013,31.61,30.59,33,14,294,123,105,522,84,37,21,257,281,48,67
8475795,2013,0,0,0,0,0,0,2,2,0,0,0,0,0,2,0
8475796,2013,1.76,1.71,1,5,51,27,31,109,7,1,3,50,0,37,12
8475797,2013,0.54,0.53,0,2,10,10,13,33,2,0,0,10,0,42,0
8475798,2013,9.45,9.22,16,17,104,29,36,169,41,8,5,96,415,38,27
8475799,2013,15.12,14.51,13,9,143,47,37,227,36,14,16,129,7,175,37
8475800,2013,0.31,0.3,0,0,4,0,4,8,0,0,0,4,0,2,0
8475807,2013,2.21,2.19,2,0,26,9,11,46,3,1,2,25,10,17,9
8475808,2013,0.46,0.45,1,0,6,3,7,16,1,0,0,6,42,34,5
8475815,2013,0,0,0,0,0,0,0,0,0,0,0,0,0,1,0
8475833,2013,0.08,0.08,0,0,0,1,0,1,0,0,0,0,5,1,0
8475844,2013,1.64,1.68,1,0,12,6,2,20,2,1,2,11,0,9,3
8475845,2013,0.43,0.43,1,0,5,2,1,8,2,1,0,4,0,4,2
8475848,2013,26.71,25.91,9,13,211,76,97,384,41,19,22,192,47,38,41
8475855,2013,0.8,0.73,0,0,7,5,4,16,0,0,1,7,0,20,1
8475878,2013,0.94,0.95,0,0,13,7,6,26,0,0,1,13,14,24,3
8475889,2013,0.12,0.12,0,0,2,0,0,2,0,0,0,2,1,2,0
8475902,2013,0.1,0.1,0,0,4,3,0,7,0,0,0,4,0,2,0
8475913,2013,6.23,6.03,3,1,36,25,11,72,8,4,7,32,1,10,18
8475917,2013,0.12,0.11,1,0,2,0,2,4,1,0,0,2,0,1,0
8476043,2013,1.07,1.1,0,1,17,7,6,30,1,0,0,17,63,14,5
8476062,2013,5.95,5.73,7,7,70,29,28,127,18,4,7,66,206,78,18
8476086,2013,0,0,0,0,0,0,0,0,0,0,0,0,0,6,0
8476116,2013,14,13.81,9,6,165,68,58,291,32,17,8,148,4,141,42
8476158,2013,1.25,1.24,0,0,12,4,3,19,2,2,1,10,2,14,3
8476162,2013,0.84,0.85,5,3,27,11,23,61,10,2,3,25,0,46,8
8476166,2013,0.34,0.35,0,0,6,2,2,10,2,2,0,4,0,1,1
8476177,2013,18.32,18.04,9,9,151,73,66,290,40,22,10,129,12,72,45
8476179,2013,1.86,1.84,1,1,18,8,11,37,5,3,0,15,98,37,15
8476191,2013,1.07,1.07,2,3,41,20,40,101,6,1,1,40,0,103,15
8476195,2013,10.95,10.57,10,9,101,35,33,169,26,7,6,94,9,51,24
8476205,2013,2.41,2.35,1,0,20,9,17,46,4,3,1,17,32,14,7
8476206,2013,0.26,0.26,0,2,6,1,3,10,2,0,0,6,15,4,2
8476207,2013,3.61,3.57,7,5,29,9,15,53,17,5,1,24,9,24,10
8476209,2013,1.72,1.62,0,0,20,6,4,30,0,0,2,20,5,19,3
8476227,2013,0,0,0,0,0,0,0,0,0,0,0,0,0,1,0
8476235,2013,8.48,8.22,5,3,79,33,29,141,21,13,5,66,2,9,24
8476244,2013,2.57,2.52,10,3,68,44,63,175,15,2,5,66,0,36,8
8476289,2013,0,0,0,0,0,0,0,0,0,0,0,0,0,0,0
8476292,2013,18.54,17.69,26,10,165,66,56,287,59,23,21,142,5,146,47
8476302,2013,0.62,0.59,0,0,20,11,11,42,1,1,1,19,0,9,1
8476304,2013,0.34,0.33,0,1,3,1,3,7,1,0,0,3,0,7,2
8476346,2013,0.19,0.19,0,0,1,1,0,2,1,1,0,0,0,0,1
8476367,2013,1.17,1.19,0,0,16,4,7,27,1,1,0,15,0,18,1
8476381,2013,19.29,18.59,8,11,149,40,49,238,39,20,8,129,296,168,25
8476389,2013,4.58,4.33,1,2,38,23,15,76,8,5,2,33,166,39,13
8476410,2013,0.4,0.41,1,0,4,2,0,6,2,1,0,3,0,5,2
8476411,2013,0.01,0.01,0,0,0,1,2,3,0,0,0,0,0,1,0
8476419,2013,4.07,4.04,0,0,31,18,9,58,2,2,2,29,118,41,8
8476423,2013,2.97,2.9,4,1,27,15,11,53,7,2,0,25,1,17,6
8476427,2013,0.26,0.26,0,0,4,2,0,6,0,0,0,4,0,1,0
8476429,2013,0.21,0.19,0,0,7,1,5,13,0,0,0,7,0,7,2
8476430,2013,6.72,6.42,4,3,77,29,23,129,15,8,3,69,0,67,8
8476432,2013,14.22,14.05,8,5,127,46,44,217,29,16,12,111,14,212,28
8476435,2013,0.22,0.22,0,0,2,0,0,2,0,0,0,2,8,1,1
8476436,2013,1.15,1.11,1,0,18,6,12,36,2,1,0,17,1,40,3
8476438,2013,18.47,18.12,20,8,159,51,61,271,47,19,14,140,50,48,50
8476440,2013,0.82,0.81,1,0,9,2,1,12,3,2,0,7,28,3,2
8476442,2013,12.75,12,8,6,124,33,42,199,24,10,8,114,3,7,17
8476443,2013,0.07,0.07,0,0,4,1,5,10,0,0,0,4,0,7,0
8476445,2013,0.59,0.58,0,1,13,3,0,16,1,0,1,13,4,4,5
8476450,2013,0.05,0.05,0,0,3,1,2,6,0,0,0,3,0,2,0
8476451,2013,0.24,0.23,0,0,4,2,1,7,0,0,0,4,0,2,1
8476452,2013,0.1,0.1,3,1,3,4,10,17,4,0,0,3,0,8,2
8476453,2013,13.34,13.17,7,2,102,54,33,189,18,9,4,93,1,15,17
8476454,2013,19.76,18.7,23,14,178,57,72,307,56,19,10,159,543,72,63
8476455,2013,22.03,21.03,28,11,222,72,90,384,65,26,22,196,13,176,64
8476456,2013,12.55,11.1,8,11,108,36,46,190,28,9,14,99,5,73,32
8476457,2013,0.56,0.55,2,0,20,11,23,54,3,1,4,19,0,41,4
8476458,2013,8.19,7.93,5,6,89,20,28,137,18,7,5,82,165,29,21
8476459,2013,14.8,14.23,14,3,153,77,39,269,33,16,9,137,183,118,31
8476460,2013,12.14,11.78,10,11,100,45,39,184,34,13,10,87,331,63,31
8476461,2013,15.96,15.58,16,10,165,59,55,279,39,13,12,152,646,64,47
8476462,2013,7.25,7.14,6,12,114,52,67,233,25,7,6,107,0,73,18
8476463,2013,3.67,3.6,1,10,74,33,70,177,19,8,4,66,0,33,28
8476465,2013,2.95,2.88,8,2,81,34,67,182,12,2,5,79,0,22,32
8476466,2013,3.03,2.83,4,5,30,10,16,56,11,2,0,28,0,22,9
8476467,2013,0.9,0.72,0,0,5,1,3,9,0,0,0,5,0,16,1
8476468,2013,3.38,3.31,0,3,46,19,14,79,6,3,1,43,26,44,11
8476470,2013,0.57,0.55,1,1,15,8,20,43,2,0,0,15,0,7,1
8476472,2013,1,0.97,1,1,14,6,13,33,3,1,1,13,0,6,3
8476473,2013,0.91,0.9,3,4,30,10,29,69,8,1,2,29,0,44,13
8476480,2013,0.49,0.51,0,0,4,0,2,6,0,0,0,4,12,3,1
8476482,2013,2.92,2.77,3,0,30,19,13,62,6,3,3,27,0,7,8
8476483,2013,3.55,3.38,3,1,22,18,14,54,4,0,4,22,95,21,5
8476522,2013,0.23,0.25,0,0,4,1,0,5,0,0,0,4,0,6,0
8476765,2013,2.34,2.33,0,0,25,5,13,43,1,1,1,24,4,52,4
8476779,2013,0.02,0.02,0,0,1,0,1,2,0,0,0,1,0,0,1
8476792,2013,9.25,9.09,10,16,183,63,144,390,40,14,6,169,1,50,24
8476798,2013,0.09,0.09,0,0,1,1,0,2,0,0,0,1,0,3,0
8476799,2013,0.02,0.02,0,0,2,0,1,3,0,0,0,2,0,2,0
8476805,2013,0.27,0.26,0,0,2,0,0,2,0,0,0,2,0,1,0
8476806,2013,9.82,9.64,10,5,113,41,33,187,19,4,8,109,7,70,19
8476808,2013,7.97,7.43,5,2,102,22,30,154,13,6,12,96,184,51,28
8476819,2013,0.98,0.99,0,0,13,5,2,20,1,1,0,12,46,16,3
8476822,2013,5.42,5.41,6,0,54,15,16,85,7,1,3,53,329,92,12
8476827,2013,0.15,0.15,0,3,3,5,8,16,3,0,0,3,0,0,2
8476850,2013,3.37,3.25,8,9,62,29,47,138,21,4,1,58,0,26,12
8476851,2013,14.31,13.1,13,5,110,36,47,193,31,13,10,97,5,49,30
8476853,2013,5.75,5.4,8,17,96,46,72,214,27,2,5,94,0,96,38
8476854,2013,5.8,5.66,14,10,116,32,78,226,30,6,14,110,0,54,22
8476855,2013,12.8,12.38,9,4,122,45,50,217,24,11,9,111,0,64,18
8476856,2013,0.45,0.44,0,1,12,7,12,31,2,1,2,11,0,9,2
8476871,2013,3.87,3.79,2,2,31,20,11,62,7,3,4,28,1,35,9
8476874,2013,7.17,7.02,12,8,119,48,75,242,29,9,10,110,0,41,10
8476878,2013,12.58,12.05,10,4,115,45,31,191,22,8,11,107,100,161,25
8476879,2013,3.28,3.26,4,2,82,29,55,166,9,3,8,79,0,45,12
8476880,2013,5.7,5.6,4,3,63,19,15,97,10,3,5,60,0,197,17
8476881,2013,13.06,12.86,5,5,98,35,33,166,25,15,3,83,29,39,18
8476882,2013,0.2,0.2,0,0,4,1,2,7,0,0,1,4,13,1,4
8476885,2013,7.78,7.57,9,10,121,66,106,293,29,10,5,111,0,95,31
8476887,2013,1.6,1.56,1,3,20,9,9,38,5,1,1,19,0,6,6
8476888,2013,1.54,1.47,1,0,20,6,8,34,3,2,0,18,53,6,7
8476925,2013,1.18,1.18,2,1,13,6,2,21,4,1,1,12,70,9,6
8476931,2013,0.01,0.01,0,1,1,0,4,5,1,0,0,1,0,5,2
8476941,2013,1.09,1.03,0,5,26,16,29,71,6,1,1,25,0,25,6
8476975,2013,0.18,0.19,1,0,1,0,1,2,1,0,0,1,16,2,0
8477059,2013,10.2,9.92,12,2,110,42,44,196,25,11,2,99,1,15,16
8477082,2013,0,0,0,1,0,0,0,0,1,0,0,0,0,5,0
8477126,2013,3.9,3.83,3,1,36,12,16,64,9,5,4,31,2,47,7
8477201,2013,0.74,0.71,0,0,7,1,2,10,1,1,0,6,18,7,2
8477205,2013,1.1,1.05,0,7,39,12,23,74,8,1,1,38,0,26,4
8477214,2013,0.07,0.07,0,0,2,1,4,7,0,0,0,2,0,1,0
8477215,2013,3.65,3.62,6,13,84,35,53,172,23,4,4,80,0,64,13
8477220,2013,1.28,1.27,1,3,41,13,23,77,6,2,4,39,0,18,10
8477227,2013,1.37,1.34,0,0,17,10,1,28,1,1,0,16,9,40,2
8477228,2013,0,0,0,0,0,0,0,0,0,0,0,0,2,0,1
8477244,2013,0.75,0.74,1,0,35,9,22,66,1,0,1,35,0,20,6
8477289,2013,2.81,2.57,2,4,54,25,53,132,7,1,4,53,0,103,7
8477290,2013,12.6,12.35,11,2,101,47,39,187,22,9,8,92,52,113,25
8477492,2013,22.47,21.76,22,17,241,79,68,388,63,24,21,217,194,57,51
8477493,2013,8.73,8.24,12,4,87,16,31,134,24,8,9,79,400,16,30
8477495,2013,5.39,5.2,6,13,100,51,74,225,25,6,5,94,0,55,25
8477496,2013,8.39,7.93,6,6,70,29,31,130,21,9,6,61,106,51,37
8477497,2013,16.06,14.33,8,4,140,44,66,250,34,22,10,118,476,42,26
8477499,2013,1.67,1.62,2,0,52,16,19,87,4,2,1,50,0,66,9
8477501,2013,14.6,14.15,13,7,128,51,41,220,34,14,10,114,0,86,25
8477507,2013,0.16,0.16,0,0,4,2,3,9,1,1,0,3,0,25,1
8477666,2013,0.5,0.45,1,0,7,2,2,11,2,1,0,6,0,5,1
8477814,2013,1.2,1.21,2,0,24,13,7,44,2,0,2,24,1,15,6
8477816,2013,0.22,0.21,0,1,2,2,1,5,1,0,0,2,0,0,1
8477832,2013,0.09,0.1,0,0,2,0,1,3,0,0,0,2,1,1,0
8477836,2013,0.16,0.17,0,0,1,1,0,2,1,1,0,0,10,2,0
8477847,2013,0.3,0.32,0,0,4,3,1,8,0,0,0,4,0,17,2
8477850,2013,0,0,1,0,0,0,0,0,1,0,0,0,0,1,0
8448208,2012,14.17,13.26,10,9,115,42,50,207,35,16,8,99,0,13,19
8457981,2012,11.31,11,10,2,96,35,36,167,24,12,3,84,85,8,23
8458529,2012,2.05,1.94,2,1,21,10,13,44,5,2,0,19,1,7,3
8458537,2012,7.61,7.27,9,9,62,35,41,138,29,11,2,51,16,10,29
8458590,2012,2.55,2.52,3,1,31,11,13,55,8,4,1,27,4,25,3
8458938,2012,0.24,0.23,0,1,7,6,8,21,1,0,0,7,0,8,1
8458951,2012,3.68,3.6,9,15,85,35,71,191,27,3,6,82,0,25,10
8459053,2012,0.55,0.55,2,2,26,12,27,65,4,0,2,26,0,43,4
8459442,2012,9.21,8.95,10,9,55,23,30,108,27,8,4,47,437,31,14
8459444,2012,0.58,0.58,0,1,10,3,4,17,3,2,1,8,0,6,0
8459454,2012,0.55,0.53,0,0,11,4,4,19,0,0,2,11,2,25,1
8459457,2012,0.21,0.2,0,1,5,0,0,5,1,0,0,5,0,4,0
8459492,2012,7.78,7.58,5,13,85,26,42,153,30,12,4,73,4,37,25
8459514,2012,0.65,0.63,1,1,10,5,2,17,2,0,0,10,42,26,3
8459628,2012,0.33,0.33,0,0,8,3,14,25,0,0,0,8,0,28,7
8459670,2012,5.08,4.83,14,10,78,35,56,169,29,5,6,73,0,31,13
8459687,2012,0.86,0.89,0,0,13,4,5,22,1,1,0,12,132,27,6
8460492,2012,0.17,0.16,1,0,6,4,6,16,1,0,1,6,0,3,1
8460496,2012,6.28,5.83,9,2,69,27,17,113,13,2,5,67,87,41,15
8460542,2012,12.63,12.17,14,8,118,37,55,210,36,14,5,104,71,20,26
8460561,2012,4.29,4.12,2,8,80,27,60,167,17,7,2,73,1,34,9
8460577,2012,5.64,5.2,5,2,41,10,18,69,11,4,2,37,2,6,6
8460621,2012,12.38,11.55,9,7,101,42,59,202,26,10,6,91,16,28,37
8460626,2012,0.93,0.91,2,0,29,13,39,81,2,0,1,29,0,36,11
8460719,2012,7.01,6.63,4,6,61,15,33,109,17,7,2,54,3,12,15
8460720,2012,0.45,0.46,0,0,5,4,4,13,0,0,0,5,0,23,1
8462033,2012,1.29,1.27,2,2,28,18,22,68,7,3,2,25,0,16,7
8462038,2012,9.91,9.63,7,7,129,38,53,220,27,13,8,116,4,118,23
8462041,2012,2.08,1.97,0,0,17,5,1,23,4,4,0,13,0,2,4
8462042,2012,13.98,13.69,13,6,134,37,48,219,33,14,4,120,123,65,18
8462077,2012,5.08,5.02,6,3,69,22,16,107,14,5,2,64,147,24,22
8462129,2012,3.53,3.38,4,2,41,16,11,68,8,2,3,39,236,31,16
8462196,2012,1.55,1.51,5,7,46,34,49,129,13,1,5,45,0,136,9
8462225,2012,2.13,2.07,4,5,50,16,16,82,10,1,6,49,0,37,14
8462535,2012,0.02,0.02,0,0,0,1,0,1,0,0,0,0,0,3,0
8464956,2012,4.63,4.54,3,6,89,28,45,162,14,5,8,84,0,93,9
8464966,2012,2.48,2.45,4,7,68,43,42,153,11,0,6,68,0,92,10
8464967,2012,3.45,3.4,2,3,34,8,12,54,5,0,3,34,157,21,14
8464975,2012,10.09,9.7,4,6,87,19,37,143,16,6,8,81,62,15,7
8464977,2012,2.32,2.26,5,2,22,10,7,39,9,2,5,20,11,31,6
8464981,2012,0.33,0.32,1,1,14,6,18,38,2,0,1,14,0,43,6
8464989,2012,9.6,9.11,15,5,79,32,29,140,27,7,9,72,245,18,14
8464994,2012,2.85,2.84,0,4,31,18,9,58,8,4,1,27,57,62,4
8465009,2012,6.82,6.39,10,2,119,54,75,248,19,7,2,112,0,101,12
8465012,2012,0.33,0.3,2,0,8,5,11,24,2,0,2,8,0,5,2
8465025,2012,1.22,1.17,0,0,14,3,7,24,2,2,0,12,5,39,5
8465042,2012,1.3,1.27,3,3,28,13,20,61,6,0,3,28,0,83,6
8465050,2012,1.8,1.73,2,1,31,4,19,54,3,0,2,31,203,19,12
8465058,2012,0.7,0.7,4,8,13,14,16,43,12,0,0,13,0,44,10
8465122,2012,0.3,0.28,1,0,6,2,10,18,1,0,1,6,0,5,1
8465166,2012,4.33,4.1,3,3,46,12,13,71,9,3,2,43,51,107,5
8465200,2012,0.41,0.39,1,2,11,5,7,23,3,0,3,11,0,2,1
8465202,2012,1.74,1.68,4,11,48,17,34,99,17,2,4,46,0,40,13
8465914,2012,1.63,1.61,4,4,46,13,42,101,9,1,1,45,0,78,9
8465951,2012,7.27,7.28,8,5,61,23,19,103,21,8,5,53,3,97,11
8465978,2012,4.11,4.1,1,3,55,17,26,98,7,3,2,52,7,77,11
8466138,2012,8.37,7.71,20,13,85,24,27,136,40,7,8,78,410,23,37
8466139,2012,18.93,17.74,5,9,150,46,49,245,31,17,19,133,71,38,25
8466140,2012,10.48,9.78,3,4,85,44,47,176,14,7,9,78,300,91,14
8466142,2012,2.43,2.39,5,3,56,24,56,136,12,4,2,52,0,88,13
8466148,2012,12.18,12.07,7,7,116,36,53,205,31,17,6,99,1,12,48
8466149,2012,10.55,9.96,1,5,93,22,18,133,15,9,5,84,11,56,11
8466158,2012,0.7,0.69,1,0,25,8,20,53,1,0,2,25,0,35,9
8466160,2012,7.77,7.63,8,5,55,22,19,96,25,12,6,43,13,85,11
8466182,2012,1.11,1.11,1,2,22,14,40,76,4,1,0,21,0,15,6
8466215,2012,4.29,4.1,4,7,71,30,47,148,17,6,9,65,0,27,15
8466251,2012,6.31,6.16,6,5,92,19,28,139,14,3,7,89,21,73,10
8466285,2012,4.77,4.47,6,13,70,34,40,144,27,8,6,62,0,14,14
8466333,2012,2.9,2.85,5,4,66,37,57,160,13,4,3,62,0,89,5
8466378,2012,13.28,12.71,17,26,112,40,40,192,60,17,10,95,12,23,43
8466393,2012,16.26,16.01,6,12,140,59,59,258,38,20,9,120,27,83,29
8466398,2012,1.1,1.09,0,0,13,5,4,22,1,1,0,12,3,23,2
8467096,2012,8.98,8.65,6,7,97,57,81,235,20,7,8,90,0,29,16
8467329,2012,10.85,10.29,15,7,86,29,21,136,32,10,5,76,404,74,12
8467330,2012,8.74,8.44,5,8,78,29,20,127,25,12,7,66,362,20,31
8467331,2012,1.78,1.73,2,4,39,30,62,131,6,0,6,39,0,87,15
8467332,2012,1.35,1.34,1,5,25,29,36,90,6,0,1,25,0,63,4
8467334,2012,0.33,0.32,0,0,2,2,2,6,0,0,0,2,64,8,3
8467336,2012,2.24,2.12,2,1,29,10,10,49,4,1,4,28,16,48,6
8467338,2012,6.92,6.37,10,6,44,20,20,84,27,11,7,33,68,24,19
8467344,2012,0.98,0.97,1,3,27,24,17,68,4,0,1,27,0,100,1
8467346,2012,7.62,7.5,5,6,76,27,32,135,16,5,4,71,2,24,17
8467351,2012,5.9,5.66,5,8,58,24,18,100,15,2,9,56,181,4,20
8467353,2012,5.7,5.37,8,4,56,15,26,97,18,6,2,50,128,76,15
8467365,2012,0.93,0.95,1,2,32,10,26,68,6,3,4,29,0,91,4
8467370,2012,7.17,7,7,4,68,33,37,138,21,10,3,58,275,67,23
8467371,2012,9.12,8.93,20,16,63,22,14,99,49,13,3,50,226,55,22
8467389,2012,8.58,8.25,14,9,110,44,67,221,34,11,9,99,391,25,31
8467396,2012,9.05,8.77,1,3,86,43,41,170,13,9,8,77,22,101,18
8467400,2012,4.46,4.4,5,13,74,27,47,148,24,6,6,68,0,81,17
8467407,2012,11.74,11.2,8,4,112,40,46,198,26,14,14,98,14,37,23
8467412,2012,5.57,5.43,2,3,51,30,20,101,9,4,3,47,2,81,4
8467423,2012,4.93,4.88,1,4,41,10,9,60,12,7,2,34,245,24,6
8467428,2012,0.65,0.67,0,0,4,3,2,9,0,0,0,4,1,25,0
8467452,2012,1,0.98,3,8,33,14,26,73,12,1,4,32,0,30,6
8467463,2012,0.22,0.22,1,0,4,5,2,11,1,0,0,4,0,6,1
8467478,2012,0.19,0.2,1,0,4,7,6,17,1,0,0,4,0,18,0
8467493,2012,7.67,7.45,4,4,87,24,25,136,12,4,4,83,3,206,13
8467496,2012,7.11,6.95,12,8,79,34,62,175,30,10,9,69,0,22,18
8467514,2012,12.26,12.07,18,16,107,54,56,217,49,15,1,92,488,31,56
8467543,2012,0.11,0.1,0,0,0,1,1,2,0,0,0,0,1,1,0
8467545,2012,12.09,11.18,8,11,101,32,53,186,35,16,4,85,3,35,19
8467580,2012,0.39,0.38,0,0,8,7,17,32,0,0,1,8,0,9,2
8467831,2012,2.48,2.42,1,1,26,12,12,50,3,1,3,25,208,56,15
8467875,2012,12.68,12.47,16,12,138,39,44,221,40,12,6,126,3,15,16
8467876,2012,8.91,8.4,18,16,70,21,23,114,45,11,6,59,440,22,21
8467881,2012,5.97,5.86,4,1,56,24,13,93,11,6,4,50,4,85,11
8467890,2012,0.78,0.78,6,3,39,9,36,84,12,3,1,36,0,70,11
8467899,2012,8.84,8.49,7,3,89,27,28,144,18,8,7,81,1,6,8
8467910,2012,0.24,0.22,0,0,4,4,0,8,0,0,0,4,0,12,0
8467917,2012,2.63,2.24,4,4,60,21,40,121,10,2,4,58,0,39,7
8467925,2012,2.45,2.46,3,1,34,13,5,52,4,0,1,34,141,59,11
8467931,2012,0.55,0.54,2,0,19,11,11,41,2,0,0,19,0,27,3
8467967,2012,5.05,4.91,3,3,40,14,16,70,9,3,3,37,216,43,19
8467977,2012,1.17,1.13,0,0,18,5,8,31,3,3,1,15,0,32,3
8467988,2012,4.47,4.26,0,2,37,11,7,55,8,6,3,31,9,49,14
8468001,2012,2.55,2.57,2,3,33,12,15,60,8,3,1,30,192,122,12
8468064,2012,6.61,6.44,8,11,69,20,35,124,24,5,4,64,32,48,18
8468083,2012,13.59,13.36,19,18,173,50,55,278,48,11,12,162,263,20,29
8468085,2012,8.62,8.38,10,6,106,34,34,174,28,12,12,94,10,26,18
8468095,2012,1.36,1.23,0,1,16,10,4,30,2,1,1,15,0,53,5
8468101,2012,0.49,0.49,0,0,12,8,5,25,3,3,1,9,0,15,2
8468114,2012,0.96,0.95,1,4,27,23,31,81,6,1,1,26,0,89,10
8468162,2012,3.71,3.6,3,0,29,9,10,48,6,3,0,26,265,96,8
8468172,2012,5.36,5.23,5,4,43,21,19,83,13,4,4,39,67,52,13
8468208,2012,6.77,6.42,6,6,52,16,21,89,20,8,4,44,38,37,16
8468309,2012,5.6,5.56,8,13,83,37,86,206,27,6,4,77,0,34,20
8468434,2012,7.94,7.91,9,5,86,24,28,138,21,7,12,79,95,10,13
8468478,2012,1.1,1.08,3,5,21,7,16,44,9,1,1,20,0,49,4
8468482,2012,9.77,8.92,7,3,83,21,31,135,21,11,5,72,12,26,8
8468483,2012,14.79,14.18,9,6,151,32,53,236,27,12,9,139,1,21,19
8468484,2012,1.9,1.72,3,3,44,22,30,96,8,2,0,42,0,40,4
8468485,2012,5.75,5.65,6,5,60,28,13,101,18,7,3,53,6,87,12
8468486,2012,9.01,8.62,3,0,74,35,19,128,11,8,7,66,3,68,11
8468493,2012,1.77,1.7,5,8,52,21,48,121,13,0,3,52,0,36,8
8468498,2012,0.72,0.72,3,5,32,12,28,72,8,0,0,32,0,119,5
8468501,2012,1.25,1.21,1,3,38,19,20,77,5,1,3,37,0,51,7
8468504,2012,12.08,11.35,16,9,97,45,47,189,35,10,6,87,4,44,19
8468505,2012,7,6.74,9,6,73,24,29,126,24,9,5,64,298,187,10
8468508,2012,13.16,12.07,10,12,142,56,52,250,33,11,15,131,2,29,15
8468509,2012,3.74,3.61,9,15,68,38,76,182,29,5,7,63,0,42,11
8468513,2012,1.23,1.21,3,5,33,14,21,68,9,1,0,32,0,52,9
8468518,2012,10.86,10.4,7,5,93,33,40,166,27,15,5,78,42,23,24
8468520,2012,0.76,0.75,2,2,21,13,18,52,5,1,2,20,0,16,3
8468526,2012,5.59,5.48,6,5,73,22,25,120,18,7,2,66,418,107,8
8468534,2012,0.18,0.18,0,0,2,3,2,7,0,0,0,2,0,12,1
8468535,2012,12.9,12.59,3,5,91,38,28,157,21,13,7,78,482,63,24
8468542,2012,2.67,2.59,9,8,38,20,43,101,23,6,7,32,0,17,14
8468598,2012,2.89,2.83,3,8,69,18,56,143,14,3,5,66,0,20,13
8468611,2012,5.79,5.71,1,2,54,27,24,105,8,5,4,49,147,93,15
8468635,2012,3.17,3.16,2,2,32,22,12,66,6,2,2,30,4,82,2
8468636,2012,1.02,0.99,3,3,40,20,26,86,6,0,3,40,0,65,14
8468639,2012,2.56,2.52,5,4,47,16,32,95,11,2,2,45,0,45,8
8468660,2012,0,0,0,0,0,0,0,0,0,0,0,0,0,6,0
8468674,2012,0.7,0.69,2,4,31,8,18,57,6,0,2,31,0,70,7
8468695,2012,4.48,4.44,2,2,44,11,22,77,8,4,1,40,105,24,7
8468700,2012,3.09,3,1,2,35,8,10,53,5,2,0,33,268,40,10
8468704,2012,3.38,3.3,0,2,26,10,10,46,5,3,1,23,0,29,2
8468778,2012,1.35,1.35,2,1,13,3,8,24,4,1,1,12,0,78,4
8469454,2012,10.2,9.92,11,9,123,58,57,238,31,11,7,112,7,13,10
8469455,2012,1.54,1.42,2,1,12,4,7,23,5,2,1,10,68,0,5
8469457,2012,2.06,2,2,1,19,7,14,40,4,1,1,18,141,6,13
8469459,2012,11.22,10.66,13,13,127,59,61,247,37,11,7,116,524,47,26
8469460,2012,0.04,0.04,0,0,1,2,4,7,0,0,0,1,0,11,1
8469462,2012,3.84,3.62,3,2,30,10,19,59,9,4,4,26,1,51,12
8469465,2012,3.46,3.44,8,12,62,43,67,172,24,4,5,58,0,47,20
8469466,2012,8.51,8.09,5,6,82,17,31,130,20,9,5,73,12,11,16
8469467,2012,4.27,4.19,3,1,43,13,17,73,9,5,5,38,18,34,14
8469469,2012,9.8,9.72,5,5,96,31,42,169,18,8,3,88,54,51,22
8469470,2012,0.64,0.66,1,0,12,5,10,27,1,0,1,12,0,12,0
8469473,2012,8.18,7.86,7,3,92,25,32,149,19,9,3,83,410,73,21
8469474,2012,3,2.99,2,1,33,12,9,54,5,2,1,31,9,36,10
8469476,2012,1.37,1.28,3,6,36,21,43,100,9,0,6,36,0,90,10
8469483,2012,2.4,2.31,4,2,23,11,4,38,7,1,1,22,175,41,6
8469485,2012,9.73,9.44,13,8,85,24,44,153,28,7,9,78,295,15,31
8469490,2012,3.87,3.78,4,0,42,16,14,72,5,1,4,41,11,98,6
8469492,2012,3.57,3.37,13,5,56,31,50,137,22,4,2,52,1,58,9
8469500,2012,10.52,10.42,13,6,102,45,45,192,32,13,3,89,253,20,22
8469501,2012,1.32,1.24,2,0,13,5,12,30,4,2,1,11,20,65,3
8469506,2012,9.77,9.63,12,8,118,51,54,223,34,14,4,104,51,21,38
8469508,2012,5.68,5.61,2,7,48,12,19,79,17,8,2,40,203,76,30
8469521,2012,14.34,13.88,10,9,133,43,60,236,33,14,7,119,486,26,15
8469531,2012,2.5,2.34,4,3,54,23,45,122,10,3,4,51,0,83,12
8469534,2012,0.2,0.2,0,0,8,3,12,23,0,0,0,8,0,18,0
8469544,2012,7.75,7.43,9,5,88,31,47,166,20,6,8,82,40,26,14
8469547,2012,3.29,3.24,4,1,45,15,19,79,8,3,2,42,0,68,11
8469555,2012,5.05,4.92,12,5,102,53,68,223,22,5,9,97,0,38,22
8469581,2012,3.77,3.71,5,4,37,10,14,61,15,6,2,31,43,10,18
8469591,2012,0.19,0.18,0,0,6,2,4,12,0,0,0,6,12,17,0
8469598,2012,3.54,3.5,1,5,77,35,50,162,12,6,5,71,0,60,21
8469619,2012,2.69,2.68,4,9,83,35,65,183,17,4,2,79,0,115,10
8469622,2012,9.43,8.94,9,7,87,36,42,165,19,3,9,84,5,99,13
8469623,2012,5.68,5.28,6,9,101,45,86,232,19,4,8,97,0,52,10
8469626,2012,0.8,0.78,1,0,15,10,15,40,1,0,0,15,0,39,5
8469638,2012,9.82,9.18,5,4,74,34,31,139,22,13,5,61,250,17,26
8469639,2012,1.28,1.28,2,1,10,5,14,29,4,1,0,9,41,14,2
8469664,2012,9.11,8.77,11,4,82,34,38,154,20,5,11,77,9,73,15
8469665,2012,1.88,1.86,3,6,52,25,42,119,12,3,1,49,0,24,19
8469685,2012,0.03,0.03,0,0,2,0,0,2,0,0,0,2,0,1,0
8469707,2012,12.46,11.81,15,10,105,22,47,174,43,18,5,87,1,50,40
8469755,2012,0,0,0,0,0,0,0,0,0,0,0,0,0,0,0
8469759,2012,4.74,4.63,10,3,56,23,24,103,17,4,2,52,319,34,18
8469760,2012,1.02,1,1,1,42,21,29,92,2,0,4,42,0,42,6
8469765,2012,1.38,1.34,3,5,43,19,34,96,9,1,4,42,0,16,7
8469770,2012,4.99,4.75,6,10,94,51,72,217,22,6,5,88,0,40,16
8469779,2012,5.75,5.76,4,2,50,18,24,92,12,6,4,44,167,33,21
8469812,2012,6.48,6.33,0,2,65,32,22,119,4,2,2,63,9,59,8
8469820,2012,1.53,1.49,0,0,18,5,6,29,0,0,0,18,162,23,5
8469992,2012,1.49,1.25,0,0,25,13,14,52,1,1,4,24,0,28,8
8470018,2012,0.44,0.42,0,0,8,1,0,9,0,0,0,8,15,0,0
8470039,2012,10.23,9.96,15,8,121,38,49,208,35,12,7,109,10,29,27
8470041,2012,13.9,13.76,12,9,176,43,60,279,42,21,10,155,5,46,19
8470047,2012,8.86,8.54,6,2,78,36,26,140,17,9,5,69,179,16,18
8470054,2012,1.72,1.71,1,1,35,11,24,70,2,0,1,35,0,45,16
8470061,2012,0.25,0.24,1,0,5,4,14,23,1,0,1,5,0,24,1
8470063,2012,3.5,3.44,1,1,39,18,17,74,3,1,3,38,122,65,4
8470104,2012,2.33,2.24,4,6,36,28,39,103,13,3,1,33,0,24,9
8470105,2012,4.94,4.73,1,0,54,19,11,84,5,4,4,50,9,38,13
8470110,2012,3.38,3.33,3,6,58,36,53,147,13,4,5,54,0,27,10
8470120,2012,14.99,14.54,20,11,150,77,96,323,44,13,13,137,5,14,46
8470121,2012,0.11,0.11,1,0,3,1,1,5,1,0,0,3,0,22,0
8470123,2012,0,0,0,0,0,0,0,0,0,0,0,0,0,5,0
8470137,2012,1.79,1.77,5,3,34,14,25,73,9,1,0,33,0,16,11
8470144,2012,7.89,7.81,10,13,93,32,34,159,29,6,5,87,268,23,29
8470151,2012,4.42,4.34,11,4,79,39,37,155,22,7,6,72,0,41,11
8470153,2012,6.63,6.44,5,7,71,14,18,103,20,8,1,63,1,12,10
8470156,2012,2.06,2.02,0,0,20,5,7,32,2,2,2,18,7,24,6
8470159,2012,5.7,5.43,8,2,59,26,16,101,14,4,6,55,452,22,18
8470162,2012,6.43,6.11,11,7,44,20,12,76,23,5,6,39,356,47,24
8470169,2012,6.38,6.34,6,3,52,29,24,105,13,4,4,48,189,71,15
8470171,2012,4.59,4.52,3,2,41,13,15,69,10,5,1,36,92,57,9
8470180,2012,5.9,5.53,3,1,49,33,25,107,11,7,2,42,15,122,19
8470187,2012,2.57,2.51,3,2,75,31,46,152,6,1,4,74,0,79,4
8470189,2012,0.45,0.44,2,0,10,2,5,17,2,0,0,10,4,10,3
8470192,2012,0.61,0.6,1,2,22,7,16,45,3,0,2,22,0,53,4
8470201,2012,7.39,6.85,9,8,56,21,24,101,27,10,3,46,10,16,22
8470207,2012,5.55,5.5,5,2,42,13,12,67,18,11,2,31,3,31,9
8470222,2012,2.97,2.83,5,4,62,24,51,137,14,5,6,57,0,53,11
8470230,2012,8.55,8.38,6,1,70,17,16,103,17,10,7,60,2,45,25
8470232,2012,0.6,0.62,1,0,4,2,1,7,1,0,0,4,16,9,1
8470257,2012,11.67,11.15,10,9,129,53,58,240,27,8,10,121,94,28,13
8470265,2012,0.13,0.13,0,1,5,3,5,13,1,0,0,5,0,1,0
8470273,2012,1.33,1.28,1,1,27,27,32,86,4,2,2,25,1,14,1
8470274,2012,8.6,8.35,2,3,77,30,24,131,15,10,5,67,33,46,36
8470280,2012,0.76,0.73,0,1,14,4,5,23,2,1,0,13,0,40,3
8470281,2012,4.43,4.4,10,14,91,29,64,184,27,3,5,88,0,19,26
8470283,2012,1.36,1.35,0,3,23,10,11,44,3,0,2,23,124,31,3
8470289,2012,1.36,1.4,0,1,22,8,8,38,2,1,0,21,145,41,10
8470302,2012,9.88,9.52,6,2,93,39,39,171,16,8,11,85,17,57,16
8470309,2012,1.09,1.08,2,7,30,4,23,57,13,4,2,26,0,16,9
8470310,2012,0.71,0.7,3,2,15,6,19,40,5,0,3,15,0,43,2
8470318,2012,1.5,1.5,5,5,34,21,35,90,13,3,1,31,0,67,8
8470324,2012,1.48,1.49,3,4,40,22,33,95,9,2,3,38,0,68,8
8470358,2012,16.64,15.78,7,4,140,41,34,215,24,13,6,127,48,52,19
8470378,2012,2.86,2.72,2,5,50,22,47,119,10,3,4,47,0,29,7
8470543,2012,14.69,14.34,17,13,113,43,40,196,52,22,6,91,4,104,13
8470595,2012,20.2,19.16,23,12,152,53,65,270,53,18,18,134,527,35,48
8470596,2012,12.31,12.17,4,5,114,26,42,182,22,13,8,101,5,41,9
8470598,2012,18.7,17.82,14,7,119,39,42,200,41,20,10,99,8,13,34
8470599,2012,6.74,6.01,4,6,58,32,26,116,14,4,3,54,2,6,9
8470600,2012,5.84,5.62,9,19,91,31,71,193,32,4,8,87,0,33,9
8470601,2012,2.22,2.21,3,1,38,29,35,102,5,1,4,37,0,76,12
8470602,2012,4.92,4.68,10,9,88,41,83,212,28,9,4,79,0,131,15
8470604,2012,16.16,15.93,6,1,133,65,65,263,33,26,11,107,202,25,23
8470606,2012,18.67,18,9,2,142,56,54,252,29,18,8,124,15,156,17
8470607,2012,3.27,3.18,5,7,65,26,57,148,20,8,4,57,0,106,15
8470609,2012,11.18,11.01,5,2,88,26,13,127,15,8,7,80,5,64,11
8470610,2012,24.3,22.34,14,6,182,47,34,263,38,18,30,164,3,59,24
8470611,2012,8.7,8.61,3,5,72,31,34,137,17,9,1,63,0,36,23
8470612,2012,9.8,9.76,25,9,99,41,40,180,49,15,3,84,355,89,27
8470613,2012,7.24,6.96,6,5,81,30,42,153,20,9,6,72,4,54,5
8470614,2012,1.44,1.39,1,1,40,26,49,115,4,2,4,38,0,111,5
8470616,2012,3.56,3.53,5,4,36,26,24,86,13,4,2,32,174,30,9
8470617,2012,9.9,9.58,12,8,82,44,38,164,32,12,7,70,216,58,21
8470619,2012,4.83,4.76,2,1,56,29,22,107,5,2,3,54,215,145,12
8470621,2012,15.49,14.92,13,8,128,40,40,208,36,15,8,113,6,49,18
8470622,2012,3.46,3.45,4,2,42,19,14,75,8,2,0,40,7,40,7
8470626,2012,13.86,13.41,10,7,104,48,37,189,29,12,5,92,9,6,29
8470630,2012,2.49,2.44,7,4,54,24,48,126,14,3,3,51,0,66,23
8470638,2012,13.39,13.04,11,11,125,47,39,211,32,10,3,115,549,28,23
8470640,2012,2.98,2.73,8,9,66,21,46,133,22,5,3,61,0,32,22
8470642,2012,7.48,6.74,8,11,124,52,63,239,28,9,16,115,0,112,14
8470644,2012,7.7,7.1,5,5,82,19,27,128,17,7,4,75,4,120,6
8470647,2012,3.95,3.85,5,2,50,22,12,84,8,1,2,49,4,44,11
8470654,2012,5.16,5.17,5,1,54,22,16,92,10,4,2,50,274,116,14
8470655,2012,10.29,10.09,13,9,100,39,28,167,28,6,9,94,477,158,30
8470662,2012,2.51,2.46,4,1,19,8,13,40,7,2,2,17,78,71,7
8470666,2012,1.73,1.64,1,0,23,4,15,42,3,2,0,21,0,37,6
8470667,2012,8.65,8.64,6,6,62,29,32,123,20,8,5,54,5,44,15
8470672,2012,1.24,1.21,1,3,26,22,24,72,6,2,1,24,0,104,10
8470685,2012,0.7,0.7,0,1,15,6,10,31,4,3,1,12,0,5,2
8470699,2012,1.45,1.39,3,6,50,20,48,118,10,1,5,49,0,96,18
8470704,2012,0.01,0.01,0,0,1,0,0,1,0,0,0,1,0,4,1
8470713,2012,1.25,1.25,3,3,13,7,3,23,6,0,0,13,0,36,1
8470714,2012,1.56,1.52,1,0,36,19,29,84,4,3,2,33,0,50,8
8470719,2012,1.25,1.23,0,0,17,3,4,24,0,0,0,17,7,21,2
8470724,2012,1.62,1.54,2,0,36,25,41,102,3,1,1,35,0,29,6
8470729,2012,1.62,1.58,2,2,42,19,34,95,4,0,4,42,0,110,11
8470740,2012,11.56,11,14,9,113,25,53,191,32,9,9,104,3,47,32
8470750,2012,5.67,5.64,7,3,72,28,47,147,20,10,2,62,171,99,28
8470755,2012,2.82,2.83,2,3,27,12,13,52,6,1,2,26,27,22,6
8470760,2012,1.81,1.81,5,4,53,16,28,97,11,2,5,51,0,130,7
8470774,2012,2.3,2.25,1,4,49,21,45,115,6,1,2,48,0,25,7
8470775,2012,6.08,6.02,5,3,58,26,18,102,15,7,3,51,310,85,21
8470777,2012,0,0,0,0,0,0,0,0,0,0,0,0,0,5,1
8470778,2012,6.33,6.18,2,2,54,20,14,88,8,4,4,50,1,81,12
8470794,2012,12.64,12.03,11,4,130,53,60,243,31,16,10,114,342,48,38
8470798,2012,0.03,0.03,0,0,1,1,1,3,0,0,0,1,0,0,1
8470803,2012,9.19,9.12,1,3,88,32,31,151,12,8,5,80,377,54,22
8470804,2012,0.01,0.01,0,0,0,1,1,2,0,0,0,0,0,0,0
8470816,2012,0.66,0.66,0,0,7,3,1,11,1,1,1,6,0,18,1
8470828,2012,1.31,1.29,3,8,21,14,15,50,15,4,2,17,0,9,2
8470834,2012,8.03,7.85,10,10,142,56,77,275,28,8,12,134,0,80,26
8470839,2012,1.11,1.05,2,2,28,12,26,66,4,0,2,28,0,42,9
8470852,2012,18.03,17.15,20,9,154,44,58,256,44,15,11,139,1,24,20
8470854,2012,3.14,3.18,0,1,38,5,12,55,2,1,0,37,22,125,1
8470871,2012,3.88,3.91,4,2,46,10,10,66,8,2,3,44,25,65,5
8470877,2012,5.71,5.51,5,1,62,18,22,102,9,3,6,59,6,45,9
8470886,2012,1.21,1.18,2,8,40,19,34,93,10,0,1,40,0,87,12
8470896,2012,0,0,0,0,0,0,0,0,0,0,0,0,0,2,0
8470920,2012,18.21,17.74,5,4,180,50,39,269,24,15,12,165,6,84,8
8470966,2012,2.85,2.78,6,5,58,34,56,148,15,4,3,54,0,65,34
8471185,2012,12.22,11.91,7,4,92,38,38,168,26,15,7,77,20,49,19
8471208,2012,5.15,4.96,6,6,61,24,18,103,14,2,5,59,2,59,15
8471214,2012,28.76,27.87,13,11,220,98,123,441,56,32,11,188,0,120,30
8471215,2012,9.84,9.65,14,10,99,46,48,193,33,9,10,90,195,12,23
8471216,2012,1.03,1.04,1,1,19,7,10,36,2,0,3,19,0,16,0
8471217,2012,14.17,13.82,14,14,121,60,46,227,46,18,5,103,29,98,25
8471218,2012,15.12,14.86,16,6,129,57,42,228,41,19,7,110,4,90,28
8471222,2012,1.65,1.64,0,3,30,22,20,72,4,1,2,29,0,151,8
8471226,2012,7.2,6.94,6,6,121,32,33,186,18,6,5,115,37,46,21
8471231,2012,4.39,4.26,9,0,37,12,11,60,14,5,6,32,126,61,14
8471232,2012,8.2,8.05,3,2,83,31,39,153,11,6,5,77,6,71,18
8471233,2012,8.64,8.31,7,6,82,37,27,146,20,7,7,75,506,33,29
8471234,2012,5.59,5.4,4,1,49,19,12,80,9,4,1,45,1,5,12
8471236,2012,0.66,0.61,2,0,18,6,18,42,2,0,0,18,0,18,2
8471240,2012,0.27,0.27,2,1,12,4,19,35,3,0,2,12,0,17,3
8471241,2012,0.45,0.44,4,2,9,14,9,32,6,0,2,9,0,88,6
8471242,2012,4.94,4.84,9,5,96,32,72,200,26,12,6,84,0,36,14
8471245,2012,5.1,5,6,1,46,13,16,75,14,7,2,39,239,43,21
8471246,2012,2.16,2.21,1,2,24,11,9,44,4,1,1,23,0,25,6
8471254,2012,4.92,4.96,8,6,82,25,42,149,23,9,5,73,2,108,23
8471260,2012,4.44,4.36,4,2,48,21,26,95,12,6,3,42,40,95,7
8471262,2012,0.35,0.34,0,2,6,2,2,10,2,0,1,6,7,3,2
8471266,2012,3.49,3.45,0,2,27,11,5,43,3,1,0,26,1,24,2
8471269,2012,1.08,1,3,0,21,14,21,56,4,1,1,20,0,81,6
8471273,2012,5.27,5.06,10,8,50,22,18,90,20,2,6,48,256,64,13
8471274,2012,4.52,4.4,11,13,80,55,67,202,27,3,3,77,0,56,5
8471276,2012,10.32,10.08,16,7,93,39,41,173,33,10,5,83,361,41,20
8471280,2012,2.29,2.22,2,0,23,8,6,37,6,4,3,19,0,13,6
8471283,2012,3.97,3.9,8,1,39,8,14,61,14,5,3,34,25,87,11
8471284,2012,2.07,2.04,4,6,33,15,37,85,12,2,4,31,0,30,10
8471296,2012,1.51,1.5,4,5,33,25,45,103,12,3,3,30,0,110,8
8471299,2012,3.19,2.88,2,1,37,10,17,64,3,0,2,37,92,12,10
8471303,2012,5.51,5.4,4,10,113,47,92,252,22,8,7,105,1,77,19
8471309,2012,11.93,11.76,11,6,116,54,31,201,31,14,3,102,30,43,16
8471311,2012,6.61,6.54,1,4,100,22,47,169,11,6,7,94,13,41,9
8471312,2012,0,0,0,0,0,0,0,0,0,0,0,0,7,0,0
8471314,2012,0.39,0.39,1,0,13,2,8,23,1,0,1,13,0,2,2
8471321,2012,0.2,0.2,0,1,8,3,2,13,1,0,0,8,0,4,0
8471323,2012,3.77,3.69,3,2,38,12,13,63,7,2,1,36,2,55,10
8471326,2012,2.52,2.33,1,2,24,9,7,40,5,2,5,22,0,116,4
8471331,2012,2.91,2.88,4,1,37,10,16,63,9,4,2,33,109,56,21
8471338,2012,4.93,4.71,3,1,39,22,12,73,8,4,5,35,21,47,14
8471339,2012,16.26,15.7,6,9,144,57,44,245,31,16,11,128,14,154,23
8471346,2012,1.65,1.61,0,2,20,7,6,33,4,2,0,18,0,5,7
8471348,2012,3.14,3.11,3,3,60,35,48,143,9,3,2,57,0,31,11
8471352,2012,0.33,0.29,0,0,3,0,1,4,0,0,0,3,2,2,0
8471362,2012,7.6,7.53,3,4,80,44,43,167,16,9,3,71,323,34,19
8471371,2012,1.91,1.84,1,0,18,15,15,48,2,1,0,17,5,87,6
8471385,2012,0.29,0.29,1,3,6,5,6,17,4,0,1,6,0,24,3
8471388,2012,1.77,1.71,0,0,34,7,10,51,1,1,0,33,5,86,2
8471390,2012,2.76,2.58,2,0,35,19,29,83,4,2,2,33,56,12,6
8471392,2012,1.21,1.2,1,4,39,30,31,100,6,1,0,38,0,110,8
8471402,2012,2.01,2.02,2,4,23,12,11,46,9,3,2,20,3,63,5
8471409,2012,0.05,0.05,0,0,2,1,2,5,0,0,0,2,2,4,1
8471426,2012,12.67,12.36,11,3,111,43,33,187,33,19,7,92,111,108,24
8471436,2012,2,1.94,3,3,57,12,43,112,6,0,2,57,0,40,30
8471450,2012,2.65,2.58,3,2,35,12,7,54,8,3,2,32,8,46,6
8471451,2012,1.21,1.23,0,0,11,3,3,17,3,3,1,8,30,7,4
8471476,2012,6.93,6.82,5,8,95,27,26,148,19,6,2,89,16,63,24
8471482,2012,2.97,2.87,7,5,56,23,39,118,16,4,6,52,0,82,8
8471490,2012,1.82,1.78,2,2,21,8,10,39,6,2,1,19,6,22,6
8471498,2012,8.35,7.98,10,7,99,35,43,177,27,10,2,89,3,55,21
8471504,2012,7.58,7.45,4,2,63,37,28,128,13,7,4,56,0,37,8
8471514,2012,10.96,10.63,5,7,95,36,20,151,18,6,9,89,211,23,23
8471521,2012,0.47,0.37,1,0,5,2,3,10,2,1,0,4,0,31,0
8471636,2012,0.19,0.21,0,0,4,3,2,9,0,0,0,4,14,10,0
8471657,2012,8.85,8.33,2,2,79,33,16,128,12,8,8,71,7,106,9
8471663,2012,0.47,0.48,0,0,5,1,1,7,0,0,1,5,0,2,0
8471664,2012,7.77,7.75,9,3,79,23,37,139,22,10,6,69,17,18,17
8471669,2012,10.41,9.89,5,10,87,34,18,139,24,9,11,78,409,21,23
8471670,2012,6.79,6.69,3,1,53,21,24,98,10,6,5,47,0,42,14
8471675,2012,14.75,14.27,28,13,124,44,35,203,56,15,14,109,453,21,15
8471676,2012,9.83,9.7,11,8,101,44,40,185,30,11,5,90,25,80,24
8471677,2012,5.5,5.29,5,9,96,42,58,196,19,5,4,91,0,66,9
8471678,2012,7.05,6.85,6,6,60,24,16,100,20,8,2,52,10,35,18
8471681,2012,5.84,5.57,6,3,69,30,20,119,12,3,4,66,8,96,12
8471682,2012,13.21,12.87,9,5,97,33,38,168,27,13,11,84,7,92,18
8471683,2012,0.47,0.47,0,0,13,9,12,34,0,0,2,13,0,49,1
8471685,2012,9.44,9.49,18,14,98,45,35,178,42,10,5,88,473,70,27
8471686,2012,1.72,1.48,4,5,20,20,31,71,11,2,2,18,0,47,4
8471691,2012,11.48,11.21,7,5,93,44,33,170,23,11,8,82,298,100,24
8471693,2012,2.75,2.63,3,6,76,31,50,157,13,4,2,72,0,46,8
8471698,2012,6.22,6.21,7,6,65,31,34,130,20,7,5,58,5,33,18
8471699,2012,9.51,9.52,6,4,79,22,39,140,23,13,4,66,32,40,13
8471700,2012,0,0,0,0,0,0,0,0,0,0,0,0,0,6,0
8471701,2012,0.08,0.08,0,1,2,2,9,13,1,0,0,2,0,24,3
8471702,2012,2.55,2.52,6,4,67,42,44,153,14,4,3,63,0,49,15
8471703,2012,0.59,0.58,1,0,2,2,0,4,1,0,1,2,1,5,0
8471705,2012,0,0,1,0,0,0,2,2,1,0,0,0,0,3,1
8471707,2012,16.59,16.22,9,6,136,39,74,249,36,21,11,115,1,56,11
8471709,2012,2.66,2.6,2,2,59,31,48,138,7,3,7,56,0,27,10
8471716,2012,11.41,11.18,2,1,96,29,22,147,13,10,4,86,65,120,10
8471717,2012,1.36,1.35,2,1,26,11,26,63,4,1,2,25,0,62,3
8471719,2012,0.71,0.67,0,0,6,4,6,16,1,1,1,5,0,38,1
8471724,2012,5.77,5.4,15,18,95,37,52,184,38,5,10,90,0,45,12
8471729,2012,1.31,1.3,3,3,41,15,22,78,7,1,3,40,0,26,10
8471733,2012,4.33,4.22,3,2,46,15,15,76,9,4,4,42,0,159,4
8471735,2012,7.6,7.43,11,9,130,55,88,273,30,10,10,120,0,18,20
8471742,2012,2.79,2.55,8,17,70,26,40,136,29,4,3,66,0,124,21
8471743,2012,6.3,6.24,7,4,69,22,26,117,19,8,0,61,286,98,15
8471748,2012,1.2,1.03,7,1,33,17,41,91,8,0,0,33,0,153,13
8471752,2012,0,0,0,0,0,0,0,0,0,0,0,0,0,0,0
8471761,2012,1.5,1.4,3,4,40,13,24,77,8,1,4,39,0,53,8
8471762,2012,0.57,0.53,0,0,7,1,1,9,0,0,0,7,21,12,2
8471766,2012,1.26,1.21,3,1,19,9,11,39,6,2,0,17,4,80,1
8471767,2012,1.74,1.71,0,1,22,4,7,33,1,0,0,22,58,22,4
8471768,2012,7.26,7.26,6,2,60,21,19,100,16,8,3,52,145,22,16
8471769,2012,1.58,1.52,3,5,43,20,36,99,10,2,5,41,0,26,29
8471794,2012,0.28,0.28,0,0,1,2,1,4,0,0,0,1,6,4,1
8471804,2012,4.29,4.21,3,2,64,20,26,110,10,5,4,59,0,32,12
8471807,2012,0.95,0.99,0,0,14,7,15,36,1,1,0,13,46,15,8
8471810,2012,0.03,0.03,0,0,2,0,2,4,0,0,0,2,0,4,0
8471816,2012,0.94,0.9,2,3,34,16,34,84,6,1,1,33,0,25,6
8471817,2012,2.67,2.63,1,1,24,4,6,34,6,4,4,20,3,135,9
8471832,2012,0.47,0.48,0,0,5,2,3,10,0,0,0,5,29,8,3
8471840,2012,0.14,0.14,0,0,2,0,1,3,0,0,0,2,8,7,1
8471842,2012,1.76,1.73,0,0,24,6,8,38,2,2,1,22,3,22,9
8471851,2012,1.93,1.93,2,1,33,13,18,64,6,3,1,30,5,21,6
8471853,2012,0.29,0.29,0,0,6,1,2,9,0,0,1,6,1,22,1
8471856,2012,2.38,2.36,2,1,26,12,5,43,5,2,3,24,157,45,8
8471859,2012,5.45,5.38,7,5,42,28,37,107,15,3,1,39,3,27,15
8471862,2012,9.24,8.85,6,5,80,39,30,149,19,8,6,72,22,122,19
8471873,2012,2.71,2.62,2,1,66,24,59,149,7,4,4,62,0,75,8
8471887,2012,7.95,7.45,3,7,87,21,21,129,14,4,8,83,1,29,7
8471912,2012,0.61,0.63,0,0,3,2,2,7,1,1,0,2,0,3,1
8471916,2012,0.14,0.13,0,0,0,1,0,1,0,0,0,0,3,0,0
8471956,2012,4.99,4.69,1,0,51,19,17,87,3,2,4,49,39,53,5
8471958,2012,2.71,2.65,2,10,81,46,53,180,14,2,1,79,0,102,15
8471976,2012,9.57,9.23,9,9,66,23,16,105,28,10,6,56,382,26,23
8471996,2012,0,0,0,0,0,0,0,0,0,0,0,0,0,3,0
8472368,2012,1.69,1.72,1,0,15,6,4,25,2,1,2,14,0,15,7
8472370,2012,0.01,0.01,0,0,0,1,1,2,0,0,0,0,0,1,1
8472382,2012,3.49,3.41,4,8,63,36,63,162,16,4,4,59,0,47,32
8472394,2012,2.05,2.02,2,1,36,13,19,68,5,2,2,34,0,21,5
8472410,2012,6.55,6.31,5,5,58,28,9,95,14,4,2,54,137,87,21
8472424,2012,1.09,1.05,2,0,6,2,2,10,2,0,0,6,4,22,1
8473412,2012,9.91,9.58,17,8,84,24,34,142,32,7,8,77,431,32,29
8473416,2012,0,0,0,0,0,0,2,2,0,0,0,0,0,0,0
8473419,2012,12.22,12.05,12,6,91,32,34,157,36,18,4,73,6,38,28
8473422,2012,7.88,7.81,7,6,69,18,25,112,19,6,7,63,3,99,17
8473426,2012,0.75,0.74,1,5,25,13,21,59,7,1,2,24,0,122,5
8473432,2012,3.49,3.34,1,5,38,7,13,58,9,3,2,35,13,55,5
8473446,2012,2.13,2.06,2,2,64,21,34,119,4,0,2,64,0,44,19
8473449,2012,11.29,11.01,14,6,101,36,38,175,24,4,4,97,104,48,35
8473453,2012,8.67,8.48,6,3,92,38,16,146,14,5,6,87,31,83,11
8473463,2012,6.24,6.02,1,4,51,28,17,96,9,4,4,47,29,176,16
8473465,2012,11.32,10.86,8,3,128,47,38,213,22,11,12,117,3,82,20
8473466,2012,1.76,1.61,0,0,16,14,10,40,1,1,2,15,91,50,7
8473468,2012,2.03,2.01,2,2,51,18,26,95,6,2,4,49,0,89,10
8473473,2012,8.89,8.74,12,8,79,45,48,172,27,7,8,72,17,139,20
8473482,2012,17.23,16.62,9,6,117,43,34,194,38,23,13,94,3,53,22
8473484,2012,2.43,2.37,0,3,36,7,12,55,4,1,3,35,9,23,13
8473485,2012,10.09,9.69,10,8,97,36,25,158,36,18,6,79,8,41,13
8473492,2012,5.06,4.99,4,1,61,24,26,111,13,8,5,53,6,103,8
8473504,2012,6.09,5.95,4,2,87,27,35,149,10,4,5,83,1,155,13
8473507,2012,2.59,2.44,4,5,66,30,45,141,12,3,1,63,0,112,32
8473512,2012,12.51,11.97,22,13,137,57,72,266,48,13,13,124,644,57,17
8473514,2012,1.04,1,2,0,15,1,2,18,2,0,2,15,0,12,5
8473525,2012,0.11,0.1,0,0,2,3,3,8,0,0,0,2,0,14,1
8473526,2012,11.73,10.94,7,2,131,31,31,193,17,8,13,123,46,29,33
8473533,2012,11.67,11.18,14,7,114,41,33,188,31,10,12,104,458,105,31
8473534,2012,9.86,9.74,5,3,74,26,31,131,25,17,3,57,279,53,10
8473536,2012,4.26,4.08,1,2,40,14,12,66,4,1,3,39,2,63,16
8473537,2012,10.59,10.43,11,3,113,40,36,189,23,9,10,104,0,43,22
8473542,2012,2.45,2.41,0,0,14,4,7,25,3,3,2,11,1,39,5
8473544,2012,6.8,6.62,14,3,88,24,39,151,29,12,7,76,215,83,19
8473546,2012,11.15,11.16,3,2,108,24,36,168,21,16,5,92,10,16,30
8473548,2012,15.99,15.28,23,9,161,65,87,313,52,20,6,141,5,16,25
8473558,2012,4.75,4.77,1,2,55,17,15,87,8,5,1,50,187,28,10
8473560,2012,0.94,0.95,1,0,16,8,7,31,3,2,1,14,0,61,3
8473563,2012,9.75,9.46,17,23,82,36,38,156,48,8,9,74,432,31,33
8473564,2012,5.25,5.29,3,4,98,27,35,160,10,3,3,95,15,32,42
8473565,2012,0.4,0.41,1,3,13,8,9,30,4,0,2,13,0,33,2
8473568,2012,0.41,0.4,0,1,6,3,2,11,1,0,1,6,1,13,3
8473569,2012,0,0,0,0,0,0,0,0,0,0,0,0,1,0,0
8473571,2012,1.48,1.4,3,4,46,16,39,101,8,1,3,45,0,22,8
8473573,2012,5.4,5.25,4,3,68,23,35,126,18,11,1,57,249,13,17
8473574,2012,9.24,8.94,5,2,106,27,36,169,21,14,7,92,153,66,16
8473579,2012,7.79,7.58,11,5,72,33,26,131,23,7,3,65,10,122,30
8473584,2012,2.24,2.22,3,6,45,21,46,112,12,3,1,42,0,26,24
8473588,2012,7.7,7.66,4,4,73,30,24,127,12,4,3,69,8,12,27
8473589,2012,0.16,0.15,0,0,5,1,3,9,0,0,0,5,0,12,1
8473600,2012,0.31,0.3,1,0,4,4,1,9,1,0,0,4,2,4,2
8473604,2012,15.73,15.63,13,12,143,36,45,224,48,23,5,120,559,24,56
8473610,2012,2.11,1.99,3,1,48,16,29,93,6,2,10,46,0,50,12
8473616,2012,0.14,0.14,0,0,5,0,2,7,0,0,0,5,0,12,0
8473618,2012,5.32,5.29,10,1,47,19,22,88,17,6,2,41,168,28,9
8473646,2012,7.2,7.07,7,2,63,23,14,100,15,6,3,57,43,50,17
8473658,2012,1.43,1.4,4,3,19,15,18,52,7,0,0,19,0,35,11
8473673,2012,2.17,2.12,0,5,35,23,24,82,6,1,6,34,0,38,5
8473682,2012,2.1,2.07,4,1,23,9,13,45,6,1,2,22,106,17,7
8473700,2012,0.78,0.74,0,3,23,10,13,46,3,0,3,23,0,17,5
8473712,2012,1.66,1.62,1,1,20,2,4,26,5,3,0,17,4,53,1
8473722,2012,0.67,0.65,0,0,15,5,4,24,0,0,0,15,0,38,8
8473734,2012,2.12,2.1,1,0,20,10,5,35,2,1,2,19,9,69,4
8473867,2012,1.6,1.59,0,0,10,5,2,17,1,1,1,9,1,20,2
8473908,2012,2,1.84,1,1,16,9,6,31,4,2,2,14,0,28,4
8473911,2012,0.63,0.64,0,0,9,3,2,14,0,0,0,9,0,29,0
8473914,2012,7.65,7.39,8,6,92,17,34,143,27,13,6,79,244,36,27
8473932,2012,1.66,1.66,0,0,23,15,11,49,0,0,1,23,56,82,5
8473933,2012,1.63,1.59,3,7,58,20,27,105,10,0,5,58,0,76,8
8473942,2012,0,0,0,0,0,0,0,0,0,0,0,0,0,0,0
8473944,2012,0.1,0.11,1,0,0,1,1,2,1,0,0,0,0,0,0
8473953,2012,0.82,0.58,0,1,18,6,8,32,1,0,2,18,0,7,2
8473962,2012,8,7.84,20,5,94,28,36,158,36,11,7,83,2,11,20
8473970,2012,3.71,3.68,4,2,34,13,11,58,11,5,2,29,2,65,5
8473986,2012,7.85,7.71,7,5,82,23,30,135,19,7,5,75,11,40,11
8473991,2012,1.6,1.56,1,3,39,29,30,98,5,1,1,38,0,45,10
8473992,2012,0.99,0.98,1,2,27,12,29,68,3,0,4,27,0,53,7
8473994,2012,13.12,12.53,14,7,110,49,52,211,33,12,12,98,327,71,41
8474001,2012,6.23,5.93,6,3,68,28,24,120,14,5,7,63,5,36,18
8474009,2012,3.09,3.03,7,1,37,16,16,69,13,5,3,32,138,11,16
8474013,2012,0.31,0.31,1,0,10,9,11,30,1,0,0,10,0,6,1
8474024,2012,3.21,3.11,1,0,38,13,12,63,6,5,1,33,100,30,9
8474025,2012,4.87,4.82,2,1,48,21,17,86,4,1,5,47,0,87,8
8474027,2012,2.21,2.13,3,4,48,35,56,139,7,0,1,48,0,53,12
8474030,2012,1.84,1.78,3,4,29,8,12,49,9,2,2,27,2,32,8
8474031,2012,3.29,3.18,7,11,84,40,65,189,23,5,4,79,0,55,22
8474032,2012,0,0,0,0,0,0,1,1,0,0,0,0,0,1,1
8474034,2012,1.94,1.88,1,0,21,9,1,31,3,2,4,19,4,22,5
8474035,2012,0.12,0.12,0,0,0,1,0,1,0,0,0,0,0,0,0
8474037,2012,16.28,15.5,6,8,140,47,46,233,32,18,10,122,24,55,17
8474038,2012,0.1,0.11,1,0,1,2,1,4,1,0,0,1,7,3,0
8474040,2012,11.97,11.41,11,13,113,35,45,193,38,14,4,99,325,35,23
8474048,2012,1.42,1.39,3,2,37,12,27,76,7,2,3,35,0,91,5
8474049,2012,0.24,0.24,0,0,2,1,2,5,0,0,0,2,0,5,1
8474052,2012,0.39,0.41,0,0,1,1,2,4,1,1,0,0,1,1,2
8474053,2012,17.49,16.98,11,5,151,63,49,263,37,21,10,130,252,32,31
8474056,2012,7,6.03,13,14,126,42,79,247,38,11,8,115,0,51,10
8474061,2012,0.17,0.19,2,0,4,0,0,4,2,0,1,4,0,7,0
8474062,2012,4.05,3.93,5,0,36,16,11,63,9,4,4,32,128,36,31
8474066,2012,2.5,2.46,1,2,40,15,40,95,4,1,3,39,0,27,13
8474068,2012,11.54,11.25,12,5,118,47,61,226,29,12,9,106,451,30,28
8474074,2012,2.58,2.55,4,1,32,28,33,93,9,4,3,28,0,17,9
8474089,2012,0.48,0.49,0,1,10,4,9,23,2,1,0,9,22,39,6
8474090,2012,1.46,1.45,1,7,33,17,37,87,8,0,1,33,0,20,10
8474091,2012,7.31,7.28,5,3,82,31,25,138,19,11,2,71,382,30,19
8474094,2012,5.08,4.86,6,0,51,14,9,74,11,5,5,46,2,33,13
8474095,2012,2.4,2.32,2,1,19,13,4,36,4,1,0,18,5,24,5
8474096,2012,7.01,6.19,3,1,57,24,24,105,13,9,4,48,223,38,22
8474098,2012,0,0,0,1,0,0,0,0,1,0,0,0,1,1,0
8474100,2012,5.6,5.51,3,3,60,29,15,104,10,4,3,56,2,58,14
8474102,2012,8.33,8.31,6,9,84,31,53,168,25,10,6,74,8,48,26
8474113,2012,3.64,3.17,4,3,42,32,33,107,10,3,4,39,0,31,12
8474121,2012,0.93,0.93,1,0,17,1,8,26,2,1,0,16,0,61,3
8474125,2012,1.11,1.08,2,12,28,15,20,63,15,1,1,27,0,78,11
8474134,2012,0.18,0.16,1,1,3,2,11,16,2,0,0,3,0,3,1
8474135,2012,0.48,0.47,1,1,3,7,8,18,2,0,2,3,0,14,3
8474137,2012,5.18,5.05,1,1,68,24,24,116,5,3,3,65,4,55,21
8474138,2012,3.02,2.98,2,1,26,12,10,48,6,3,0,23,94,6,2
8474141,2012,16.44,16.43,24,8,138,47,52,237,55,23,9,115,2,11,36
8474145,2012,0.56,0.56,1,1,10,8,7,25,4,2,1,8,0,18,1
8474150,2012,8.18,7.75,3,5,88,28,29,145,16,8,5,80,194,31,28
8474151,2012,4.24,4.13,8,7,83,34,64,181,19,4,2,79,0,69,27
8474157,2012,11.57,11.05,13,11,163,57,57,277,39,15,7,148,2,59,24
8474161,2012,14.93,14.34,13,11,129,36,51,216,46,22,10,107,2,20,21
8474162,2012,3.21,2.97,7,2,77,31,56,164,16,7,2,70,0,70,7
8474164,2012,1.37,1.22,3,3,26,9,20,55,7,1,5,25,0,32,10
8474166,2012,1.5,1.41,0,4,30,18,20,68,5,1,0,29,0,31,2
8474168,2012,4.14,4.01,4,1,43,14,11,68,8,3,5,40,144,17,4
8474176,2012,11.39,11.2,9,5,132,33,47,212,24,10,8,122,7,49,13
8474184,2012,1.15,1.12,1,2,23,21,24,68,3,0,3,23,0,74,5
8474189,2012,7.51,7.34,11,11,84,36,39,159,30,8,10,76,267,86,23
8474190,2012,15.19,14.04,8,9,110,31,31,172,32,15,9,95,2,72,10
8474192,2012,4.66,4.61,2,4,42,16,21,79,13,7,3,35,5,55,10
8474201,2012,2.08,1.94,1,0,16,12,7,35,3,2,0,14,2,40,3
8474207,2012,0.03,0.03,0,0,2,0,0,2,0,0,0,2,0,3,0
8474218,2012,0.81,0.81,1,1,27,19,23,69,3,1,3,26,0,32,6
8474230,2012,0.38,0.37,0,0,4,0,1,5,0,0,0,4,2,21,0
8474250,2012,9.7,9.55,5,6,94,40,35,169,15,4,8,90,379,97,22
8474291,2012,6.2,6.02,3,3,56,24,17,97,8,2,8,54,249,55,18
8474497,2012,2.55,2.43,4,4,49,31,41,121,8,0,2,49,0,49,12
8474518,2012,1.6,1.53,2,3,28,16,30,74,7,2,6,26,1,21,1
8474519,2012,1.05,1.01,4,2,28,15,17,60,9,3,2,25,0,10,2
8474520,2012,4.92,4.77,4,4,94,61,70,225,16,8,6,86,0,36,16
8474535,2012,2.92,2.69,1,2,22,7,2,31,5,2,0,20,92,14,5
8474551,2012,1.03,1.02,1,3,11,1,4,16,6,2,0,9,4,5,1
8474554,2012,0.45,0.42,1,0,2,1,1,4,1,0,1,2,0,5,2
8474563,2012,7.47,7.2,8,8,114,55,91,260,22,6,9,108,0,128,9
8474564,2012,22.35,21.62,17,11,157,68,62,287,57,29,8,128,406,63,24
8474565,2012,5.39,5.18,10,9,93,57,71,221,24,5,10,88,0,24,26
8474567,2012,3.15,3.08,2,7,85,38,49,172,14,5,1,80,0,79,12
8474568,2012,3.48,3.33,2,6,81,23,57,161,11,3,4,78,0,187,14
8474569,2012,5.15,5.01,8,4,26,23,11,60,19,7,4,19,8,10,12
8474570,2012,12.31,11.62,13,6,114,30,49,193,34,15,6,99,380,21,19
8474571,2012,8.76,8.49,7,12,83,27,27,137,26,7,7,76,1,77,27
8474573,2012,9.23,9.14,5,3,76,22,28,126,19,11,1,65,35,24,26
8474574,2012,2.54,2.11,3,2,48,19,35,102,8,3,0,45,0,58,11
8474576,2012,1.78,1.74,1,0,14,9,5,28,2,1,2,13,0,10,2
8474577,2012,0.21,0.2,0,0,4,1,0,5,0,0,0,4,15,11,2
8474578,2012,4.11,4.07,6,2,79,32,71,182,14,6,3,73,0,10,18
8474579,2012,2.02,2,3,4,39,20,41,100,8,1,4,38,0,99,10
8474581,2012,0.7,0.7,2,2,12,10,13,35,4,0,0,12,0,13,6
8474582,2012,0.43,0.46,0,1,2,1,3,6,1,0,0,2,0,1,0
8474584,2012,4.67,4.56,10,8,81,41,64,186,21,3,7,78,0,77,10
8474586,2012,13.87,13.63,16,5,133,42,29,204,37,16,8,117,8,31,28
8474589,2012,12.86,12.5,9,12,108,34,38,180,31,10,11,98,158,28,16
8474590,2012,4.17,4.1,6,10,97,41,54,192,22,6,4,91,1,59,18
8474594,2012,3.4,3.41,9,10,79,45,72,196,25,6,5,73,2,83,8
8474597,2012,0.36,0.33,0,0,14,2,2,18,1,1,2,13,0,10,0
8474600,2012,4.05,3.91,8,5,96,26,60,182,18,5,5,91,0,31,16
8474602,2012,5.85,5.74,4,15,85,41,64,190,27,8,7,77,0,15,15
8474605,2012,3.35,3.24,10,4,81,24,62,167,19,5,4,76,0,28,1
8474606,2012,0.84,0.78,1,0,15,9,16,40,1,0,0,15,0,4,3
8474609,2012,0.15,0.17,0,0,2,1,2,5,1,1,0,1,1,3,0
8474610,2012,2.13,1.96,1,1,18,11,8,37,3,1,3,17,1,14,4
8474612,2012,2.5,2.45,2,5,83,42,64,189,10,3,2,80,0,59,34
8474613,2012,11.19,10.94,18,8,108,42,58,208,44,18,4,90,448,52,34
8474615,2012,0.29,0.28,0,0,3,0,4,7,0,0,0,3,0,12,2
8474616,2012,0.35,0.35,0,0,4,1,5,10,0,0,0,4,1,15,0
8474618,2012,0.16,0.16,0,0,7,2,4,13,1,1,0,6,0,8,0
8474625,2012,1.29,1.33,2,1,13,5,3,21,4,1,0,12,4,11,3
8474628,2012,2.32,2.3,3,1,51,22,32,105,9,5,2,46,0,89,8
8474629,2012,0,0,0,0,0,0,1,1,0,0,0,0,0,3,1
8474641,2012,10.17,9.71,5,0,78,38,24,140,16,11,5,67,333,27,26
8474646,2012,0.4,0.4,0,1,2,3,1,6,1,0,0,2,12,4,0
8474649,2012,1.92,1.62,3,3,23,12,28,63,7,1,2,22,0,21,5
8474661,2012,0.08,0.07,0,0,2,2,3,7,0,0,0,2,0,0,0
8474666,2012,3.63,3.56,2,1,28,15,8,51,5,2,4,26,10,23,3
8474668,2012,4.06,4.08,2,1,35,11,9,55,6,3,2,32,1,84,8
8474673,2012,2.33,2.24,5,7,44,25,38,107,14,2,4,42,0,24,25
8474674,2012,2.86,2.69,1,2,32,10,14,56,5,2,2,30,22,43,12
8474679,2012,4.94,4.9,2,1,46,26,16,88,6,3,8,43,1,2,19
8474681,2012,4.85,4.63,3,1,47,14,15,76,12,8,0,39,80,6,19
8474683,2012,0.37,0.36,0,0,5,3,2,10,0,0,1,5,17,8,0
8474685,2012,6.03,6.02,5,2,63,19,40,122,16,9,3,54,2,57,17
8474688,2012,0,0,0,0,0,0,2,2,0,0,0,0,0,2,0
8474697,2012,0.01,0.01,0,0,1,0,3,4,0,0,1,1,0,26,0
8474705,2012,3,2.74,2,0,33,7,9,49,6,4,3,29,59,28,9
8474707,2012,1.39,1.34,1,2,30,9,25,64,5,2,2,28,0,50,3
8474709,2012,6.99,6.77,7,0,67,19,20,106,11,4,5,63,6,234,10
8474715,2012,9.9,9.73,7,2,91,33,18,142,18,9,7,82,0,24,19
8474716,2012,6.1,5.69,6,4,67,25,48,140,15,5,3,62,0,46,10
8474717,2012,0.11,0.11,0,0,1,2,3,6,0,0,0,1,0,0,0
8474719,2012,2.77,2.61,1,1,21,18,9,48,3,1,4,20,1,22,6
8474727,2012,0.01,0.01,0,0,1,0,2,3,1,1,0,0,0,1,0
8474736,2012,1.64,1.62,2,0,15,8,2,25,5,3,1,12,1,143,4
8474739,2012,4.99,5,5,3,69,14,22,105,13,5,2,64,4,115,18
8474743,2012,0.59,0.56,2,1,13,6,9,28,4,1,0,12,0,12,1
8474744,2012,0.13,0.13,0,0,0,3,1,4,0,0,0,0,1,3,0
8474749,2012,0.24,0.24,1,1,9,8,12,29,2,0,1,9,0,11,1
8474772,2012,0.26,0.27,0,0,2,1,3,6,0,0,0,2,0,13,1
8474774,2012,0.64,0.62,0,6,16,14,19,49,7,1,2,15,0,51,6
8474818,2012,1.45,1.38,3,2,31,18,30,79,6,1,5,30,0,25,8
8474837,2012,0.91,0.92,1,1,8,4,5,17,3,1,0,7,0,15,1
8474844,2012,0,0,0,0,0,0,0,0,0,0,0,0,0,6,1
8474849,2012,5.54,5.21,4,3,46,15,8,69,14,7,3,39,30,75,12
8474850,2012,0.03,0.03,0,0,2,0,2,4,0,0,0,2,1,7,0
8474870,2012,1.42,1.43,2,1,11,9,8,28,6,3,0,8,72,18,2
8474873,2012,0.93,0.89,2,2,26,10,13,49,5,1,1,25,0,44,3
8474884,2012,0.52,0.5,0,0,6,3,3,12,0,0,0,6,2,8,1
8474892,2012,0.21,0.2,0,0,2,1,3,6,0,0,0,2,0,2,3
8475060,2012,0.02,0.02,0,0,0,1,1,2,0,0,0,0,0,5,0
8475098,2012,9.75,9.66,8,8,61,24,30,115,28,12,1,49,559,65,37
8475118,2012,0.47,0.45,0,0,14,4,9,27,0,0,1,14,0,6,3
8475147,2012,2.45,2.45,5,1,28,12,25,65,9,3,2,25,140,10,14
8475148,2012,0.88,0.77,3,2,21,13,27,61,5,0,0,21,0,20,0
8475149,2012,5.93,5.81,9,7,40,13,15,68,22,6,0,34,40,14,15
8475150,2012,2.03,1.72,1,1,20,5,7,32,3,1,3,19,0,18,3
8475151,2012,8.41,8.36,6,5,92,35,32,159,21,10,3,82,1,48,14
8475155,2012,1.28,1.27,3,2,33,9,20,62,7,2,1,31,0,48,4
8475158,2012,5.68,5.53,6,8,66,22,30,118,20,6,5,60,241,7,34
8475160,2012,6.6,6.52,3,4,56,26,25,107,14,7,5,49,1,155,12
8475161,2012,0.53,0.52,0,0,6,3,1,10,0,0,1,6,0,6,1
8475163,2012,1.34,1.39,1,0,13,3,4,20,7,6,2,7,5,10,1
8475164,2012,12.51,11.98,8,1,134,42,53,229,19,10,9,124,5,38,20
8475165,2012,0.68,0.6,1,0,11,1,4,16,1,0,1,11,27,7,5
8475166,2012,20.96,19.96,10,9,162,62,65,289,47,28,9,134,459,33,27
8475167,2012,4.75,4.6,8,8,76,35,45,156,20,4,5,72,0,56,17
8475168,2012,13.27,13.05,19,7,132,46,36,214,43,17,7,115,488,48,44
8475169,2012,17.35,16.79,12,4,191,81,79,351,33,17,16,174,13,147,25
8475170,2012,10.09,9.87,11,7,79,31,36,146,26,8,8,71,206,109,19
8475171,2012,4.58,4.44,11,10,101,44,77,222,24,3,16,98,0,73,21
8475172,2012,14.49,13.89,21,5,107,55,44,206,44,18,11,89,250,62,23
8475174,2012,0.52,0.51,0,0,8,3,10,21,1,1,0,7,0,26,4
8475175,2012,7.25,7,4,3,75,17,18,110,16,9,9,66,4,24,9
8475176,2012,2.37,2.33,3,1,48,12,22,82,6,2,1,46,0,22,8
8475178,2012,6.99,6.84,2,2,49,26,26,101,11,7,1,42,6,70,10
8475179,2012,3.4,2.99,3,4,52,24,36,112,10,3,2,49,0,84,9
8475180,2012,2.19,2.18,2,0,26,12,12,50,5,3,2,23,89,17,7
8475181,2012,3.27,3.21,4,8,65,21,29,115,18,6,4,59,0,38,12
8475182,2012,0.44,0.43,1,0,9,5,7,21,1,0,1,9,0,7,0
8475184,2012,1.31,1.32,1,0,19,9,5,33,3,2,0,17,0,36,2
8475185,2012,2.31,2.27,2,0,20,14,7,41,3,1,1,19,114,12,10
8475186,2012,1.08,1.06,4,2,29,12,26,67,7,1,2,28,0,38,3
8475191,2012,4.36,4.25,4,2,34,17,14,65,9,3,5,31,3,18,14
8475192,2012,2.91,2.73,2,2,39,10,15,64,7,3,3,36,6,13,3
8475193,2012,2.94,2.78,2,1,32,11,14,57,7,4,3,28,1,9,5
8475196,2012,0.75,0.7,0,0,4,3,2,9,1,1,0,3,0,8,0
8475197,2012,2.68,2.57,5,6,58,37,48,143,13,2,6,56,0,31,13
8475199,2012,0.06,0.05,0,0,1,2,0,3,0,0,0,1,0,1,0
8475200,2012,0.04,0.04,1,0,1,2,5,8,1,0,0,1,0,2,2
8475204,2012,0.13,0.13,0,0,2,1,0,3,0,0,0,2,6,1,0
8475206,2012,1.39,1.33,3,0,35,14,29,78,4,1,0,34,0,10,8
8475209,2012,3.85,3.81,2,2,34,10,12,56,9,5,2,29,1,38,13
8475213,2012,10.4,9.84,7,3,96,26,41,163,13,3,13,93,212,37,19
8475214,2012,0.49,0.51,1,0,7,1,2,10,2,1,0,6,0,3,0
8475218,2012,0,0,0,0,0,0,1,1,0,0,0,0,0,0,1
8475220,2012,7.78,7.27,8,5,55,20,19,94,18,5,3,50,45,108,18
8475222,2012,0.18,0.18,0,0,6,1,5,12,2,2,1,4,0,2,2
8475225,2012,7.53,7.22,5,3,83,23,30,136,12,4,8,79,79,39,21
8475231,2012,5.29,5.26,5,4,45,14,22,81,15,6,3,39,144,75,21
8475233,2012,0.05,0.05,0,0,1,2,1,4,0,0,0,1,0,4,0
8475236,2012,8.13,7.77,9,8,67,19,34,120,24,7,8,60,304,71,27
8475248,2012,0.02,0.02,0,0,0,1,0,1,0,0,0,0,0,1,1
8475254,2012,1.25,1.2,1,1,20,4,5,29,3,1,1,19,29,21,2
8475264,2012,2.76,2.68,3,2,28,11,9,48,7,2,0,26,93,18,12
8475266,2012,1.46,1.32,0,2,12,4,10,26,4,2,2,10,0,24,4
8475268,2012,6.42,5.69,3,2,50,26,14,90,16,11,5,39,4,39,13
8475283,2012,0.71,0.71,0,0,4,2,0,6,2,2,0,2,0,13,0
8475304,2012,0.74,0.72,0,0,6,2,2,10,0,0,1,6,15,6,1
8475314,2012,0.13,0.12,1,0,2,1,1,4,2,1,0,1,0,0,0
8475323,2012,4.54,4.48,5,4,50,10,14,74,13,4,1,46,228,12,24
8475325,2012,2.54,2.46,3,1,23,9,12,44,6,2,2,21,0,72,7
8475342,2012,0.44,0.44,1,0,15,6,8,29,3,2,0,13,0,36,0
8475395,2012,0.08,0.08,0,0,4,0,2,6,0,0,0,4,0,5,0
8475430,2012,0.2,0.2,2,0,5,2,2,9,2,0,1,5,0,15,2
8475455,2012,3.22,3.14,1,4,75,36,50,161,8,3,9,72,0,133,8
8475462,2012,0.93,0.9,1,2,31,11,20,62,5,2,0,29,0,87,5
8475598,2012,0.05,0.05,0,0,1,1,0,2,0,0,0,1,0,1,0
8475613,2012,0.15,0.15,0,0,5,4,5,14,0,0,0,5,0,17,4
8475619,2012,1.87,1.88,1,0,21,11,10,42,2,1,1,20,1,80,4
8475625,2012,3.67,3.59,2,4,79,25,72,176,12,6,11,73,0,39,16
8475637,2012,3.29,3.19,4,3,41,13,17,71,11,4,5,37,2,15,7
8475640,2012,1.86,1.68,4,1,36,10,29,75,8,3,4,33,0,15,7
8475650,2012,1.76,1.7,0,0,34,11,9,54,0,0,2,34,0,41,1
8475661,2012,1.75,1.58,0,0,20,5,3,28,2,2,4,18,3,29,4
8475671,2012,0.92,0.93,1,1,17,6,8,31,3,1,2,16,0,13,3
8475690,2012,0.87,0.85,1,4,20,14,24,58,7,2,0,18,0,14,13
8475692,2012,2.7,2.66,4,1,27,11,14,52,8,3,4,24,0,27,6
8475722,2012,3.64,3.63,0,1,34,14,10,58,5,4,2,30,0,11,4
8475726,2012,2.11,2.14,1,2,20,9,9,38,5,2,0,18,0,4,3
8475727,2012,0.17,0.17,0,0,4,1,3,8,0,0,0,4,11,1,0
8475728,2012,0.04,0.04,0,0,2,0,0,2,0,0,0,2,0,2,0
8475733,2012,1.24,1.2,2,0,26,4,5,35,3,1,2,25,34,8,4
8475745,2012,5.69,5.58,5,1,50,19,19,88,14,8,2,42,9,50,14
8475749,2012,0.04,0.04,0,0,2,0,0,2,0,0,0,2,0,3,0
8475753,2012,3.23,3.17,2,8,76,23,39,138,15,5,4,71,0,63,24
8475755,2012,0.2,0.19,0,0,5,4,7,16,0,0,0,5,0,10,0
8475758,2012,0.42,0.43,0,0,5,0,0,5,0,0,0,5,0,14,2
8475760,2012,1.08,0.98,0,0,17,2,4,23,1,1,1,16,53,17,3
8475761,2012,3.36,3.33,4,7,30,15,9,54,14,3,1,27,1,28,10
8475764,2012,3.02,2.96,1,9,50,19,50,119,11,1,1,49,0,19,5
8475765,2012,8.01,7.89,9,2,75,34,26,135,19,8,5,67,1,28,14
8475766,2012,0.32,0.31,0,0,4,4,4,12,1,1,0,3,19,2,3
8475768,2012,5.24,5.1,4,2,50,14,20,84,13,7,2,43,15,34,21
8475769,2012,1.89,1.77,0,0,22,8,9,39,0,0,1,22,1,21,9
8475770,2012,4.2,4.09,6,1,48,24,17,89,10,3,8,45,2,43,11
8475772,2012,0.03,0.03,0,0,1,0,0,1,0,0,0,1,0,0,1
8475775,2012,4.49,4.16,0,2,33,8,10,51,5,3,4,30,0,19,6
8475784,2012,18.95,17.49,7,4,159,59,66,284,24,13,22,146,21,21,37
8475788,2012,5.69,5.57,3,3,55,26,32,113,10,4,2,51,142,106,22
8475790,2012,1.4,1.35,0,4,49,21,24,94,4,0,4,49,0,80,2
8475791,2012,15.75,15.29,25,9,154,49,55,258,50,16,7,138,29,24,31
8475792,2012,0.95,0.97,0,0,10,2,7,19,1,1,1,9,4,2,4
8475793,2012,6.84,6.72,5,2,84,19,15,118,12,5,4,79,272,42,15
8475794,2012,16.29,16.02,8,8,161,65,63,289,32,16,9,145,22,25,18
8475796,2012,0.88,0.86,2,2,21,8,12,41,5,1,2,20,0,6,3
8475797,2012,0.1,0.09,1,1,5,2,6,13,2,0,0,5,0,14,0
8475798,2012,2.97,2.83,4,2,36,11,11,58,8,2,2,34,97,15,8
8475848,2012,12.82,11.8,8,5,117,37,53,207,28,15,12,102,8,44,17
8475893,2012,0,0,0,1,0,0,0,0,1,0,0,0,0,0,0
8475913,2012,0.17,0.17,0,0,3,1,2,6,0,0,0,3,1,10,2
8475917,2012,0.24,0.21,0,0,2,0,1,3,1,1,0,1,0,0,2
8475958,2012,0.35,0.34,0,0,6,1,4,11,0,0,1,6,9,4,1
8476043,2012,0.93,0.96,0,1,13,5,5,23,1,0,0,13,24,8,3
8476062,2012,0,0,0,0,0,0,0,0,0,0,0,0,3,0,0
8476116,2012,3.9,3.87,4,3,59,15,29,103,10,3,4,56,7,67,11
8476158,2012,0.53,0.57,1,0,4,2,3,9,1,0,0,4,0,7,1
8476162,2012,0.76,0.74,2,6,25,13,32,70,9,1,0,24,0,58,5
8476177,2012,9.98,9.91,7,6,72,31,16,119,24,11,6,61,14,49,17
8476195,2012,6.92,6.6,9,9,67,14,29,110,29,11,4,56,4,39,10
8476205,2012,1.19,1.17,1,0,15,10,10,35,2,1,2,14,39,8,1
8476206,2012,0.12,0.11,0,0,0,1,0,1,0,0,0,0,2,2,0
8476244,2012,2.41,2.37,4,9,34,17,22,73,14,1,3,33,0,11,6
8476292,2012,1.34,1.34,0,2,16,6,4,26,4,2,0,14,0,28,4
8476302,2012,0.14,0.14,0,0,4,4,5,13,0,0,0,4,0,8,1
8476381,2012,6.62,6.47,2,4,64,22,25,111,15,9,6,55,201,70,12
8476419,2012,1.29,1.28,2,0,14,3,7,24,4,2,0,12,40,11,1
8476436,2012,0.11,0.1,0,0,2,0,0,2,0,0,0,2,0,2,1
8476438,2012,9.81,9.73,11,6,98,32,33,163,27,10,5,88,17,41,26
8476454,2012,10.01,9.74,11,9,78,38,34,150,24,4,6,74,226,27,22
8476455,2012,9.28,8.82,4,4,109,35,35,179,17,9,11,100,6,86,21
8476456,2012,12.73,11.35,9,8,112,34,36,182,31,14,12,98,11,33,17
8476457,2012,0.8,0.79,3,3,30,10,28,68,6,0,2,30,0,37,17
8476459,2012,8.31,8.04,6,7,90,37,26,153,20,7,5,83,159,82,12
8476460,2012,0.6,0.59,0,0,6,3,3,12,0,0,0,6,10,4,0
8476461,2012,7.37,7.05,6,5,75,22,25,122,15,4,5,71,243,31,26
8476462,2012,4.15,4.09,8,3,83,27,53,163,16,5,3,78,0,59,8
8476463,2012,1.98,1.93,3,6,51,17,39,107,11,2,3,49,0,17,18
8476465,2012,0.26,0.25,0,0,7,3,5,15,0,0,0,7,0,2,1
8476466,2012,2.76,2.67,4,3,28,8,8,44,10,3,2,25,1,12,12
8476467,2012,0.48,0.46,1,1,11,10,13,34,2,0,1,11,0,32,2
8476468,2012,4.48,4.36,2,0,43,20,20,83,4,2,2,41,63,47,4
8476470,2012,0.25,0.24,2,0,8,2,9,19,2,0,0,8,0,3,1
8476482,2012,0.05,0.05,0,0,0,1,1,2,0,0,0,0,0,2,1
8476483,2012,0.17,0.18,0,0,3,0,0,3,0,0,1,3,10,4,0
8476539,2012,0.08,0.08,0,0,0,1,1,2,0,0,0,0,0,1,1
8476792,2012,0,0,0,1,0,0,2,2,1,0,0,0,0,0,0
8476799,2012,0,0,0,0,0,0,0,0,0,0,0,0,0,0,0
8476807,2012,0.38,0.35,1,1,8,4,5,17,2,0,0,8,0,4,0
8476808,2012,3.41,3.31,2,3,49,11,13,73,11,6,2,43,24,10,9
8476819,2012,0.21,0.18,1,0,4,1,1,6,1,0,0,4,15,6,1
8476834,2012,6.26,6.24,3,5,51,29,23,103,17,9,1,42,58,7,8
8476835,2012,1.13,1.07,1,1,13,6,5,24,2,0,0,13,0,12,3
8476849,2012,0.2,0.2,0,0,3,1,2,6,0,0,0,3,0,4,0
8476851,2012,8.12,7.89,14,4,79,36,28,143,27,9,9,70,59,23,9
8476855,2012,9.74,9.54,10,4,81,32,49,162,31,17,6,64,0,41,18
8476870,2012,1.52,1.5,2,0,22,1,5,28,3,1,0,21,0,25,5
8476872,2012,0.51,0.51,0,0,10,0,5,15,0,0,0,10,19,10,0
8476887,2012,1.09,1.06,0,1,14,4,5,23,1,0,1,14,0,3,3
8476888,2012,2.4,2.36,3,1,31,11,14,56,5,1,0,30,57,2,7
8477059,2012,10.35,9.97,12,2,123,53,56,232,26,12,8,111,2,20,22
8477205,2012,0.05,0.04,0,0,2,1,0,3,0,0,0,2,0,0,0
8477215,2012,0.34,0.34,1,0,15,5,7,27,1,0,1,15,0,9,5
8477243,2012,0.54,0.59,0,0,3,0,1,4,0,0,0,3,9,0,1
8477244,2012,0.18,0.18,0,0,8,2,4,14,0,0,0,8,0,7,2
8448208,2011,20.4,19.58,21,14,170,80,74,324,54,19,16,151,0,14,22
8457063,2011,8.3,8.04,10,13,148,69,94,311,34,11,8,137,0,41,27
8457981,2011,22.68,22.18,24,16,210,95,64,369,66,26,15,184,145,23,29
8458525,2011,10.67,10.41,7,10,151,52,73,276,24,7,8,144,37,86,18
8458537,2011,22.96,22.39,36,17,185,71,88,344,77,24,18,161,4,28,34
8458541,2011,2.37,2.32,5,3,67,21,47,135,8,0,3,67,1,55,28
8458590,2011,9.71,9.22,6,6,91,39,27,157,18,6,7,85,14,86,25
8458637,2011,1.36,1.37,3,4,30,20,25,75,7,0,0,30,0,46,11
8458938,2011,2.13,1.94,4,7,58,21,52,131,13,2,4,56,0,69,26
8458951,2011,6.07,5.9,18,14,131,50,109,290,37,5,11,126,0,48,22
8459053,2011,2.71,2.66,0,7,92,49,60,201,9,2,11,90,0,97,26
8459424,2011,0.69,0.71,3,8,23,4,19,46,12,1,1,22,0,15,7
8459429,2011,16.76,16.25,9,8,142,49,40,231,34,17,10,125,387,24,17
8459442,2011,13.01,12.38,12,15,107,38,48,193,38,11,8,96,646,56,35
8459444,2011,13.34,12.78,9,15,118,41,29,188,38,14,9,104,5,96,21
8459454,2011,3.04,2.93,1,1,44,15,11,70,3,1,0,43,61,48,14
8459457,2011,10.62,10.23,11,7,127,29,49,205,24,6,14,121,10,70,15
8459461,2011,4.68,4.39,5,2,43,13,15,71,11,4,3,39,195,8,24
8459492,2011,14.38,13.7,25,14,165,42,52,259,55,16,8,149,9,59,53
8459514,2011,5.88,5.83,6,3,70,34,17,121,15,6,5,64,313,102,23
8459596,2011,10.44,10.06,11,4,75,25,16,116,27,12,5,63,7,21,16
8459628,2011,1.51,1.48,3,9,49,17,40,106,13,1,4,48,0,75,20
8459670,2011,6.14,5.69,18,21,130,55,71,256,43,4,14,126,1,68,14
8459687,2011,4.85,4.75,5,0,67,18,14,99,8,3,2,64,259,92,14
8460465,2011,17.54,16.71,13,10,170,70,72,312,44,21,13,149,10,19,27
8460492,2011,1.65,1.59,5,5,58,23,43,124,13,3,3,55,0,71,15
8460496,2011,22.27,20.84,12,15,194,80,41,315,46,19,15,175,66,53,54
8460504,2011,1.86,1.78,2,1,29,8,16,53,4,1,1,28,2,53,2
8460541,2011,4.69,4.71,4,3,44,18,24,86,14,7,4,37,221,28,9
8460542,2011,19.34,18.84,32,20,164,53,63,280,78,26,11,138,604,61,32
8460561,2011,5.74,5.47,8,7,179,71,104,354,21,6,9,173,0,55,23
8460577,2011,17.53,16.8,16,7,170,49,72,291,37,14,17,156,2,35,30
8460621,2011,22.91,21.53,21,11,191,72,74,337,59,27,14,164,20,52,50
8460626,2011,1.82,1.76,5,4,52,15,48,115,9,0,4,52,0,106,20
8460719,2011,14.88,14.02,14,17,140,45,45,230,48,17,7,123,4,38,17
8460720,2011,1.81,1.84,0,0,25,6,7,38,0,0,2,25,1,89,1
8460743,2011,12.57,11.99,6,7,97,36,20,153,24,11,9,86,1,56,16
8462036,2011,12.72,12.1,9,10,112,54,32,198,30,11,13,101,441,87,34
8462038,2011,24.05,23.37,14,14,226,109,89,424,50,22,20,204,33,205,48
8462041,2011,7.12,6.98,12,5,83,42,38,163,21,4,4,79,10,51,42
8462042,2011,28.47,27.71,25,10,251,96,104,451,67,32,24,219,214,124,52
8462077,2011,3.11,3.04,3,1,40,15,14,69,8,4,2,36,136,14,11
8462129,2011,8.7,7.99,14,3,81,26,25,132,24,7,9,74,413,52,28
8462196,2011,4.16,4.09,8,9,75,43,79,197,22,5,5,70,0,191,23
8462225,2011,3.67,3.59,8,18,78,37,78,193,32,6,5,72,0,53,23
8462535,2011,1.87,1.65,0,1,19,7,4,30,1,0,5,19,0,49,4
8464956,2011,3.95,3.79,6,8,85,37,68,190,19,5,4,80,0,134,18
8464966,2011,1.79,1.76,3,6,72,32,55,159,11,2,3,70,0,95,12
8464967,2011,6.46,6.4,1,4,69,16,25,110,6,1,4,68,303,43,25
8464975,2011,21.34,20.13,22,11,174,52,84,310,49,16,21,158,406,48,18
8464977,2011,13.31,13.01,17,10,109,38,24,171,44,17,6,92,191,102,34
8464979,2011,6.28,6.21,2,0,65,11,24,100,5,3,3,62,9,49,12
8464981,2011,1.27,1.24,2,4,36,24,47,107,7,1,4,35,0,144,9
8464984,2011,1.38,1.31,1,0,14,6,2,22,2,1,1,13,16,4,3
8464989,2011,18.86,18.03,15,6,164,36,67,267,35,14,11,150,627,46,37
8465005,2011,1.11,1,1,2,33,12,26,71,4,1,2,32,0,65,10
8465009,2011,9.89,9.13,20,20,224,86,151,461,52,12,19,212,0,166,28
8465025,2011,3.68,3.68,9,2,49,19,24,92,16,5,4,44,6,95,13
8465042,2011,1.45,1.46,3,10,46,28,52,126,13,0,2,46,0,134,13
8465050,2011,10.26,9.76,7,5,118,46,53,217,16,4,5,114,557,36,50
8465056,2011,0.09,0.09,0,0,1,1,0,2,0,0,0,1,0,2,0
8465058,2011,1.56,1.52,4,8,49,20,40,109,13,1,5,48,0,62,13
8465059,2011,3.42,3.27,1,4,35,6,20,61,8,3,1,32,12,134,7
8465122,2011,2.92,2.85,7,6,61,37,70,168,15,2,6,59,0,118,26
8465166,2011,6.98,6.97,8,5,76,27,27,130,18,5,7,71,132,162,13
8465185,2011,3.12,3.09,6,13,104,55,81,240,24,5,6,99,0,74,21
8465192,2011,7.07,6.81,8,5,93,40,39,172,17,4,6,89,540,123,44
8465200,2011,4.7,4.03,10,18,87,43,58,188,31,3,5,84,0,21,18
8465202,2011,7.25,6.84,8,8,136,54,92,282,25,9,5,127,0,29,23
8465210,2011,2.87,2.76,6,6,75,31,52,158,15,3,3,72,0,130,18
8465914,2011,3.89,3.71,2,5,38,22,51,111,11,4,3,34,0,103,23
8465951,2011,15.67,15.43,6,13,147,47,46,240,38,19,11,128,18,160,37
8465978,2011,8.99,8.88,7,1,114,38,35,187,13,5,4,109,16,91,19
8466138,2011,17.74,16.86,29,30,156,53,50,259,77,18,18,138,557,42,96
8466139,2011,30.7,29.37,16,18,251,93,74,418,64,30,18,221,243,84,38
8466140,2011,23.6,23.02,25,13,223,54,69,346,61,23,15,200,620,53,55
8466142,2011,4.2,3.97,8,12,83,51,88,222,21,1,5,82,0,197,26
8466148,2011,28.52,28.02,32,16,248,78,111,437,77,29,17,219,3,73,94
8466149,2011,20.18,19.3,11,10,199,57,52,308,33,12,13,187,21,90,27
8466158,2011,2.09,2.07,2,8,49,26,28,103,12,2,0,47,1,60,13
8466160,2011,9.63,9.38,7,8,88,38,32,158,26,11,4,77,11,130,18
8466181,2011,0.22,0.23,0,0,2,3,1,6,0,0,0,2,0,0,1
8466182,2011,2.52,2.49,5,1,43,23,29,95,6,0,4,43,0,32,19
8466215,2011,7.67,7.6,13,8,168,63,106,337,25,4,13,164,0,27,14
8466251,2011,16.95,16.36,11,8,205,47,44,296,39,20,13,185,30,132,23
8466285,2011,7.37,6.85,23,26,131,56,87,274,53,4,10,127,0,46,29
8466309,2011,0.77,0.77,1,1,22,10,19,51,2,0,3,22,0,38,17
8466333,2011,3.21,3.16,7,11,107,49,75,231,24,6,2,101,1,68,7
8466371,2011,3.2,3.17,0,0,33,11,6,50,3,3,3,30,155,23,19
8466378,2011,22.1,21.24,30,19,185,78,81,344,74,25,13,160,18,17,66
8466393,2011,19.08,18.55,20,14,214,77,89,380,59,25,16,189,51,111,25
8466398,2011,8.02,7.62,4,4,91,20,36,147,12,4,4,87,25,124,29
8467096,2011,12.75,12.28,13,26,252,98,170,520,48,9,16,243,0,58,21
8467304,2011,1.53,1.46,3,4,41,15,22,78,10,3,2,38,0,112,14
8467329,2011,21.91,20.8,14,13,182,62,64,308,49,22,12,160,556,103,24
8467330,2011,14.72,14.32,24,10,140,39,41,220,53,19,12,121,512,31,46
8467331,2011,4.35,4.22,6,9,96,44,70,210,21,6,7,90,0,177,22
8467332,2011,3.12,2.81,6,7,87,48,75,210,14,1,6,86,0,111,22
8467334,2011,5.94,6.02,4,7,60,19,25,104,18,7,5,53,536,44,22
8467335,2011,0,0,0,0,0,0,3,3,0,0,0,0,12,7,0
8467336,2011,2.27,2.17,0,1,31,11,7,49,5,4,0,27,19,103,3
8467338,2011,11.16,10.87,25,11,84,38,38,160,49,13,12,71,25,22,35
8467344,2011,1.72,1.67,1,3,49,19,36,104,5,1,2,48,0,172,11
8467346,2011,7.23,6.93,7,3,75,18,35,128,17,7,4,68,2,17,8
8467351,2011,6.29,6.17,8,1,59,26,31,116,11,2,4,57,165,11,14
8467353,2011,12.36,11.79,15,5,95,46,37,178,35,15,6,80,283,94,25
8467365,2011,0.45,0.44,1,1,20,8,13,41,2,0,0,20,0,39,4
8467370,2011,15.44,15.04,14,13,157,52,51,260,51,24,3,133,588,116,44
8467371,2011,13.15,12.75,25,20,142,53,52,247,63,18,7,124,341,113,39
8467389,2011,17.77,17.27,21,20,229,95,104,428,66,25,13,204,682,51,47
8467396,2011,26.98,26.06,15,11,241,68,99,408,61,35,17,206,24,186,39
8467400,2011,5.13,4.95,7,7,139,59,87,285,22,8,5,131,1,154,30
8467407,2011,7.86,7.69,6,1,75,46,33,154,15,8,5,67,14,35,15
8467408,2011,0.07,0.07,0,0,2,3,3,8,0,0,0,2,0,1,2
8467412,2011,18.09,17.66,9,10,156,54,65,275,33,14,17,142,4,143,33
8467423,2011,16.28,15.95,13,8,123,61,39,223,34,13,7,110,728,62,46
8467428,2011,2.96,2.81,1,2,24,13,6,43,5,2,0,22,2,67,5
8467439,2011,2.75,2.69,7,3,42,19,40,101,15,5,4,37,0,29,14
8467452,2011,1.58,1.54,2,6,63,29,59,151,9,1,3,62,0,61,17
8467463,2011,9.31,8.82,10,7,138,36,66,240,31,14,11,124,12,79,23
8467466,2011,3.8,3.69,3,2,51,20,19,90,7,2,6,49,4,72,3
8467478,2011,0.48,0.48,0,5,16,10,14,40,7,2,1,14,0,6,0
8467493,2011,13.89,13.12,9,6,127,30,35,192,28,13,10,114,0,271,21
8467496,2011,1.6,1.29,2,1,17,5,16,38,3,0,2,17,0,7,2
8467514,2011,16.86,16.39,28,20,164,67,69,300,67,19,10,145,702,76,97
8467543,2011,3.42,3.22,1,2,44,23,8,75,5,2,3,42,3,34,8
8467545,2011,24.18,23.34,17,10,211,74,99,384,62,35,11,176,34,86,48
8467579,2011,0.02,0.02,0,0,1,0,0,1,0,0,0,1,0,2,0
8467580,2011,1.67,1.6,2,1,44,16,23,83,4,1,1,43,0,53,13
8467831,2011,8.14,7.92,7,5,63,19,22,104,16,4,5,59,365,55,22
8467844,2011,9.11,8.77,3,2,109,42,28,179,12,7,9,102,0,41,19
8467875,2011,23.84,23.2,22,15,229,97,87,413,67,30,17,199,6,21,28
8467876,2011,13.42,13.09,44,23,113,43,53,209,81,14,4,99,652,32,31
8467878,2011,11.95,11.66,13,10,104,51,47,202,36,13,3,91,383,29,32
8467881,2011,11.3,10.95,5,5,111,33,37,181,19,9,8,102,6,137,14
8467890,2011,2.91,2.79,5,7,82,38,60,180,13,1,3,81,0,106,22
8467899,2011,9.49,8.73,16,4,96,33,42,171,27,7,14,89,0,6,19
8467910,2011,0,0,0,0,0,0,1,1,0,0,0,0,0,0,1
8467915,2011,0.64,0.63,1,1,23,9,22,54,2,0,1,23,0,53,4
8467917,2011,5.64,5.21,7,7,110,33,79,222,24,10,4,100,0,54,14
8467925,2011,6.28,6.03,4,1,63,18,8,89,7,2,7,61,276,89,12
8467928,2011,0.27,0.26,1,0,6,9,10,25,1,0,0,6,0,7,2
8467931,2011,0.6,0.58,0,2,17,10,25,52,3,1,0,16,0,58,3
8467943,2011,13.64,13.05,10,4,125,58,53,236,23,9,9,116,8,49,20
8467967,2011,13.81,13.71,11,8,122,41,37,200,39,20,9,102,419,79,35
8467977,2011,0.4,0.41,1,1,10,7,4,21,2,0,0,10,0,29,4
8467988,2011,19.22,18.26,16,12,144,49,19,212,48,20,13,124,29,142,37
8468001,2011,5.69,5.55,3,4,61,18,15,94,14,7,2,54,234,189,26
8468064,2011,13.38,13.13,17,22,107,38,50,195,58,19,5,88,60,52,60
8468083,2011,20.12,19.6,31,16,267,89,122,478,69,22,7,245,548,45,42
8468085,2011,20.94,20.54,16,11,232,82,85,399,62,35,9,197,27,57,37
8468086,2011,1.51,1.47,0,0,18,3,6,27,1,1,0,17,1,11,7
8468095,2011,1.42,1.4,3,0,17,7,5,29,4,1,0,16,0,57,5
8468101,2011,0.58,0.57,0,0,10,3,5,18,1,1,0,9,0,5,3
8468114,2011,2.33,2.28,3,1,71,25,38,134,4,0,2,71,0,126,14
8468162,2011,2.95,2.92,2,3,37,19,13,69,6,1,1,36,362,128,17
8468172,2011,10.12,9.93,6,5,94,37,35,166,20,9,6,85,16,86,22
8468208,2011,6.25,6.13,6,6,79,24,39,142,18,6,5,73,29,75,35
8468213,2011,0.9,0.89,0,3,19,7,15,41,4,1,2,18,0,14,6
8468224,2011,1.5,1.49,0,0,15,7,9,31,3,3,1,12,0,10,4
8468309,2011,9.86,9.31,23,17,149,49,121,319,47,7,20,142,0,110,50
8468434,2011,8.41,8.23,5,7,64,21,23,108,22,10,4,54,66,3,11
8468463,2011,8.44,7.87,3,4,77,26,28,131,12,5,5,72,6,79,15
8468478,2011,1.81,1.76,4,12,51,27,46,124,16,0,4,51,0,114,38
8468482,2011,29.15,27.55,17,12,238,92,104,434,53,24,21,214,36,70,33
8468483,2011,35.33,34.43,23,12,276,88,84,448,76,41,16,235,0,63,30
8468484,2011,4.3,4.18,5,5,87,35,52,174,13,3,6,84,1,112,13
8468485,2011,9.32,9.11,4,7,99,32,24,155,26,15,2,84,7,128,18
8468486,2011,34.03,32.35,17,13,232,83,59,374,67,37,10,195,20,188,27
8468493,2011,2.88,2.75,8,2,57,31,47,135,10,0,1,57,0,33,10
8468498,2011,1.43,1.39,7,9,44,31,45,120,18,2,5,42,0,259,13
8468499,2011,2.35,2.3,0,1,29,8,8,45,1,0,4,29,17,13,5
8468501,2011,2.69,2.67,4,5,63,29,55,147,11,2,6,61,0,176,14
8468504,2011,9.45,9.42,10,5,100,37,33,170,23,8,12,92,126,29,18
8468505,2011,10.93,10.43,15,13,108,62,48,218,39,11,8,97,561,278,26
8468508,2011,26.66,26.2,21,16,241,97,84,422,59,22,11,219,11,36,32
8468509,2011,9.7,9.46,5,16,141,49,91,281,36,15,6,126,0,133,21
8468510,2011,0.89,0.91,1,1,7,2,4,13,2,0,0,7,1,7,0
8468513,2011,3.14,2.97,3,3,51,39,41,131,7,1,5,50,0,83,14
8468515,2011,5.24,5.1,3,1,72,18,21,111,10,6,5,66,20,78,13
8468518,2011,13.23,12.6,13,9,143,69,87,299,32,10,7,133,140,45,60
8468520,2011,4.45,4.29,1,9,85,25,46,156,14,4,2,81,0,46,4
8468526,2011,11.56,11.01,9,6,133,60,56,249,21,6,10,127,662,165,19
8468534,2011,0.93,0.92,3,3,35,9,11,55,6,0,2,35,0,61,8
8468535,2011,15.56,14.94,17,9,149,63,42,254,37,11,16,138,645,124,44
8468542,2011,4.27,4.28,12,13,93,34,73,200,27,2,7,91,0,24,27
8468575,2011,7.97,7.74,12,9,103,42,52,197,25,4,4,99,419,52,25
8468584,2011,0.18,0.19,0,0,2,0,0,2,0,0,0,2,0,1,0
8468598,2011,5.26,5.08,8,13,112,49,82,243,27,6,4,106,1,63,22
8468611,2011,7.57,7.38,3,2,97,35,38,170,9,4,7,93,142,219,26
8468635,2011,4.97,4.75,5,2,45,24,13,82,16,9,2,36,5,75,13
8468636,2011,1.36,1.32,0,5,41,23,32,96,8,3,2,38,0,116,11
8468639,2011,7.55,7.14,10,10,106,46,86,238,27,7,5,99,0,68,16
8468660,2011,1.09,1.11,2,0,27,4,6,37,3,1,1,26,0,67,4
8468674,2011,3,3.04,5,8,86,39,61,186,17,4,10,82,0,174,9
8468695,2011,10.96,10.56,7,3,101,25,27,153,18,8,6,93,151,58,16
8468700,2011,7.3,7.11,9,5,75,28,24,127,21,7,7,68,659,114,22
8468704,2011,5.73,5.51,4,4,58,20,26,104,13,5,5,53,9,38,7
8468778,2011,0.45,0.44,0,0,3,0,0,3,1,1,1,2,0,7,0
8468789,2011,0.49,0.48,0,1,4,6,3,13,2,1,0,3,0,1,4
8468881,2011,0.8,0.77,0,1,10,0,2,12,1,0,2,10,8,16,3
8468887,2011,4.09,3.93,2,2,54,28,26,108,5,1,2,53,255,70,24
8468927,2011,3.81,3.8,3,6,57,23,33,113,14,5,4,52,0,49,6
8469120,2011,0.01,0.01,0,0,0,1,0,1,0,0,0,0,0,3,0
8469454,2011,29.57,28.86,26,20,310,115,147,572,83,37,24,273,13,27,42
8469455,2011,27.98,26.21,28,22,232,111,110,453,84,34,13,198,909,28,64
8469457,2011,18.67,18.09,20,17,149,69,47,265,57,20,11,129,781,92,56
8469459,2011,11.99,11.26,23,9,129,39,50,218,44,12,8,117,587,62,47
8469460,2011,0.99,0.97,2,2,34,17,34,85,5,1,1,33,0,104,25
8469462,2011,20.62,19.1,9,7,156,55,60,271,34,18,8,138,44,151,32
8469465,2011,6.07,5.94,16,16,140,69,124,333,36,4,17,136,0,103,48
8469466,2011,13.01,12.84,13,13,137,49,70,256,36,10,19,127,2,22,37
8469467,2011,6.44,6.22,6,1,65,19,29,113,14,7,4,58,7,62,17
8469469,2011,25.79,24.72,12,8,200,53,49,302,40,20,17,180,150,102,45
8469470,2011,3.93,3.68,8,9,68,41,71,180,19,2,3,66,0,73,9
8469473,2011,9.5,9.17,10,6,97,24,28,149,27,11,6,86,505,38,43
8469474,2011,1.52,1.47,0,2,14,5,7,26,3,1,0,13,7,37,6
8469476,2011,2.29,2.22,11,6,65,32,49,146,18,1,13,64,0,129,18
8469480,2011,0.36,0.36,2,3,13,5,16,34,6,1,0,12,0,18,4
8469483,2011,9.94,9.52,2,3,79,31,33,143,13,8,3,71,643,170,33
8469485,2011,17.76,16.87,11,16,176,56,94,326,44,17,7,159,672,35,46
8469490,2011,9.67,9.09,3,3,103,44,48,195,7,1,11,102,15,160,18
8469492,2011,6.35,6.23,8,13,124,39,83,246,26,5,9,119,0,100,16
8469500,2011,15.93,15.35,12,9,175,45,61,281,41,20,13,155,104,17,25
8469501,2011,5.95,5.77,6,1,69,27,24,120,11,4,4,65,39,151,13
8469506,2011,20.54,19.89,26,17,235,82,90,407,73,30,11,205,179,30,45
8469508,2011,9.17,8.91,4,3,95,34,40,169,17,10,12,85,448,72,34
8469516,2011,0.11,0.1,0,0,2,2,0,4,0,0,1,2,0,0,0
8469521,2011,19.77,19.52,21,14,220,74,104,398,52,17,14,203,824,67,43
8469531,2011,6.66,6.31,8,6,128,59,104,291,23,9,12,119,0,117,15
8469534,2011,3.63,3.55,6,7,64,28,31,123,16,3,6,61,0,100,17
8469542,2011,1.43,1.32,0,2,16,7,9,32,2,0,1,16,3,27,11
8469544,2011,25.93,25.22,19,17,282,86,115,483,69,33,17,249,139,80,55
8469547,2011,8.12,8.04,19,5,136,40,61,237,30,6,7,130,4,151,42
8469555,2011,6.59,6.43,12,15,136,71,96,303,32,5,8,131,0,47,24
8469581,2011,12.97,12.58,14,15,93,37,29,159,47,18,11,75,135,10,35
8469582,2011,0,0,0,0,0,0,0,0,0,0,0,0,0,0,0
8469591,2011,3.52,3.56,2,1,43,22,23,88,4,1,3,42,8,67,8
8469598,2011,7.64,7.57,9,27,166,75,114,355,44,8,3,158,0,159,29
8469619,2011,5.85,5.68,7,11,174,64,111,349,23,5,10,169,0,154,17
8469622,2011,18.68,17.86,14,14,180,51,66,297,45,17,28,163,6,109,42
8469623,2011,4.39,4.25,13,7,70,27,62,159,22,2,8,68,0,62,14
8469626,2011,0.66,0.65,0,1,19,11,31,61,3,2,0,17,0,91,13
8469638,2011,14.98,14.61,17,17,118,66,57,241,46,12,14,106,459,41,37
8469639,2011,18.71,18.14,20,5,191,55,52,298,41,16,14,175,664,120,52
8469664,2011,6.86,6.79,3,4,82,28,26,136,9,2,7,80,93,43,15
8469665,2011,3.73,3.65,8,7,82,52,79,213,18,3,3,79,0,64,23
8469684,2011,4.37,4.2,4,4,127,62,76,265,11,3,8,124,0,173,26
8469685,2011,2.12,2.15,2,1,33,12,7,52,4,1,1,32,5,66,6
8469707,2011,16.45,16.08,29,20,167,50,55,272,67,18,13,149,10,99,37
8469755,2011,0.64,0.56,0,0,8,2,1,11,0,0,0,8,1,12,0
8469759,2011,9.31,9.19,7,6,123,50,41,214,21,8,6,115,534,82,40
8469760,2011,3.3,3.18,4,7,77,40,57,174,13,2,4,75,0,47,10
8469765,2011,3.07,2.85,8,12,80,43,75,198,24,4,6,76,0,37,19
8469770,2011,10.06,9.54,19,16,175,90,105,370,46,11,13,164,0,113,30
8469779,2011,1.99,1.98,4,4,21,10,12,43,11,3,2,18,57,10,12
8469812,2011,22.71,22.16,8,5,199,64,69,332,32,19,15,180,18,131,26
8469820,2011,2.45,2.41,1,1,34,11,8,53,5,3,1,31,232,54,7
8469992,2011,1.91,1.84,4,7,49,40,43,132,14,3,6,46,0,120,12
8470005,2011,0.34,0.34,0,1,1,3,1,5,1,0,0,1,15,2,2
8470018,2011,6.18,6.11,1,4,85,28,27,140,8,3,4,82,117,34,22
8470039,2011,21.72,20.77,21,13,217,85,114,416,61,27,11,190,14,32,56
8470041,2011,24.93,23.72,22,7,306,87,113,506,59,30,18,276,6,104,62
8470047,2011,18.5,18.33,29,14,144,63,55,262,66,23,9,121,193,42,39
8470054,2011,2.68,2.57,0,6,41,29,35,105,7,1,2,40,0,61,8
8470061,2011,0.05,0.05,0,0,2,1,1,4,0,0,0,2,0,1,1
8470063,2011,7.04,6.95,7,6,82,31,27,140,19,6,4,76,217,69,17
8470104,2011,4.32,4.29,8,11,72,43,61,176,22,3,5,69,0,65,30
8470105,2011,4.95,4.61,1,2,53,26,17,96,5,2,3,51,3,44,8
8470110,2011,6.68,6.38,10,11,134,62,87,283,25,4,5,130,0,45,22
8470120,2011,14.9,14.56,22,11,183,98,113,394,54,21,13,162,1,31,52
8470121,2011,2.35,2.28,4,7,76,47,53,176,15,4,8,72,0,241,10
8470123,2011,0.98,0.98,1,0,17,5,2,24,1,0,0,17,2,74,2
8470137,2011,3.15,3.13,5,7,62,26,27,115,17,5,8,57,0,27,9
8470144,2011,12.67,12.54,13,17,133,48,51,232,47,17,5,116,523,29,58
8470151,2011,5.9,5.7,13,11,107,57,76,240,29,5,8,102,0,69,25
8470152,2011,2.54,2.63,0,3,22,9,18,49,5,2,2,20,2,1,9
8470153,2011,8.18,7.88,7,6,84,22,35,141,22,9,4,75,4,3,22
8470156,2011,8.44,8.26,7,8,75,35,34,144,26,11,4,64,1,101,23
8470159,2011,9.4,9,8,7,114,23,34,171,23,8,13,106,669,48,28
8470162,2011,10.51,9.71,5,5,77,16,28,121,18,8,4,69,331,49,28
8470169,2011,7.84,7.9,1,7,74,29,28,131,16,8,3,66,344,107,22
8470171,2011,15.5,15.32,11,4,115,38,41,194,34,19,5,96,284,150,30
8470176,2011,19.37,18.87,3,3,185,62,45,292,23,17,18,168,3,109,29
8470180,2011,10.61,10.36,3,2,102,43,42,187,21,16,3,86,14,176,20
8470187,2011,5.97,5.7,7,3,171,72,111,354,15,5,12,166,0,145,8
8470189,2011,1.56,1.6,3,2,20,7,6,33,6,1,2,19,11,32,8
8470192,2011,0.83,0.83,2,1,19,10,16,45,5,2,0,17,0,63,5
8470201,2011,16.48,16.05,13,12,127,52,42,221,50,25,8,102,2,48,21
8470207,2011,25.75,24.26,27,15,191,68,83,342,67,25,20,166,21,110,26
8470222,2011,5.37,4.99,10,11,99,55,61,215,27,6,5,93,0,50,15
8470230,2011,7.52,7.6,4,2,86,27,23,136,15,9,7,77,2,59,20
8470232,2011,0.03,0.03,0,0,2,1,1,4,0,0,0,2,6,14,0
8470257,2011,12.95,12.25,8,5,134,57,87,278,28,15,9,119,53,24,22
8470265,2011,2.78,2.63,5,3,48,26,50,124,10,2,1,46,0,17,9
8470273,2011,8.04,7.8,10,15,196,87,121,404,32,7,12,189,0,49,20
8470274,2011,14.68,14.45,13,13,165,54,32,251,44,18,10,147,12,61,50
8470280,2011,5.99,5.64,4,1,69,25,27,121,13,8,8,61,0,73,13
8470281,2011,6.75,6.64,17,19,162,90,126,378,40,4,8,158,0,45,48
8470283,2011,7.18,6.91,6,6,71,25,24,120,24,12,4,59,278,64,19
8470289,2011,10.41,10.26,6,2,118,39,24,181,21,13,10,105,634,163,23
8470294,2011,0.01,0.01,0,0,1,0,0,1,0,0,0,1,0,2,0
8470299,2011,4.31,4.05,3,2,44,18,27,89,12,7,5,37,159,26,11
8470301,2011,0.17,0.17,0,1,2,2,0,4,1,0,0,2,1,16,0
8470302,2011,11.5,11.24,5,2,120,49,44,213,12,5,9,115,15,129,33
8470309,2011,3,2.91,8,9,41,25,44,110,20,3,3,38,0,18,16
8470310,2011,2.01,2.02,3,3,42,28,35,105,10,4,2,38,0,64,4
8470317,2011,0.14,0.14,0,0,5,3,7,15,2,2,0,3,0,26,2
8470318,2011,2.69,2.67,5,5,63,25,47,135,11,1,8,62,0,128,9
8470324,2011,3.27,3.19,7,7,59,30,56,145,16,2,4,57,0,131,20
8470329,2011,2.11,2.07,2,7,43,19,24,86,11,2,4,41,0,43,12
8470358,2011,23.17,22.4,18,6,198,75,68,341,52,28,7,170,7,87,39
8470543,2011,28.81,27.68,18,17,230,98,70,398,61,26,18,204,20,180,28
8470580,2011,3.39,3.38,0,1,41,22,16,79,2,1,2,40,4,53,14
8470595,2011,30.63,29.8,31,15,262,100,114,476,70,24,24,238,882,48,66
8470596,2011,12.73,12.51,10,5,90,24,41,155,32,17,4,73,2,32,12
8470598,2011,22.69,21.48,22,13,204,56,69,329,61,26,15,178,3,34,24
8470599,2011,30.2,28.89,19,6,212,99,72,383,60,35,13,177,1,36,39
8470600,2011,9.28,8.79,20,19,134,46,62,242,46,7,10,127,0,46,37
8470601,2011,5.2,5.13,10,10,113,69,79,261,24,4,7,109,0,164,33
8470602,2011,11.37,11.11,14,18,202,91,131,424,44,12,12,190,0,214,30
8470603,2011,11.82,11.71,10,9,120,42,68,230,35,16,8,104,3,111,22
8470604,2011,18.84,17.92,7,6,184,76,52,312,34,21,14,163,393,16,26
8470606,2011,24.79,24,18,14,214,89,97,400,54,22,30,192,17,293,39
8470607,2011,6.3,6.01,8,17,156,60,88,304,34,9,8,147,0,198,34
8470609,2011,2.12,2.12,4,1,23,4,10,37,6,1,1,22,3,61,10
8470610,2011,34.14,32.72,27,11,293,68,55,416,69,31,22,262,30,65,65
8470611,2011,4.83,4.7,0,1,54,17,19,90,3,2,2,52,0,22,6
8470612,2011,16.7,15.93,27,19,185,104,107,396,57,11,14,174,639,182,35
8470613,2011,10.74,10.18,14,12,201,101,162,464,37,11,22,190,0,68,25
8470614,2011,2.46,2.41,4,7,60,40,69,169,14,3,5,57,0,198,7
8470615,2011,2.4,2.31,2,2,19,8,6,33,4,0,1,19,37,10,2
8470616,2011,25.92,25.1,15,12,222,95,99,416,49,22,17,200,724,108,43
8470617,2011,20.02,19.77,17,9,171,103,92,366,44,18,11,153,539,115,40
8470618,2011,4.98,4.9,5,6,64,23,18,105,20,9,7,55,3,92,15
8470619,2011,16.72,15.93,9,6,165,67,69,301,26,11,10,154,629,236,25
8470621,2011,33.66,31.79,19,4,278,104,85,467,60,37,17,241,19,69,35
8470622,2011,1.41,1.37,1,0,24,3,7,34,1,0,0,24,2,21,2
8470626,2011,20.58,20.06,27,18,187,55,59,301,71,26,12,161,7,20,50
8470630,2011,3.2,3.11,9,8,91,30,59,180,21,4,6,87,0,84,25
8470636,2011,0.28,0.28,0,0,2,1,0,3,0,0,0,2,8,2,0
8470638,2011,25.39,23.9,31,11,191,85,79,355,64,22,15,169,973,73,55
8470640,2011,7.2,6.66,15,19,132,48,112,292,38,4,9,128,0,55,18
8470642,2011,12.8,12.62,19,11,230,105,99,434,49,19,16,211,0,177,51
8470644,2011,0.34,0.33,0,0,6,4,1,11,0,0,0,6,0,8,1
8470647,2011,3.22,3.26,2,0,50,14,19,83,3,1,3,49,3,22,3
8470649,2011,3.02,3.02,2,0,34,11,11,56,4,2,2,32,5,7,6
8470654,2011,7.63,7.66,5,5,103,30,35,168,19,9,4,94,251,244,17
8470655,2011,27.12,26.54,17,13,234,93,70,397,54,24,26,210,658,226,50
8470661,2011,0.81,0.73,0,0,7,5,0,12,0,0,2,7,0,6,0
8470662,2011,5.99,5.91,1,5,54,20,25,99,8,2,1,52,175,149,16
8470666,2011,3.64,3.67,5,4,27,15,13,55,11,2,0,25,2,76,8
8470667,2011,16.67,15.91,12,11,148,47,85,280,43,20,6,128,5,60,17
8470672,2011,2.19,1.91,3,3,42,28,40,110,7,1,0,41,0,180,13
8470678,2011,0.6,0.6,2,2,10,3,6,19,4,0,1,10,0,12,4
8470685,2011,1.81,1.73,3,3,33,14,32,79,9,3,2,30,0,17,4
8470687,2011,0.01,0.01,0,0,1,0,0,1,0,0,0,1,0,1,0
8470697,2011,1.92,1.92,0,0,30,9,10,49,0,0,1,30,29,37,7
8470699,2011,3.07,2.95,6,8,78,55,74,207,19,5,6,73,1,142,27
8470700,2011,0.52,0.53,2,1,6,2,2,10,4,1,0,5,0,20,5
8470708,2011,0.43,0.42,0,0,2,3,3,8,0,0,0,2,1,16,0
8470713,2011,1.04,1.06,0,0,15,4,4,23,1,1,0,14,0,70,2
8470714,2011,3.78,3.65,9,8,98,44,74,216,21,4,5,94,0,90,31
8470719,2011,0.1,0.09,0,0,1,1,0,2,0,0,0,1,1,1,0
8470724,2011,8.74,8.5,6,13,168,53,115,336,26,7,14,161,0,101,24
8470729,2011,0.51,0.51,1,1,14,10,9,33,3,1,0,13,0,31,3
8470737,2011,0.55,0.54,0,0,5,2,1,8,0,0,1,5,3,1,1
8470740,2011,13.15,12.93,7,7,130,42,60,232,28,14,13,116,7,55,35
8470750,2011,8.59,7.96,5,6,64,28,25,117,16,5,11,59,103,89,11
8470755,2011,11.53,11.16,2,1,98,40,49,187,8,5,8,93,33,65,20
8470760,2011,1.48,1.45,3,3,42,17,30,89,7,1,1,41,0,106,10
8470774,2011,3.28,3.24,4,3,57,24,36,117,13,6,3,51,0,42,17
8470775,2011,8.87,8.57,3,3,85,22,28,135,15,9,5,76,293,107,29
8470777,2011,0,0,0,0,0,0,0,0,0,0,0,0,0,3,0
8470778,2011,11.95,11.51,8,3,131,31,32,194,25,14,6,117,5,79,26
8470780,2011,1.95,1.89,2,2,30,20,27,77,7,3,3,27,0,10,2
8470794,2011,29,28.07,20,10,269,125,109,503,61,31,20,238,507,50,73
8470798,2011,1.15,1.15,2,4,26,16,23,65,7,1,4,25,0,22,12
8470803,2011,22.3,21.02,15,7,160,65,58,283,44,22,13,138,707,81,70
8470816,2011,1.1,1.06,0,0,15,0,6,21,0,0,0,15,1,53,3
8470828,2011,4.95,4.84,11,16,94,34,55,183,33,6,4,88,0,24,8
8470834,2011,12.93,12.26,19,22,223,128,128,479,53,12,18,211,0,112,49
8470838,2011,0.01,0.01,0,0,1,0,0,1,0,0,0,1,1,0,0
8470839,2011,4,3.84,12,5,114,34,80,228,20,3,9,111,0,138,28
8470852,2011,31.08,29.02,19,13,214,61,74,349,67,35,21,179,1,33,57
8470854,2011,7.92,7.56,6,5,86,24,28,138,16,5,5,81,29,246,9
8470871,2011,5.56,5.6,1,2,61,17,18,96,7,4,5,57,8,124,4
8470877,2011,18.62,17.82,11,6,136,59,52,247,37,20,6,116,16,85,21
8470886,2011,1.88,1.84,1,3,47,25,31,103,5,1,6,46,0,72,14
8470896,2011,0.03,0.03,0,0,0,2,1,3,0,0,0,0,0,5,0
8470905,2011,1.11,1.09,0,1,24,19,31,74,2,1,0,23,0,23,7
8470920,2011,26.68,26.21,8,8,228,72,54,354,46,30,13,198,102,169,32
8470966,2011,6.28,6.09,10,8,125,44,102,271,27,9,4,116,0,84,26
8470986,2011,2.46,2.42,3,1,25,12,18,55,5,1,3,24,84,46,6
8470988,2011,0,0,0,0,0,0,2,2,0,0,0,0,0,1,0
8471185,2011,15.07,14.45,11,11,110,28,39,177,48,26,4,84,41,81,39
8471187,2011,1.25,1.2,1,2,36,15,19,70,4,1,1,35,0,21,7
8471208,2011,11.78,11.6,7,3,119,55,42,216,17,7,7,112,14,90,27
8471214,2011,29.18,28.27,14,13,303,135,172,610,65,38,16,265,6,215,34
8471215,2011,39.3,37.62,46,13,339,117,155,611,109,50,21,289,575,29,52
8471216,2011,2.01,1.97,0,0,35,13,32,80,2,2,1,33,0,36,2
8471217,2011,27.15,26.12,13,9,265,86,80,431,50,28,15,237,32,76,40
8471218,2011,24.36,23.25,31,16,208,102,61,371,64,17,19,191,4,113,50
8471220,2011,0.25,0.24,0,0,6,0,2,8,0,0,0,6,0,7,0
8471222,2011,1.88,1.87,1,9,47,17,28,92,15,5,3,42,0,186,31
8471226,2011,21.77,20.26,25,5,226,70,81,377,50,20,21,206,45,102,40
8471228,2011,2.66,2.73,3,1,21,7,7,35,7,3,0,18,0,5,5
8471229,2011,2.95,2.98,4,0,37,14,18,69,7,3,1,34,165,46,6
8471231,2011,5.23,5.07,9,4,43,17,18,78,16,3,2,40,173,67,13
8471232,2011,16,15.61,14,6,146,70,77,293,37,17,14,129,23,91,24
8471233,2011,3.18,3.1,3,1,25,7,7,39,6,2,1,23,118,11,12
8471234,2011,3.66,3.58,3,5,50,20,20,90,12,4,1,46,5,34,10
8471236,2011,5.63,5.61,11,7,114,42,83,239,25,7,9,107,0,144,21
8471240,2011,0.73,0.71,3,2,22,12,25,59,6,1,1,21,0,49,10
8471241,2011,1,0.98,0,2,30,30,29,89,2,0,2,30,1,235,10
8471242,2011,2.85,2.79,1,3,64,34,51,149,7,3,6,61,0,27,23
8471245,2011,14.17,13.88,12,6,126,34,51,211,37,19,7,107,582,58,53
8471254,2011,5.96,5.99,8,7,84,34,44,162,24,9,5,75,0,128,21
8471260,2011,10.73,10.25,5,5,137,51,95,283,15,5,6,132,29,144,37
8471261,2011,0.48,0.46,0,0,8,0,0,8,0,0,0,8,0,4,2
8471266,2011,13.78,13.34,6,8,159,42,61,262,30,16,10,143,9,81,20
8471268,2011,0,0,0,0,0,0,0,0,0,0,0,0,0,1,0
8471269,2011,1.79,1.7,3,8,56,39,40,135,11,0,4,56,0,164,8
8471273,2011,15.61,15.14,14,10,140,58,58,256,34,10,9,130,205,207,37
8471274,2011,7.81,6.98,13,8,140,85,113,338,30,9,6,131,0,49,19
8471276,2011,17.42,17.25,23,16,145,57,57,259,62,23,3,122,544,69,43
8471279,2011,0.69,0.69,0,2,19,6,14,39,3,1,3,18,0,24,8
8471280,2011,13.64,13.14,14,4,146,36,40,222,26,8,12,138,3,59,33
8471283,2011,11.09,9.93,7,5,68,22,18,108,17,5,5,63,3,144,15
8471284,2011,4.49,4.41,4,6,88,37,60,185,13,3,6,85,0,56,25
8471296,2011,2.71,2.66,3,1,62,25,59,146,7,3,6,59,0,236,13
8471299,2011,1.02,0.95,2,0,15,6,7,28,4,2,2,13,29,6,1
8471303,2011,9.94,9.57,16,22,228,96,169,493,49,11,10,217,0,143,32
8471309,2011,24.2,23.79,17,10,211,100,68,379,56,29,7,182,79,60,30
8471311,2011,13.94,13.62,17,5,195,64,65,324,33,11,17,184,42,70,19
8471312,2011,3.56,3.49,5,4,31,16,14,61,11,2,4,29,22,33,8
8471314,2011,0.42,0.41,0,2,9,10,7,26,2,0,0,9,0,3,0
8471321,2011,0.03,0.03,0,0,1,0,2,3,0,0,0,1,0,0,0
8471323,2011,15.33,15.05,6,10,137,47,44,228,33,17,8,120,3,119,46
8471331,2011,3.31,3.19,1,2,32,6,12,50,7,4,1,28,14,36,13
8471338,2011,8.77,8.48,5,5,100,31,44,175,19,9,4,91,36,94,33
8471339,2011,30.08,28.93,15,10,236,71,85,392,54,29,15,207,10,271,51
8471346,2011,19.53,19.14,20,11,181,62,53,296,54,23,10,158,21,52,62
8471348,2011,7,6.15,11,14,103,60,73,236,32,7,6,96,0,47,24
8471352,2011,3.33,3.11,4,1,39,14,16,69,7,2,4,37,94,80,9
8471362,2011,19.61,18.69,22,6,163,69,94,326,51,23,9,140,466,56,49
8471365,2011,0.19,0.18,0,0,6,0,0,6,0,0,0,6,22,11,1
8471371,2011,5.49,5.25,2,0,56,29,18,103,4,2,2,54,0,120,10
8471385,2011,0.91,0.89,0,3,29,8,19,56,3,0,0,29,0,39,9
8471386,2011,1.33,1.31,0,0,9,3,1,13,2,2,0,7,1,7,3
8471388,2011,5.56,5.36,3,2,69,32,29,130,10,5,2,64,10,139,19
8471390,2011,11.25,11.05,1,1,117,25,36,178,11,9,11,108,176,49,15
8471392,2011,3.43,3.29,3,8,88,46,56,190,11,0,4,88,0,173,15
8471402,2011,3,2.92,5,0,36,13,27,76,9,4,4,32,7,122,20
8471409,2011,3.04,2.99,2,1,38,20,15,73,5,2,0,36,0,49,8
8471419,2011,0.22,0.23,0,0,5,1,4,10,0,0,0,5,0,5,1
8471426,2011,14.83,14.55,9,6,133,57,58,248,33,18,9,115,38,247,39
8471428,2011,0.19,0.2,0,0,3,0,1,4,0,0,0,3,0,2,0
8471436,2011,2.24,2.14,2,1,40,10,26,76,6,3,1,37,0,24,11
8471450,2011,3.2,3.19,3,1,41,14,10,65,7,3,4,38,2,51,8
8471451,2011,0.56,0.57,0,0,6,3,3,12,0,0,0,6,18,1,1
8471476,2011,13.25,12.98,7,8,184,65,57,306,23,8,16,176,33,95,55
8471482,2011,3.16,3.08,5,8,87,43,55,185,17,4,4,83,0,85,15
8471483,2011,0.98,0.96,1,0,7,5,2,14,2,1,1,6,3,8,2
8471490,2011,0.11,0.11,0,0,1,1,0,2,1,1,0,0,0,1,1
8471498,2011,10.5,10.46,17,6,137,44,49,230,39,16,6,121,12,118,39
8471504,2011,17.27,16.8,3,3,159,63,97,319,24,18,12,141,12,86,32
8471514,2011,12.85,12.65,17,14,112,55,59,226,42,11,2,101,203,23,20
8471521,2011,3.27,3.08,0,0,27,14,14,55,1,1,2,26,3,96,7
8471634,2011,4.4,4.29,6,2,46,17,12,75,12,4,1,42,22,22,16
8471636,2011,0.84,0.85,0,0,6,4,5,15,0,0,0,6,31,28,1
8471657,2011,5.84,5.73,1,4,62,25,18,105,11,6,5,56,2,123,12
8471663,2011,2.59,2.53,2,0,34,14,7,55,4,2,2,32,2,104,8
8471664,2011,8.56,8.46,7,3,125,31,48,204,20,10,6,115,7,32,20
8471668,2011,0.79,0.67,0,0,14,2,3,19,0,0,1,14,2,4,0
8471669,2011,22.32,21.03,19,13,190,57,57,304,53,21,33,169,789,40,59
8471670,2011,5.47,5.29,3,1,36,16,9,61,9,5,1,31,2,37,12
8471675,2011,10.52,9.77,16,13,75,22,29,126,37,8,3,67,227,11,10
8471676,2011,21.23,20.65,20,6,204,95,75,374,57,31,12,173,20,113,35
8471677,2011,9.47,8.98,13,13,175,70,100,345,38,12,13,163,0,106,21
8471678,2011,11.6,11.38,9,7,107,41,26,174,32,16,8,91,8,97,37
8471680,2011,4.82,4.74,5,4,56,20,12,88,14,5,4,51,8,55,10
8471681,2011,6.98,7,6,0,76,29,29,134,10,4,7,72,8,99,10
8471682,2011,19.91,19.21,7,10,174,55,78,307,36,19,19,155,3,73,31
8471683,2011,1.5,1.48,6,9,32,31,24,87,16,1,1,31,0,127,9
8471685,2011,27.26,26.45,24,27,230,103,85,418,76,25,17,205,763,72,76
8471686,2011,3.01,2.83,1,2,61,19,30,110,5,2,4,59,0,55,14
8471689,2011,0.54,0.48,0,1,7,1,0,8,1,0,2,7,36,19,2
8471691,2011,15.23,14.84,14,12,145,58,46,249,34,8,7,137,571,239,41
8471693,2011,2.57,2.57,7,5,69,21,29,119,13,1,2,68,0,61,15
8471694,2011,0.12,0.12,0,0,3,0,4,7,0,0,0,3,0,10,3
8471697,2011,0.52,0.52,0,1,11,1,2,14,2,1,1,10,0,0,4
8471698,2011,20.91,20.2,24,11,188,61,47,296,54,19,16,169,24,130,61
8471699,2011,9,8.85,9,4,115,42,50,207,26,13,2,102,162,88,32
8471701,2011,0.03,0.02,0,0,1,1,2,4,0,0,0,1,0,3,0
8471702,2011,7.22,6.88,5,12,118,63,89,270,21,4,10,114,0,105,13
8471703,2011,14.33,13.86,13,14,140,51,74,265,41,14,9,126,40,105,49
8471705,2011,1.45,1.36,2,0,45,18,32,95,3,1,4,44,0,42,4
8471707,2011,37.22,36.27,21,20,329,123,147,599,81,40,34,289,4,108,30
8471709,2011,6.95,6.79,9,10,119,73,95,287,23,4,13,115,0,45,18
8471710,2011,0.27,0.24,0,0,2,2,2,6,0,0,1,2,0,0,3
8471714,2011,0.71,0.72,1,1,14,7,9,30,3,1,1,13,0,21,11
8471716,2011,11.15,10.91,12,2,121,37,38,196,22,8,10,113,239,148,16
8471717,2011,1.6,1.56,2,6,63,26,68,157,10,2,3,61,0,104,9
8471719,2011,1.62,1.59,0,0,13,3,3,19,2,2,1,11,0,32,1
8471724,2011,7.42,7.09,16,16,142,44,78,264,42,10,16,132,0,83,28
8471729,2011,3.38,3.27,3,3,56,21,44,121,12,6,0,50,0,61,16
8471730,2011,0,0,0,0,0,0,0,0,0,0,0,0,3,4,0
8471735,2011,9.08,8.86,17,15,196,102,138,436,43,11,15,185,0,31,24
8471741,2011,0.21,0.2,0,0,4,1,6,11,0,0,0,4,0,7,0
8471742,2011,3.46,3.38,5,11,65,30,78,173,21,5,1,60,0,102,20
8471743,2011,10.72,10.41,10,5,117,52,42,211,20,5,7,112,281,152,29
8471748,2011,0.14,0.14,0,0,2,4,4,10,0,0,0,2,0,7,2
8471752,2011,2.46,2.17,3,10,47,15,22,84,15,2,3,45,1,19,10
8471760,2011,0.56,0.56,1,0,13,0,2,15,1,0,0,13,5,22,4
8471761,2011,2.48,2.44,2,11,62,36,51,149,15,2,1,60,0,70,17
8471762,2011,0.04,0.04,0,0,1,0,1,2,1,1,0,0,18,4,2
8471766,2011,2.8,2.78,1,0,35,19,11,65,3,2,3,33,3,96,7
8471767,2011,5.74,5.66,3,2,58,16,16,90,8,3,4,55,128,49,18
8471768,2011,11.13,10.67,4,3,95,26,21,142,19,12,3,83,128,40,17
8471769,2011,1.73,1.69,8,6,65,31,62,158,15,1,6,64,0,42,30
8471794,2011,11.9,11.73,10,7,124,50,74,248,26,9,6,115,403,97,27
8471804,2011,9.58,9.37,14,5,137,32,48,217,25,6,5,131,7,53,18
8471807,2011,7.32,6.97,6,3,103,37,42,182,15,6,8,97,141,52,37
8471810,2011,2.95,2.74,2,0,36,18,24,78,4,2,1,34,1,47,6
8471811,2011,2.47,2.3,4,1,17,7,9,33,7,2,1,15,120,5,10
8471816,2011,3.25,3.16,2,11,92,39,83,214,17,4,5,88,0,83,20
8471817,2011,3.37,3.27,1,0,32,12,11,55,4,3,4,29,1,171,11
8471821,2011,0,0,0,0,0,0,0,0,0,0,0,0,0,1,0
8471840,2011,1.72,1.46,2,1,13,9,6,28,4,1,2,12,22,23,4
8471842,2011,1.92,1.81,1,0,22,3,2,27,2,1,0,21,64,48,9
8471846,2011,0.01,0.01,0,0,0,1,1,2,0,0,0,0,0,1,1
8471851,2011,11.1,10.82,5,4,101,54,52,207,18,9,10,92,8,48,19
8471856,2011,7.79,7.55,6,4,70,28,24,122,14,4,2,66,403,106,17
8471859,2011,10.91,10.84,19,8,99,42,58,199,44,17,5,82,0,45,32
8471862,2011,17.74,17.13,12,8,184,56,51,291,37,17,17,167,26,189,31
8471868,2011,3.86,3.71,0,0,39,12,13,64,2,2,1,37,0,37,11
8471873,2011,2.92,2.78,8,8,55,18,37,110,18,2,3,53,0,76,11
8471885,2011,0.87,0.84,0,0,7,3,2,12,2,2,3,5,35,2,6
8471887,2011,25.68,24.14,8,8,230,61,47,338,43,27,14,203,6,62,28
8471916,2011,0.52,0.47,0,0,8,0,3,11,1,1,1,7,4,6,3
8471941,2011,0.26,0.26,2,0,4,0,2,6,2,0,0,4,0,17,2
8471956,2011,5.33,5.29,9,4,80,27,25,132,17,4,7,76,192,93,37
8471958,2011,4.14,3.69,10,14,122,48,75,245,29,5,10,117,0,211,37
8471976,2011,13.05,11.62,26,18,98,29,35,162,60,16,8,82,678,33,36
8471978,2011,0.07,0.07,0,0,2,1,1,4,0,0,0,2,0,7,0
8471996,2011,0,0,0,0,0,0,2,2,0,0,0,0,1,6,1
8472262,2011,0.58,0.56,0,0,7,1,7,15,0,0,2,7,0,1,1
8472355,2011,2.35,2.35,1,0,44,13,13,70,3,2,1,42,125,80,6
8472361,2011,0.43,0.43,0,0,9,2,6,17,1,1,0,8,0,10,1
8472368,2011,0.91,0.9,2,0,10,4,3,17,3,1,0,9,0,4,4
8472379,2011,7.21,7.01,9,7,74,23,19,116,27,11,2,63,97,27,21
8472382,2011,2.09,2.08,7,8,53,32,33,118,16,1,5,52,0,35,15
8472394,2011,0.22,0.23,1,1,11,3,4,18,2,0,2,11,0,3,1
8472410,2011,0.78,0.75,0,0,2,2,0,4,1,1,0,1,5,1,0
8472424,2011,0.02,0.02,0,1,1,0,0,1,1,0,0,1,0,5,2
8473412,2011,21,20.36,14,8,162,63,66,291,46,24,13,138,733,44,44
8473419,2011,18.81,18.47,13,14,167,50,57,274,55,28,6,139,5,72,40
8473422,2011,18.51,17.95,18,14,153,41,51,245,47,15,11,138,62,196,35
8473426,2011,1.84,1.81,1,3,51,17,54,122,5,1,3,50,0,123,14
8473432,2011,13.46,12.78,6,2,137,37,33,207,20,12,11,125,14,199,36
8473444,2011,0,0,0,0,0,0,0,0,0,0,0,0,1,0,0
8473446,2011,7.13,6.84,13,9,155,53,100,308,26,4,19,151,0,123,35
8473449,2011,18.2,17.27,13,8,152,63,64,279,45,24,17,128,68,51,62
8473453,2011,8.87,8.64,1,3,103,52,29,184,7,3,9,100,87,117,25
8473456,2011,0.41,0.43,0,0,3,6,2,11,0,0,0,3,0,1,2
8473459,2011,0.18,0.18,0,0,8,3,3,14,0,0,0,8,0,13,0
8473465,2011,18.33,17.76,11,6,159,58,40,257,37,20,17,139,6,159,29
8473466,2011,0.61,0.6,3,0,12,6,6,24,3,0,1,12,29,61,5
8473473,2011,17.67,16.5,22,13,149,56,70,275,61,26,9,123,14,201,25
8473482,2011,14.98,14.48,9,10,136,45,45,226,36,17,14,119,3,83,31
8473484,2011,5.54,5.46,4,2,77,39,33,149,11,5,3,72,23,58,27
8473485,2011,16.13,15.94,11,4,166,56,47,269,30,15,9,151,3,112,17
8473492,2011,5.57,5.46,6,5,75,36,45,156,15,4,4,71,11,104,10
8473493,2011,0.66,0.66,4,1,10,1,4,15,6,1,1,9,26,11,0
8473501,2011,0,0,0,0,0,0,0,0,0,0,0,0,0,1,0
8473504,2011,16.64,15.6,6,6,161,65,58,284,27,15,9,146,5,288,28
8473507,2011,6.23,6.1,15,8,111,51,77,239,25,2,4,109,0,126,36
8473511,2011,0.33,0.34,0,1,6,3,4,13,2,1,1,5,2,8,1
8473512,2011,28.97,27.27,37,28,242,96,118,456,93,28,23,214,828,70,50
8473525,2011,0.94,0.9,1,1,25,14,24,63,3,1,2,24,0,94,18
8473526,2011,6.05,5.94,8,1,82,33,39,154,16,7,5,75,6,14,10
8473533,2011,19.64,18.01,18,7,149,62,54,265,50,25,10,124,591,101,39
8473534,2011,23.24,22.37,11,8,188,110,77,375,38,19,14,169,567,97,39
8473537,2011,22.57,21.84,12,9,215,87,68,370,43,22,10,193,5,91,51
8473539,2011,0,0,1,0,0,0,0,0,1,0,0,0,0,2,0
8473542,2011,0.67,0.67,1,0,4,1,1,6,1,0,0,4,2,37,0
8473544,2011,12.74,12.15,16,11,125,31,77,233,41,14,10,111,278,137,35
8473546,2011,19.41,19.2,7,5,174,53,48,275,32,20,7,154,3,16,94
8473548,2011,33.23,31.23,26,19,295,96,147,538,82,37,26,258,9,12,39
8473558,2011,4.87,4.62,2,2,63,21,19,103,10,6,1,57,151,37,16
8473562,2011,0.99,0.99,0,0,14,1,1,16,0,0,2,14,18,10,2
8473563,2011,9.19,8.94,17,13,95,36,30,161,44,14,5,81,353,31,28
8473564,2011,9.5,9.36,7,3,117,42,65,224,15,5,2,112,16,56,41
8473565,2011,0.26,0.26,0,1,4,8,0,12,1,0,1,4,0,12,0
8473568,2011,7.16,6.97,4,1,66,37,26,129,8,3,3,63,3,68,22
8473569,2011,1.13,1.13,0,2,22,9,8,39,3,1,0,21,1,21,4
8473571,2011,8.81,8.12,11,8,127,57,108,292,27,8,9,119,0,15,30
8473573,2011,14.57,14.38,12,8,132,61,61,254,36,16,9,116,161,75,37
8473574,2011,14.84,14.38,11,3,133,35,34,202,24,10,12,123,295,60,25
8473579,2011,13.86,12.79,11,10,107,78,47,232,28,7,8,100,32,97,34
8473584,2011,3.87,3.77,2,12,71,41,90,202,19,5,5,66,0,48,50
8473588,2011,12.17,11.71,11,6,140,49,48,237,25,8,2,132,11,16,48
8473589,2011,0.26,0.24,1,2,10,6,17,33,3,0,1,10,0,50,2
8473592,2011,0.01,0.01,0,0,0,1,1,2,0,0,0,0,0,1,0
8473600,2011,5.98,5.68,0,1,68,15,25,108,8,7,3,61,3,43,9
8473604,2011,20.7,20,17,11,185,35,37,257,57,29,12,156,675,32,82
8473608,2011,2.58,2.6,2,1,29,13,23,65,5,2,2,27,68,40,13
8473610,2011,0.13,0.13,0,0,5,1,2,8,0,0,0,5,0,1,0
8473618,2011,7.73,7.49,9,5,61,32,36,129,30,16,2,45,229,49,33
8473646,2011,5.38,5.12,3,1,50,20,18,88,8,4,1,46,215,114,19
8473647,2011,0.42,0.42,1,1,11,3,12,26,3,1,0,10,0,7,6
8473673,2011,1.93,1.87,3,7,58,23,40,121,11,1,5,57,0,52,5
8473682,2011,2.82,2.75,0,1,27,9,3,39,6,5,2,22,15,15,4
8473700,2011,2.26,2.14,12,8,63,32,56,151,21,1,4,62,0,97,33
8473712,2011,0.19,0.17,0,0,2,2,1,5,0,0,0,2,0,6,2
8473722,2011,0.45,0.45,0,1,9,6,5,20,1,0,0,9,0,39,8
8473734,2011,1.91,1.88,4,2,26,6,16,48,9,3,1,23,8,104,14
8473867,2011,0.01,0.01,0,0,1,0,0,1,0,0,0,1,0,0,0
8473898,2011,1.42,1.39,3,0,11,3,4,18,4,1,1,10,28,7,1
8473908,2011,1.1,1,1,0,13,6,4,23,2,1,1,12,0,31,1
8473913,2011,0.08,0.08,0,0,3,0,2,5,0,0,0,3,0,0,0
8473914,2011,10.55,10.05,8,6,114,38,36,188,25,11,8,103,375,60,32
8473921,2011,0.05,0.05,0,0,2,2,2,6,0,0,1,2,0,6,0
8473927,2011,1.61,1.59,0,1,18,8,6,32,1,0,0,18,75,36,4
8473932,2011,9.76,9.47,5,2,109,47,33,189,13,6,6,103,46,151,22
8473933,2011,2.12,1.99,2,2,48,18,34,100,5,1,1,47,0,30,1
8473942,2011,2.08,2.01,2,1,17,3,5,25,5,2,0,15,34,19,3
8473953,2011,2.36,2.29,6,3,44,37,26,107,11,2,4,42,0,27,14
8473962,2011,16.19,15.54,28,13,152,56,64,272,65,24,12,128,3,17,34
8473970,2011,2.16,2.07,1,1,26,13,7,46,2,0,4,26,2,47,7
8473991,2011,1.67,1.63,6,10,56,33,57,146,17,1,2,55,0,74,18
8473992,2011,2.26,2.24,3,5,46,24,35,105,9,1,2,45,0,78,12
8473994,2011,21.26,20.93,16,21,203,81,82,366,63,26,11,177,347,136,56
8473999,2011,5.9,5.69,1,2,55,20,10,85,7,4,1,51,2,39,5
8474000,2011,0.85,0.82,2,1,20,14,25,59,5,2,0,18,0,19,3
8474001,2011,9.89,9.49,2,4,113,39,46,198,15,9,3,104,75,110,47
8474009,2011,5.8,5.74,6,7,63,25,16,104,18,5,6,58,195,18,28
8474013,2011,1.17,1.15,0,5,18,16,19,53,6,1,3,17,0,16,5
8474024,2011,2.76,2.69,2,1,37,11,20,68,6,3,2,34,121,28,14
8474025,2011,2.36,2.32,1,1,20,11,10,41,2,0,2,20,0,42,5
8474027,2011,4.16,4.05,5,4,113,56,77,246,11,2,8,111,0,46,16
8474029,2011,0.07,0.07,0,1,1,3,1,5,1,0,0,1,0,1,0
8474030,2011,2.42,2.44,1,3,37,14,19,70,5,1,3,36,0,28,9
8474031,2011,9.55,9.29,17,17,178,66,97,341,43,9,12,169,1,72,40
8474034,2011,0.07,0.07,0,0,1,0,1,2,0,0,0,1,0,4,1
8474035,2011,0.02,0.02,0,0,2,0,1,3,0,0,0,2,0,1,0
8474037,2011,12.9,12.18,10,3,121,36,46,203,24,11,11,110,2,37,17
8474038,2011,2.07,2.12,1,1,13,3,5,21,5,3,0,10,8,26,8
8474040,2011,17.32,16.16,19,10,149,81,62,292,47,18,13,131,334,21,27
8474042,2011,0.46,0.42,0,0,7,2,4,13,1,1,0,6,25,15,3
8474045,2011,1.4,1.38,2,0,13,6,8,27,2,0,0,13,15,13,6
8474046,2011,0,0,1,0,0,0,1,1,1,0,0,0,0,5,0
8474048,2011,0.71,0.63,0,3,18,10,11,39,3,0,0,18,0,78,4
8474049,2011,0.33,0.34,0,1,3,0,1,4,3,2,0,1,0,6,0
8474050,2011,0.34,0.34,0,2,6,2,1,9,2,0,0,6,0,3,2
8474053,2011,25.92,24.6,24,10,245,83,98,426,65,31,21,214,468,42,61
8474056,2011,10.25,9.07,15,14,205,82,113,400,36,7,15,198,0,105,26
8474059,2011,2.31,2.29,0,0,24,12,11,47,3,3,0,21,2,7,4
8474062,2011,0.29,0.29,1,0,2,4,0,6,1,0,0,2,11,1,7
8474068,2011,12.69,12.58,12,5,142,35,62,239,29,12,14,130,338,23,21
8474074,2011,0.17,0.17,0,0,3,1,1,5,0,0,0,3,0,1,0
8474077,2011,0.82,0.86,1,1,8,6,5,19,3,1,0,7,5,19,2
8474089,2011,0.64,0.62,2,0,6,4,2,12,2,0,0,6,1,13,7
8474090,2011,1.66,1.53,4,2,13,8,10,31,7,1,0,12,0,17,5
8474091,2011,15.39,14.83,12,3,169,59,59,287,31,16,19,153,646,53,60
8474094,2011,9.87,9.82,8,5,96,19,22,137,28,15,8,81,11,41,21
8474095,2011,1.95,1.92,3,2,23,10,8,41,5,0,1,23,0,20,11
8474096,2011,10.44,10.3,5,7,107,32,25,164,22,10,3,97,448,43,45
8474100,2011,4.53,4.54,5,4,42,17,9,68,14,5,4,37,2,37,6
8474102,2011,15.96,15.18,12,9,114,56,36,206,42,21,9,93,2,32,29
8474113,2011,1.05,1.05,0,0,14,11,11,36,1,1,1,13,0,20,1
8474121,2011,5.22,5.16,3,3,48,23,24,95,8,2,2,46,7,161,31
8474125,2011,4.63,4.21,4,11,89,35,75,199,19,4,5,85,0,114,34
8474128,2011,0.07,0.06,0,0,1,0,1,2,0,0,0,1,0,0,2
8474130,2011,4.27,4.16,2,3,32,9,9,50,8,3,2,29,0,47,6
8474134,2011,4.87,4.77,7,7,88,33,77,198,18,4,5,84,0,49,18
8474137,2011,6.73,6.47,4,3,70,19,35,124,13,6,10,64,0,54,10
8474138,2011,3.75,3.65,1,1,33,12,16,61,6,4,1,29,109,19,6
8474139,2011,1.07,1.05,2,1,14,5,3,22,4,1,0,13,113,17,14
8474141,2011,23.8,23.21,29,14,253,89,105,447,66,23,7,230,240,19,77
8474143,2011,0,0,0,0,0,0,0,0,0,0,0,0,0,0,0
8474145,2011,0.09,0.09,0,0,3,2,2,7,0,0,0,3,0,9,0
8474146,2011,0.97,0.97,4,3,12,4,8,24,9,2,0,10,1,24,4
8474149,2011,2.56,2.5,1,0,21,7,1,29,3,2,0,19,0,13,6
8474150,2011,7.42,7.27,3,4,85,28,26,139,11,4,3,81,225,25,29
8474151,2011,6.79,6.7,15,10,123,56,60,239,32,7,12,116,1,118,46
8474153,2011,3.5,3.33,2,1,35,9,3,47,5,2,5,33,3,24,8
8474157,2011,27.21,26.35,18,14,286,99,83,468,65,33,16,253,1,104,33
8474161,2011,19.8,18.15,20,11,190,62,96,348,49,18,16,172,7,44,35
8474163,2011,0.44,0.43,0,0,6,1,4,11,0,0,0,6,0,8,2
8474164,2011,1.04,1.01,1,3,25,11,22,58,7,3,1,22,0,17,8
8474166,2011,5.16,4.88,5,1,78,29,59,166,12,6,9,72,0,51,1
8474168,2011,0.04,0.04,0,0,3,0,0,3,0,0,0,3,5,5,0
8474176,2011,12.39,11.85,13,11,131,40,45,216,38,14,10,117,1,78,31
8474184,2011,1.18,1.12,1,4,45,22,37,104,5,0,1,45,0,80,1
8474189,2011,13.67,13.35,10,2,129,53,78,260,28,16,5,113,319,72,42
8474190,2011,29.45,27.96,14,7,197,60,61,318,49,28,26,169,7,140,30
8474192,2011,8.65,8.45,7,0,92,47,42,181,15,8,1,84,2,81,22
8474195,2011,0.84,0.83,1,0,9,1,0,10,2,1,1,8,0,11,2
8474201,2011,0.67,0.6,0,2,5,7,5,17,2,0,1,5,3,36,4
8474218,2011,2.99,2.94,1,8,73,33,51,157,13,4,11,69,0,60,11
8474220,2011,2.24,2.16,2,1,31,12,12,55,5,2,5,29,0,10,6
8474230,2011,0.98,0.93,0,0,13,1,7,21,0,0,0,13,1,31,2
8474250,2011,13.35,13.02,5,7,134,73,69,276,26,14,8,120,484,168,50
8474291,2011,5,4.88,0,1,49,16,13,78,5,4,1,45,124,66,10
8474383,2011,0,0,0,0,0,0,0,0,0,0,0,0,0,2,0
8474498,2011,4.51,4.17,4,2,52,19,20,91,8,2,3,50,126,51,13
8474500,2011,0.28,0.27,0,0,2,1,2,5,0,0,0,2,0,3,1
8474518,2011,0.26,0.24,0,0,11,2,9,22,2,2,0,9,0,5,1
8474519,2011,2.7,2.57,2,2,51,23,40,114,6,2,5,49,0,42,2
8474520,2011,10.91,10.31,8,9,168,78,104,350,33,16,9,152,1,127,20
8474535,2011,0.26,0.28,0,0,4,2,0,6,0,0,0,4,15,1,1
8474551,2011,9.03,8.92,8,9,78,42,45,165,25,8,4,70,95,41,30
8474552,2011,0.34,0.34,0,1,6,1,4,11,1,0,0,6,0,4,3
8474563,2011,10.32,9.98,15,11,168,79,109,356,36,10,15,158,0,124,26
8474564,2011,35.62,34.48,25,12,303,109,128,540,97,60,22,243,558,109,42
8474565,2011,14.23,13.94,21,18,202,114,144,460,51,12,17,190,0,90,47
8474566,2011,0.45,0.43,0,1,6,5,4,15,1,0,0,6,0,8,1
8474567,2011,6.96,6.72,11,14,150,89,110,349,30,5,12,145,0,117,17
8474568,2011,3.65,3.63,8,12,81,45,63,189,22,2,5,79,0,270,28
8474569,2011,12.46,12.31,10,9,109,35,36,180,33,14,9,95,36,42,29
8474570,2011,12.05,12.04,15,7,154,49,56,259,41,19,6,135,329,37,34
8474571,2011,11.18,11.06,9,4,86,41,47,174,24,11,7,75,1,108,29
8474573,2011,14.74,14.34,11,8,104,30,43,177,32,13,10,91,323,64,62
8474574,2011,5.63,5.29,10,5,84,47,59,190,23,8,6,76,0,78,26
8474575,2011,0.59,0.59,1,0,13,5,15,33,1,0,2,13,0,68,1
8474576,2011,0.76,0.71,1,1,10,3,7,20,2,0,0,10,2,16,2
8474577,2011,0.47,0.48,1,3,7,1,0,8,5,1,0,6,28,20,4
8474578,2011,14.46,13.54,36,23,261,111,222,594,78,19,23,242,0,60,67
8474579,2011,3.9,3.82,7,12,88,48,75,211,24,5,7,83,0,186,22
8474581,2011,4.65,4.62,13,10,79,55,73,207,30,7,7,72,0,52,34
8474582,2011,3.8,3.74,4,1,46,7,19,72,6,1,4,45,1,25,11
8474584,2011,5.22,5.05,15,16,113,42,77,232,41,10,6,103,0,156,28
8474585,2011,0,0,0,0,0,0,2,2,0,0,0,0,0,2,0
8474586,2011,17.73,17.35,27,15,180,60,74,314,76,34,11,146,12,45,40
8474587,2011,0.52,0.51,0,0,2,5,0,7,0,0,1,2,19,3,0
8474589,2011,8.11,8.11,11,8,82,29,44,155,34,15,4,67,145,26,19
8474590,2011,8.61,8.26,9,14,152,63,88,303,32,9,5,143,0,83,31
8474594,2011,6.32,6.21,8,4,86,51,79,216,20,8,7,78,0,74,11
8474597,2011,0,0,0,0,0,0,0,0,0,0,0,0,0,1,0
8474600,2011,3.7,3.43,5,6,64,28,39,131,16,5,7,59,0,33,16
8474604,2011,0.73,0.73,0,0,6,7,5,18,0,0,0,6,0,2,2
8474606,2011,0.02,0.02,0,0,1,0,3,4,0,0,0,1,0,1,1
8474607,2011,0,0,0,0,0,0,1,1,0,0,0,0,0,0,0
8474609,2011,9.09,8.75,4,6,89,45,33,167,20,10,13,79,114,26,24
8474610,2011,2.19,2.04,2,0,20,10,6,36,3,1,1,19,5,16,5
8474612,2011,4.84,4.74,6,16,124,65,105,294,24,2,9,122,0,170,37
8474613,2011,16.11,16.02,22,12,169,53,69,291,51,17,6,152,386,137,51
8474616,2011,0.59,0.56,0,0,8,1,4,13,0,0,1,8,22,12,0
8474618,2011,3.35,3.29,2,7,77,36,63,176,12,3,3,74,0,46,24
8474625,2011,3.98,3.81,2,2,41,12,8,61,9,5,2,36,5,50,11
8474628,2011,0.68,0.56,2,0,13,7,5,25,3,1,2,12,0,16,1
8474631,2011,2.4,2.41,0,3,45,23,36,104,7,4,3,41,0,73,7
8474634,2011,1.11,1.12,1,2,14,5,4,23,4,1,1,13,1,23,10
8474641,2011,14.59,14.25,18,17,130,34,25,189,51,16,7,114,501,83,49
8474642,2011,3.44,3.41,2,0,26,15,7,48,3,1,2,25,11,45,8
8474646,2011,2.95,2.79,1,3,26,6,4,36,4,0,2,26,23,21,2
8474649,2011,0.03,0.03,0,0,2,0,3,5,0,0,0,2,0,3,1
8474659,2011,0.44,0.44,0,0,6,3,1,10,0,0,0,6,0,3,0
8474666,2011,4.21,4.24,1,3,40,10,17,67,8,4,1,36,6,32,9
8474668,2011,4.1,4.22,3,1,48,15,19,82,8,4,0,44,0,118,14
8474670,2011,0,0,0,0,0,0,0,0,0,0,0,0,0,0,0
8474673,2011,1.75,1.76,3,9,44,17,34,95,14,2,5,42,0,43,25
8474679,2011,2.01,1.99,4,2,19,9,6,34,7,1,2,18,0,4,9
8474681,2011,4.54,4.45,4,0,60,17,35,112,7,3,4,57,64,7,14
8474685,2011,0.51,0.49,0,3,4,3,5,12,3,0,0,4,0,8,3
8474691,2011,0,0,0,1,0,0,0,0,1,0,0,0,0,2,0
8474693,2011,0.76,0.74,0,1,8,4,3,15,2,1,0,7,0,6,0
8474697,2011,0.01,0.01,0,0,1,0,1,2,0,0,0,1,0,4,0
8474705,2011,2.52,2.48,2,1,26,5,9,40,7,4,0,22,33,43,4
8474707,2011,3,2.96,3,5,69,32,64,165,11,3,6,66,0,89,10
8474709,2011,13.47,13.11,6,2,135,48,36,219,16,8,12,127,11,374,36
8474715,2011,7,6.88,6,1,66,20,22,108,14,7,5,59,0,23,15
8474716,2011,4.38,4.21,10,10,92,44,56,192,23,3,6,89,0,36,18
8474719,2011,1.75,1.46,2,1,24,5,7,36,5,2,1,22,4,36,4
8474727,2011,2.13,2.07,0,0,18,2,4,24,2,2,3,16,7,6,3
8474736,2011,3.56,3.42,5,2,54,17,23,94,9,2,2,52,6,175,4
8474739,2011,7.24,6.96,3,3,71,29,25,125,9,3,4,68,7,102,14
8474749,2011,0.01,0.01,0,0,0,1,0,1,0,0,0,0,0,5,0
8474772,2011,0.9,0.86,6,3,22,19,14,55,9,0,2,22,1,68,5
8474774,2011,0.04,0.04,0,0,2,1,1,4,0,0,0,2,0,5,1
8474818,2011,0.04,0.04,0,2,1,1,1,3,2,0,0,1,0,3,0
8474884,2011,0.09,0.1,0,0,0,2,0,2,0,0,0,0,0,2,0
8474892,2011,3.36,3.33,2,2,36,16,8,60,9,5,3,31,18,16,13
8475060,2011,0.98,0.95,3,3,33,8,22,63,7,1,1,32,0,18,6
8475098,2011,19.3,18.09,17,12,109,54,37,200,47,18,9,91,631,117,40
8475102,2011,0.11,0.11,0,0,3,0,0,3,1,1,0,2,5,7,0
8475104,2011,0.06,0.06,0,0,3,0,1,4,0,0,0,3,0,3,0
8475118,2011,3.07,3.02,7,10,80,26,55,161,20,3,4,77,0,59,18
8475148,2011,0.41,0.39,1,1,9,5,4,18,2,0,0,9,0,15,1
8475149,2011,9.74,9.55,20,12,90,36,52,178,46,14,4,76,307,61,39
8475150,2011,4.08,4.17,5,3,57,12,18,87,15,7,5,50,1,64,6
8475151,2011,3.3,3.26,2,1,34,18,18,70,7,4,1,30,2,20,1
8475153,2011,0.42,0.41,0,1,16,7,13,36,1,0,0,16,0,43,6
8475154,2011,1.67,1.62,0,0,22,3,7,32,0,0,0,22,1,32,4
8475155,2011,1.24,1.24,1,2,22,11,11,44,4,1,0,21,0,19,5
8475158,2011,17.23,16.56,21,16,189,49,64,302,55,18,16,171,762,62,101
8475159,2011,0.71,0.68,0,0,7,2,1,10,0,0,0,7,0,1,1
8475160,2011,7.78,7.59,5,2,88,34,24,146,12,5,3,83,1,179,8
8475162,2011,0.05,0.05,0,0,2,0,1,3,0,0,0,2,0,2,0
8475165,2011,4.2,4.08,0,4,54,14,16,84,6,2,1,52,149,32,15
8475166,2011,37.66,36.18,36,14,286,80,98,464,81,31,28,255,813,27,99
8475167,2011,4.96,4.78,9,9,82,42,68,192,23,5,4,77,0,96,33
8475168,2011,14.41,13.39,7,7,132,49,68,249,28,14,14,118,200,43,31
8475169,2011,30.99,29.81,16,11,287,98,76,461,57,30,18,257,15,173,35
8475170,2011,10.53,10.08,3,3,97,33,43,173,18,12,9,85,201,136,11
8475171,2011,8.52,8.08,8,11,147,75,112,334,32,13,9,134,0,140,30
8475172,2011,3.51,3.5,2,0,28,8,22,58,7,5,1,23,4,25,8
8475173,2011,0,0,0,0,0,0,1,1,0,0,0,0,0,2,0
8475174,2011,2.34,2.3,3,9,58,21,60,139,17,5,2,53,0,217,28
8475175,2011,5.88,5.67,2,4,79,22,28,129,8,2,5,77,2,18,12
8475176,2011,1.62,1.6,5,3,34,15,28,77,11,3,3,31,0,30,7
8475177,2011,0.06,0.05,0,0,2,1,0,3,0,0,0,2,0,2,0
8475178,2011,4.06,4,5,1,54,20,26,100,10,4,0,50,11,79,10
8475179,2011,4.78,4.74,13,11,104,61,78,243,28,4,6,100,0,104,25
8475180,2011,0.24,0.23,0,0,1,2,0,3,1,1,0,0,7,4,0
8475181,2011,3.64,3.54,14,20,94,35,72,201,37,3,4,91,0,67,30
8475182,2011,1.77,1.67,3,3,34,15,38,87,7,1,1,33,0,34,6
8475183,2011,3.56,3.59,3,2,58,21,18,97,10,5,2,53,28,68,15
8475185,2011,4.05,3.76,4,3,37,13,9,59,9,2,1,35,181,16,13
8475186,2011,2.22,2.13,2,3,64,28,46,138,7,2,7,62,0,47,4
8475188,2011,1.05,1.01,2,5,23,10,19,52,8,1,0,22,0,49,16
8475191,2011,0.09,0.1,0,0,2,0,2,4,0,0,0,2,1,0,0
8475197,2011,0.66,0.62,0,0,15,6,11,32,0,0,1,15,0,9,4
8475200,2011,3.13,3.01,7,9,51,27,34,112,19,3,5,48,0,99,23
8475204,2011,0.27,0.26,0,2,5,2,5,12,2,0,0,5,26,5,5
8475206,2011,2.45,2.38,4,5,84,20,68,172,13,4,5,80,0,3,7
8475214,2011,0.34,0.34,0,0,2,1,0,3,0,0,0,2,0,4,0
8475218,2011,0.02,0.02,0,0,1,1,2,4,0,0,0,1,0,0,0
8475219,2011,0,0,0,0,0,0,0,0,0,0,0,0,0,0,0
8475220,2011,3.22,3.16,1,6,23,13,7,43,13,6,1,17,0,44,7
8475225,2011,16.76,16.5,13,9,172,74,62,308,36,14,9,158,173,44,32
8475231,2011,1.3,1.28,3,1,12,3,9,24,4,0,1,12,47,26,1
8475233,2011,1.29,1.21,2,6,34,10,26,70,10,2,3,32,0,30,5
8475236,2011,2.26,2.13,1,3,31,7,13,51,8,4,2,27,21,15,6
8475248,2011,0.19,0.19,0,0,3,2,0,5,1,1,0,2,0,5,0
8475254,2011,0.06,0.05,0,0,1,0,0,1,0,0,0,1,3,7,1
8475264,2011,4.8,4.67,5,3,53,17,18,88,11,3,2,50,183,28,14
8475266,2011,6.29,5.99,4,2,65,29,29,123,10,4,3,61,1,52,19
8475268,2011,5.16,5,5,7,59,13,22,94,19,7,4,52,0,66,20
8475283,2011,0.26,0.24,0,0,6,0,0,6,0,0,0,6,0,10,1
8475323,2011,9.09,8.92,9,8,89,23,19,131,26,9,6,80,284,26,25
8475325,2011,2.03,2.04,2,0,19,10,3,32,4,2,1,17,1,59,3
8475372,2011,0.37,0.36,0,0,3,5,3,11,0,0,0,3,24,9,0
8475430,2011,0.35,0.33,0,0,6,0,1,7,0,0,1,6,0,6,2
8475455,2011,0.2,0.19,0,0,6,0,0,6,0,0,0,6,0,4,0
8475602,2011,2.17,2.19,2,3,25,12,10,47,7,2,0,23,6,6,5
8475603,2011,0.07,0.07,0,0,3,1,0,4,0,0,0,3,15,8,0
8475613,2011,2.08,1.99,5,6,32,17,30,79,12,1,2,31,0,34,12
8475619,2011,1.22,1.28,0,0,17,6,12,35,1,1,1,16,4,61,1
8475637,2011,7.6,7.33,4,6,86,36,39,161,16,6,1,80,3,34,26
8475640,2011,0.78,0.77,3,1,18,15,25,58,5,1,2,17,0,9,6
8475650,2011,0.68,0.67,0,0,16,3,7,26,0,0,0,16,0,27,0
8475671,2011,0.05,0.04,0,0,1,0,0,1,0,0,0,1,0,0,0
8475679,2011,0.88,0.87,0,0,14,2,3,19,1,1,1,13,1,3,4
8475690,2011,0.41,0.39,1,1,15,6,19,40,2,0,1,15,0,10,5
8475692,2011,1.48,1.3,0,1,10,5,4,19,3,2,0,8,0,8,2
8475722,2011,0.59,0.55,2,0,10,2,4,16,2,0,2,10,0,5,2
8475753,2011,6.97,6.7,5,9,101,49,70,220,22,8,11,93,0,113,32
8475757,2011,0.43,0.42,0,3,7,3,3,13,3,0,1,7,0,17,0
8475758,2011,5.62,5.48,3,3,66,29,23,118,13,7,5,59,6,104,5
8475764,2011,4.68,4.47,11,13,123,47,97,267,29,5,5,118,1,43,23
8475768,2011,1.87,1.86,0,1,6,1,2,9,3,2,1,4,1,1,1
8475772,2011,0.12,0.11,0,0,3,0,0,3,0,0,0,3,0,1,0
8475784,2011,22.29,21.95,17,7,210,77,85,372,44,20,18,190,67,44,46
8475788,2011,13.7,13.5,7,8,123,57,51,231,28,13,6,110,248,118,42
8475790,2011,2.36,2.31,4,2,76,39,51,166,8,2,6,74,0,154,3
8475791,2011,21.62,21.02,15,11,207,69,83,359,53,27,12,180,23,44,35
8475792,2011,9.37,9.04,4,7,94,35,27,156,15,4,7,90,20,58,9
8475793,2011,8.46,8.15,9,3,99,31,40,170,21,9,8,90,97,68,20
8475794,2011,25.15,24.66,21,17,242,89,98,429,67,29,14,213,46,26,30
8475799,2011,7.4,7.01,0,0,74,25,21,120,1,1,5,73,0,129,21
8476116,2011,2.23,2.08,1,0,28,14,11,53,3,2,1,26,12,48,1
8476158,2011,4.33,4.37,2,1,49,18,14,81,6,3,5,46,12,67,4
8476177,2011,19.12,18.68,9,14,155,74,54,283,47,24,13,131,142,82,36
8476205,2011,2.46,2.35,2,0,31,17,15,63,5,3,1,28,65,14,8
8476206,2011,0.43,0.39,0,0,4,1,2,7,0,0,1,4,7,11,0
8476211,2011,0.44,0.48,0,0,1,0,0,1,1,1,0,0,6,1,0
8476224,2011,0.02,0.02,0,1,1,0,0,1,1,0,0,1,0,0,2
8476225,2011,0.01,0.01,0,0,1,0,0,1,0,0,0,1,0,2,1
8476244,2011,2.07,2,3,10,61,34,72,167,16,3,5,58,1,40,13
8476381,2011,9,8.65,8,3,74,25,31,130,23,12,8,62,41,82,16
8476438,2011,0.04,0.04,0,0,3,1,0,4,0,0,0,3,0,0,2
8476454,2011,17.24,16.52,19,15,134,52,63,249,52,18,12,116,227,38,34
8476455,2011,25.79,23.59,15,15,270,66,70,406,52,22,31,248,8,219,58
8476457,2011,2.31,2.26,8,8,68,25,60,153,18,2,4,66,0,94,12
8476459,2011,1.52,1.28,0,1,12,7,6,25,1,0,1,12,22,15,4
8476460,2011,1.21,1.2,0,0,5,3,4,12,1,1,0,4,18,3,0
8476461,2011,11.26,10.69,8,6,116,31,42,189,27,13,7,103,378,82,48
8476466,2011,0.98,1,0,0,10,1,3,14,3,3,1,7,0,5,3
8476792,2011,0.12,0.12,0,1,3,3,1,7,1,0,0,3,0,0,0
8476806,2011,0.81,0.79,0,1,13,1,10,24,1,0,1,13,0,2,1
8476819,2011,0.27,0.26,0,0,2,0,1,3,0,0,0,2,4,3,0
8446485,2010,4.79,4.66,1,4,57,18,14,89,11,6,0,51,95,45,16
8449645,2010,6.11,5.66,5,6,79,30,30,139,15,4,5,75,133,7,14
8450725,2010,15.99,15.61,16,18,132,33,46,211,48,14,8,118,52,81,16
8455919,2010,0.97,0.97,0,0,11,5,4,20,2,2,1,9,101,21,4
8456283,2010,0.95,0.88,3,5,23,6,12,41,8,0,3,23,0,55,4
8457063,2010,11.04,10.5,18,28,175,89,93,357,62,16,9,159,0,49,33
8457981,2010,22.64,21.86,30,19,213,64,45,322,80,31,12,182,97,15,37
8458361,2010,2.04,1.93,4,3,26,15,13,54,9,2,1,24,57,9,9
8458520,2010,0.13,0.14,0,0,3,2,2,7,0,0,0,3,0,3,1
8458525,2010,12.61,12.15,11,9,168,61,62,291,34,14,10,154,52,67,27
8458529,2010,16.66,16.16,12,6,151,61,92,304,34,16,10,135,3,14,38
8458537,2010,16.36,15.76,27,13,156,66,61,283,57,17,16,139,45,29,27
8458541,2010,1.08,1.06,4,3,23,11,21,55,10,3,1,20,1,42,11
8458543,2010,0.59,0.59,3,5,22,12,21,55,8,0,2,22,0,38,7
8458590,2010,25.55,24.59,10,6,203,68,41,312,40,24,16,179,10,74,45
8458637,2010,1.02,1,4,13,34,20,38,92,18,1,1,33,0,53,15
8458938,2010,6.18,5.96,13,16,129,60,87,276,34,5,14,124,0,66,31
8458943,2010,12.6,12.06,18,9,116,51,51,218,39,12,7,104,17,64,31
8458951,2010,7.01,6.57,9,11,107,56,97,260,27,7,8,100,0,54,22
8459004,2010,1.35,1.36,1,1,33,14,27,74,4,2,3,31,0,31,5
8459053,2010,3.36,3.29,11,8,99,53,81,233,22,3,14,96,1,134,26
8459424,2010,5.3,5.1,10,11,112,41,89,242,25,4,11,108,0,41,19
8459427,2010,6.31,6.25,8,6,80,18,23,121,19,5,5,75,129,37,14
8459429,2010,14.33,14.02,10,4,169,56,63,288,31,17,7,152,449,42,30
8459442,2010,11.35,11.18,18,12,104,31,54,189,45,15,6,89,707,48,29
8459444,2010,14.55,14.12,14,15,138,57,44,239,45,16,5,122,18,110,30
8459457,2010,14.65,14.09,13,10,153,62,57,272,32,9,9,144,11,96,28
8459461,2010,9.85,9.35,17,17,89,27,33,149,43,9,4,80,378,22,43
8459462,2010,5.64,5.36,12,9,122,30,98,250,28,7,13,115,0,86,8
8459492,2010,5.29,4.87,6,8,61,12,17,90,23,9,5,52,69,44,5
8459514,2010,5.02,5.01,6,5,62,27,18,107,14,3,5,59,53,105,24
8459587,2010,5.32,5.15,5,2,63,28,23,114,8,1,4,62,263,114,22
8459596,2010,19,17.63,19,9,117,24,13,154,46,18,9,99,7,27,18
8459628,2010,1.72,1.69,1,6,62,29,44,135,9,2,2,60,0,75,21
8459640,2010,9.23,9.08,5,6,107,33,25,165,16,5,2,102,10,112,26
8459670,2010,8.76,8.47,15,16,147,69,74,290,37,6,6,141,0,96,43
8459687,2010,4.04,3.99,2,1,61,14,11,86,7,4,6,57,288,114,17
8460492,2010,2.68,2.71,3,6,73,20,59,152,14,5,1,68,0,87,9
8460496,2010,23.35,22.73,9,15,195,76,36,307,47,23,9,172,57,25,33
8460502,2010,0.29,0.28,0,0,4,1,0,5,0,0,0,4,0,20,0
8460503,2010,1.09,1.07,0,5,39,20,43,102,5,0,0,39,0,135,17
8460504,2010,3.86,3.63,2,3,56,18,25,99,6,1,4,55,5,73,7
8460527,2010,2.03,2.03,0,5,25,5,6,36,6,1,1,24,197,31,6
8460533,2010,0.46,0.43,1,0,6,3,0,9,1,0,0,6,12,7,0
8460542,2010,20.25,19.81,21,20,204,58,87,349,62,21,9,183,224,62,45
8460555,2010,0.52,0.51,0,2,9,13,14,36,2,0,0,9,0,43,8
8460556,2010,4.45,4.39,2,1,54,17,16,87,10,7,4,47,8,19,14
8460562,2010,3.09,3.05,2,2,26,17,12,55,5,1,7,25,127,19,9
8460567,2010,7.72,7.64,6,4,83,27,27,137,15,5,12,78,3,89,18
8460577,2010,17.43,16.57,18,16,170,42,42,254,56,22,15,148,2,9,38
8460580,2010,0.04,0.04,0,0,3,1,2,6,0,0,0,3,0,5,1
8460621,2010,12.95,12.31,9,8,96,40,51,187,31,14,7,82,2,41,45
8460661,2010,0.08,0.08,0,0,3,2,4,9,0,0,0,3,0,2,0
8460719,2010,9.69,9.54,4,8,79,27,27,133,22,10,5,69,5,18,16
8460720,2010,4.2,4.16,4,0,51,17,19,87,10,6,0,45,0,93,11
8460743,2010,16.88,16,11,8,125,49,26,200,37,18,13,107,1,81,18
8462036,2010,0.3,0.3,0,1,6,3,4,13,1,0,0,6,23,4,5
8462038,2010,22.05,20.98,26,14,221,91,90,402,60,20,12,201,73,172,41
8462041,2010,9.21,9.09,9,6,109,30,28,167,22,7,6,102,7,51,35
8462042,2010,31.71,30.48,26,17,289,102,127,518,86,43,22,246,227,103,40
8462077,2010,17.12,16.33,13,4,172,67,38,277,29,12,14,160,314,32,33
8462093,2010,1.3,1.3,1,0,10,4,8,22,2,1,0,9,13,18,8
8462118,2010,3.24,3.11,4,4,50,16,17,83,10,2,0,48,167,5,3
8462129,2010,10.37,9.87,10,8,94,49,32,175,30,12,3,82,678,86,24
8462176,2010,1.65,1.58,4,1,44,18,40,102,7,2,5,42,0,36,25
8462196,2010,6.46,5.36,10,15,106,60,89,255,30,5,6,101,0,216,28
8462225,2010,3.96,3.85,5,9,76,40,60,176,16,2,5,74,0,23,22
8462535,2010,1.7,1.68,0,2,31,14,7,52,4,2,0,29,2,96,5
8464956,2010,2.87,2.79,3,5,81,44,45,170,9,1,5,80,0,116,26
8464957,2010,7.74,7.71,3,6,89,25,34,148,19,10,4,79,1,45,35
8464962,2010,3.22,2.83,2,6,75,39,47,161,10,2,2,73,0,117,19
8464966,2010,3.15,3.04,8,3,83,49,54,186,16,5,3,78,2,117,14
8464967,2010,14.32,13.86,11,7,124,55,53,232,32,14,8,110,700,71,52
8464975,2010,26.39,25.47,19,15,246,61,79,386,68,34,19,212,395,36,33
8464977,2010,12.74,12.32,10,7,115,44,31,190,30,13,5,102,253,107,33
8464979,2010,5.72,5.63,6,5,57,26,15,98,16,5,4,52,6,23,12
8464981,2010,2.68,2.64,4,9,75,38,49,162,17,4,5,71,0,175,15
8464984,2010,0.68,0.67,0,0,10,7,3,20,0,0,1,10,3,11,3
8464989,2010,14.68,14.25,17,10,150,58,79,287,39,12,12,138,473,39,43
8464994,2010,0.09,0.09,0,0,2,1,0,3,0,0,0,2,0,5,1
8465005,2010,1.08,1.06,2,4,50,16,30,96,6,0,1,50,0,109,21
8465009,2010,11,10.76,12,18,264,99,148,511,44,14,19,250,0,153,32
8465012,2010,0.89,0.82,4,1,20,5,15,40,7,2,0,18,0,7,3
8465024,2010,4.62,4.46,2,1,38,11,13,62,4,1,2,37,5,53,13
8465025,2010,3.88,3.76,4,2,60,6,15,81,11,5,3,55,3,107,7
8465026,2010,0.02,0.02,0,0,0,1,1,2,0,0,0,0,0,2,0
8465042,2010,3.12,3.06,13,9,99,49,47,195,25,3,4,96,0,141,11
8465050,2010,15.18,14.62,14,13,127,69,52,248,40,13,5,114,717,71,45
8465058,2010,3.1,3.04,7,8,55,32,49,136,21,6,5,49,0,100,24
8465059,2010,5.13,5.12,1,6,58,20,25,103,11,4,3,54,4,161,12
8465113,2010,0,0,0,1,0,0,0,0,1,0,0,0,0,0,0
8465122,2010,6.22,5.94,9,13,87,52,70,209,31,9,5,78,0,117,20
8465166,2010,6.81,6.52,5,6,90,21,27,138,15,4,2,86,194,171,24
8465170,2010,4.98,4.97,6,3,72,18,33,123,16,7,2,65,34,69,32
8465185,2010,2.31,2.27,1,4,59,35,58,152,10,5,7,54,0,35,12
8465192,2010,8.34,8.05,8,5,108,33,40,181,20,7,3,101,675,162,28
8465200,2010,6.95,6.48,21,22,130,63,104,297,47,4,9,126,0,37,29
8465202,2010,2.2,2.14,2,2,39,19,23,81,7,3,0,36,0,6,3
8465210,2010,3.17,3.08,8,11,78,42,76,196,23,4,6,74,0,90,19
8465914,2010,1.69,1.67,6,3,47,17,44,108,10,1,1,46,0,133,13
8465951,2010,11.64,11.49,8,10,95,40,31,166,30,12,5,83,8,192,23
8465978,2010,9.71,9.63,7,3,151,43,44,238,20,10,4,141,17,141,23
8466035,2010,15.55,14.86,20,7,123,45,42,210,40,13,6,110,3,56,43
8466138,2010,18.3,17.83,33,16,149,52,60,261,70,21,8,128,675,56,114
8466139,2010,28.67,27.55,17,19,279,86,105,470,73,37,19,242,288,86,35
8466140,2010,19.44,18.92,17,20,208,79,82,369,54,17,8,191,552,56,54
8466142,2010,4.78,4.66,3,4,110,45,59,214,16,9,2,101,0,145,23
8466144,2010,1.89,1.87,1,4,50,25,20,95,6,1,2,49,0,88,4
8466145,2010,1.61,1.54,3,4,43,16,36,95,8,1,3,42,0,61,15
8466148,2010,23.59,22.8,15,17,205,49,64,318,57,25,14,180,3,48,53
8466149,2010,22.27,21.62,15,5,192,73,47,312,46,26,8,166,35,112,18
8466158,2010,3.1,2.96,5,5,56,19,34,109,11,1,7,55,0,84,19
8466160,2010,30.54,29.27,14,9,209,95,58,362,56,33,14,176,1,225,41
8466181,2010,9.06,8.7,5,4,94,45,37,176,23,14,5,80,0,4,19
8466182,2010,4.05,3.94,5,6,102,42,58,202,16,5,4,97,0,67,26
8466212,2010,0.54,0.53,0,0,6,4,2,12,0,0,1,6,1,36,1
8466215,2010,8.36,7.97,18,11,191,69,128,388,40,11,16,180,0,55,60
8466216,2010,5.18,4.98,2,1,58,19,13,90,4,1,4,57,57,63,13
8466251,2010,13.94,13.69,9,7,162,53,41,256,26,10,9,152,20,98,26
8466285,2010,4.06,4.01,10,12,84,47,65,196,27,5,7,79,0,28,21
8466309,2010,0.93,0.9,0,3,21,7,20,48,3,0,1,21,0,17,4
8466333,2010,2.92,2.87,2,10,78,34,67,179,15,3,4,75,0,74,4
8466371,2010,8.76,8.61,7,6,107,33,45,185,25,12,6,95,504,43,44
8466378,2010,27.39,26.57,47,21,254,95,101,450,99,31,14,223,50,37,55
8466392,2010,1.19,1.09,1,0,11,4,4,19,2,1,1,10,30,1,3
8466393,2010,14,13.94,13,7,171,60,55,286,37,17,10,154,6,117,33
8466398,2010,9.11,8.68,6,4,79,34,37,150,18,8,6,71,18,122,28
8467096,2010,11.08,10.77,17,24,199,90,130,419,50,9,19,190,0,55,34
8467304,2010,0.95,0.93,2,2,31,12,8,51,4,0,1,31,0,62,5
8467329,2010,21.74,21.23,20,9,210,65,73,348,54,25,17,185,591,93,35
8467330,2010,16.47,16.16,11,13,130,40,45,215,41,17,7,113,395,36,55
8467331,2010,3.42,3.3,8,9,81,33,50,164,20,3,3,78,0,131,13
8467332,2010,2.26,2.19,5,8,58,26,59,143,17,4,5,54,0,118,24
8467334,2010,13.14,12.67,10,9,111,45,40,196,30,11,9,100,778,57,40
8467336,2010,5.24,5.21,6,2,81,29,34,144,17,9,6,72,82,181,9
8467338,2010,15.09,14.05,33,14,120,48,36,204,69,22,7,98,42,31,49
8467344,2010,2.43,2.39,6,9,72,43,59,174,17,2,4,70,0,180,12
8467346,2010,17.98,17.28,12,11,154,61,66,281,40,17,16,137,6,49,23
8467351,2010,14.33,14.09,20,11,157,57,62,276,38,7,5,150,575,32,56
8467353,2010,12.51,12.02,16,9,105,46,32,183,41,16,11,89,260,62,35
8467361,2010,4.59,4.52,3,4,51,13,20,84,12,5,4,46,411,82,18
8467365,2010,1.44,1.4,2,5,58,17,48,123,11,4,2,54,0,166,11
8467370,2010,14.87,14.27,13,4,192,62,61,315,36,19,12,173,602,135,36
8467371,2010,17.73,16.99,35,17,161,66,59,286,71,19,5,142,565,95,72
8467389,2010,18.78,18.06,32,17,272,122,154,548,77,28,17,244,501,20,47
8467393,2010,5.52,5.35,6,3,66,30,26,122,12,3,4,63,8,131,17
8467396,2010,27.63,26.89,15,11,201,74,91,366,52,26,14,175,7,225,65
8467400,2010,5.03,4.79,3,9,106,56,85,247,17,5,3,101,0,122,34
8467407,2010,32.11,30.74,14,3,298,111,112,521,46,29,22,269,19,87,45
8467408,2010,0.17,0.19,0,0,3,0,1,4,0,0,0,3,0,5,0
8467412,2010,7.67,7.72,6,4,94,36,32,162,15,5,5,89,1,139,12
8467423,2010,9.65,8.54,15,3,78,29,34,141,27,9,5,69,393,32,29
8467428,2010,2.65,2.63,0,1,16,5,2,23,3,2,1,14,2,53,3
8467436,2010,0.07,0.07,0,0,2,2,2,6,0,0,0,2,0,5,1
8467439,2010,2.68,2.6,5,10,65,37,69,171,16,1,2,64,0,61,30
8467452,2010,1.7,1.68,8,5,46,29,43,118,15,2,5,44,0,64,22
8467463,2010,16.25,15.54,23,9,215,71,96,382,50,18,9,197,9,76,25
8467466,2010,2.05,1.96,1,2,30,20,18,68,4,1,2,29,0,36,3
8467478,2010,1.78,1.79,4,4,38,13,43,94,10,2,2,36,0,18,10
8467493,2010,11.64,10.99,5,5,105,37,49,191,16,6,11,99,3,258,35
8467496,2010,0.91,0.86,1,1,20,9,8,37,3,1,1,19,0,2,3
8467502,2010,4.15,4.12,1,1,62,24,17,103,6,4,1,58,6,38,7
8467514,2010,15.53,14.8,23,13,137,54,66,257,59,23,11,114,429,54,71
8467519,2010,2.06,2.05,2,3,30,24,33,87,8,3,1,27,0,55,23
8467543,2010,4.05,3.95,3,1,58,17,14,89,6,2,1,56,46,56,22
8467545,2010,16.35,15.72,15,8,165,54,76,295,41,18,8,147,5,70,35
8467579,2010,0.85,0.82,0,0,9,4,4,17,2,2,1,7,0,44,1
8467580,2010,1.24,1.19,2,1,29,16,18,63,3,0,1,29,0,30,9
8467831,2010,5.17,4.79,10,5,62,20,29,111,26,11,5,51,338,42,15
8467844,2010,16.24,16.23,6,10,187,51,48,286,32,16,10,171,1,76,34
8467856,2010,4.81,4.56,18,26,106,37,75,218,48,4,7,102,0,49,12
8467875,2010,32.84,31.96,34,29,266,92,94,452,104,41,15,225,4,13,36
8467876,2010,17.45,16.79,45,30,157,42,58,257,94,19,6,138,721,15,43
8467878,2010,12.96,12.45,13,16,151,48,74,273,42,13,10,138,445,24,22
8467881,2010,13.59,13.38,8,5,126,54,35,215,31,18,8,108,6,143,21
8467890,2010,1.63,1.6,3,10,65,29,57,151,13,0,4,65,0,78,28
8467899,2010,21.13,20.47,28,12,229,74,66,369,62,22,18,207,3,34,43
8467906,2010,0.09,0.08,0,0,1,0,1,2,0,0,0,1,0,3,0
8467910,2010,0.14,0.14,1,0,8,1,5,14,1,0,0,8,0,41,1
8467915,2010,1.6,1.54,2,2,32,14,25,71,6,2,2,30,0,38,5
8467917,2010,5.99,5.78,11,11,134,43,96,273,35,13,7,121,0,49,15
8467925,2010,15.82,15.61,7,4,167,53,28,248,18,7,9,160,360,152,22
8467927,2010,0.12,0.12,0,1,2,4,4,10,1,0,0,2,0,0,0
8467928,2010,0.17,0.16,0,0,8,1,7,16,0,0,0,8,0,2,0
8467931,2010,0.95,0.91,2,4,40,10,21,71,7,1,3,39,0,71,9
8467937,2010,0.48,0.47,0,1,7,1,2,10,1,0,0,7,21,6,4
8467943,2010,14.14,13.47,12,4,140,54,61,255,27,11,12,129,3,35,12
8467964,2010,3.23,3.23,3,2,25,4,10,39,6,1,1,24,15,10,2
8467967,2010,11.7,11.62,8,6,113,45,57,215,28,14,5,99,466,81,40
8467988,2010,16.93,16.04,9,15,150,25,30,205,38,14,15,136,56,125,28
8468001,2010,6.84,6.78,7,7,76,34,34,144,23,9,2,67,246,159,33
8468064,2010,18.26,17.69,19,14,135,40,67,242,50,17,16,118,19,57,35
8468083,2010,24.95,24.13,35,21,306,126,109,541,80,24,11,282,516,38,54
8468085,2010,19.09,18.74,17,12,240,73,67,380,48,19,8,221,2,42,32
8468086,2010,1.59,1.62,0,1,13,4,8,25,2,1,3,12,0,16,1
8468095,2010,2.27,2.25,1,0,33,18,13,64,4,3,2,30,1,97,7
8468101,2010,3.9,3.74,7,6,97,48,65,210,16,3,5,94,0,69,34
8468114,2010,4.25,4.17,4,9,102,47,95,244,14,1,10,101,0,203,21
8468162,2010,7.1,7.06,4,4,73,33,32,138,13,5,7,68,578,162,41
8468172,2010,12.31,11.91,11,4,120,42,52,214,25,10,8,110,12,150,28
8468208,2010,18.9,18.51,8,11,157,40,48,245,29,10,8,147,82,67,51
8468213,2010,2.45,2.38,5,7,57,28,56,141,14,2,3,55,0,122,27
8468224,2010,10.56,10.28,12,9,137,49,41,227,24,3,9,134,15,115,19
8468252,2010,0.04,0.04,3,0,1,1,1,3,3,0,0,1,0,19,0
8468432,2010,3.38,3.22,6,0,31,8,10,49,10,4,5,27,89,20,10
8468434,2010,19.71,19.17,15,15,180,63,37,280,50,20,17,160,207,40,23
8468463,2010,10.27,9.83,11,3,90,35,29,154,26,12,7,78,7,73,15
8468478,2010,1.69,1.6,7,4,53,30,62,145,13,2,7,51,0,98,47
8468482,2010,27.29,26.06,25,13,217,99,88,404,64,26,18,191,9,104,29
8468483,2010,20.2,19.51,15,11,192,65,67,324,48,22,19,170,0,46,34
8468484,2010,2.98,2.92,4,3,67,32,40,139,11,4,5,63,1,61,18
8468485,2010,12.31,12.21,7,8,115,41,23,179,29,14,4,101,10,134,31
8468486,2010,20.57,20.33,14,11,177,65,49,291,49,24,13,153,5,168,31
8468493,2010,3.35,3.27,6,10,83,45,57,185,19,3,5,80,0,51,30
8468498,2010,1.69,1.67,4,8,56,28,45,129,13,1,2,55,1,194,17
8468500,2010,7.47,7.18,5,4,78,24,23,125,16,7,6,71,1,39,12
8468501,2010,2.02,1.93,5,3,65,27,40,132,8,0,6,65,0,125,7
8468502,2010,0.64,0.63,1,3,20,4,11,35,5,1,0,19,0,29,8
8468504,2010,18.7,17.84,20,18,178,70,73,321,55,17,10,161,136,67,30
8468505,2010,12.49,12.13,16,4,120,54,40,214,32,12,7,108,644,252,25
8468506,2010,3.28,3.1,2,0,32,8,16,56,4,2,3,30,19,70,9
8468508,2010,22.09,21.46,17,18,213,90,83,386,57,22,25,191,7,51,26
8468509,2010,11.61,11.11,11,15,131,54,78,263,37,11,9,120,0,113,26
8468510,2010,0,0,0,0,0,0,0,0,0,0,0,0,2,0,0
8468513,2010,2.14,2.09,9,5,46,35,35,116,17,3,6,43,1,78,9
8468515,2010,10.36,10.01,2,4,90,28,27,145,16,10,5,80,2,171,19
8468518,2010,16.49,16.41,20,7,178,49,68,295,42,15,9,163,120,77,50
8468520,2010,9.98,9,4,10,182,74,108,364,22,8,8,174,0,89,18
8468526,2010,13.73,13.34,15,8,187,73,77,337,43,20,6,167,753,164,31
8468534,2010,1.1,1.08,1,5,31,13,16,60,7,1,0,30,0,92,6
8468535,2010,19.85,18.76,13,15,183,72,66,321,47,19,22,164,856,123,35
8468542,2010,7.39,7.29,8,13,104,40,62,206,24,3,10,101,0,45,36
8468575,2010,18.2,17.82,10,4,175,47,46,268,32,18,10,157,475,80,32
8468577,2010,2.92,2.91,3,2,86,35,53,174,8,3,3,83,0,99,21
8468598,2010,9.48,9.13,18,32,152,79,108,339,68,18,9,134,0,52,30
8468599,2010,0.06,0.06,1,0,4,0,3,7,1,0,0,4,0,9,0
8468611,2010,9.32,9.14,8,8,113,40,38,191,25,9,9,104,52,169,18
8468626,2010,1.08,0.97,0,0,9,1,5,15,1,1,0,8,0,28,1
8468635,2010,10.78,10.65,8,2,99,18,20,137,16,6,4,93,8,129,15
8468636,2010,2.63,2.26,2,5,55,32,55,142,7,0,4,55,0,169,21
8468639,2010,9.18,8.76,19,21,163,67,130,360,46,6,15,157,0,59,32
8468660,2010,2.73,2.66,1,3,32,12,16,60,5,1,4,31,0,116,5
8468674,2010,1.12,1.12,3,4,49,24,36,109,10,3,5,46,0,122,15
8468695,2010,0.59,0.56,0,0,6,2,0,8,0,0,0,6,16,0,2
8468700,2010,12.41,12.03,12,7,117,36,38,191,31,12,11,105,692,128,22
8468704,2010,15.72,15.32,7,12,168,58,56,282,35,16,3,152,36,109,23
8468778,2010,0.91,0.89,0,0,14,6,7,27,2,2,0,12,0,46,1
8468789,2010,1.35,1.35,3,0,18,13,14,45,5,2,2,16,18,14,10
8468846,2010,0.61,0.59,1,4,12,5,16,33,6,1,0,11,0,30,8
8468887,2010,0.9,0.86,0,0,11,6,2,19,1,1,0,10,49,24,1
8468927,2010,4.5,4.24,13,8,118,37,67,222,26,5,6,113,0,86,21
8469120,2010,0.22,0.21,0,0,0,1,0,1,0,0,0,0,0,1,1
8469454,2010,24.26,23.97,19,10,245,104,112,461,60,31,10,214,9,28,43
8469455,2010,17.6,16.72,25,11,188,80,77,345,57,21,15,167,681,14,52
8469457,2010,20.29,18.35,15,13,172,46,65,283,49,21,14,151,689,52,44
8469459,2010,18.82,17.98,21,24,191,67,83,341,62,17,16,174,683,63,64
8469460,2010,2.18,2.08,4,5,48,29,72,149,10,1,1,47,0,146,14
8469462,2010,19.98,19.39,20,18,148,72,83,303,57,19,13,129,265,309,42
8469464,2010,4.39,4.31,2,1,62,19,25,106,5,2,1,60,5,108,15
8469465,2010,5.26,4.85,6,11,109,39,86,234,23,6,5,103,0,76,43
8469466,2010,11.43,11.16,21,7,100,37,46,183,42,14,9,86,1,29,17
8469467,2010,6.69,6.5,2,5,74,15,35,124,16,9,5,65,6,31,17
8469469,2010,26.13,25.02,19,13,220,79,64,363,57,25,16,195,111,114,44
8469470,2010,3.92,3.78,8,12,81,39,70,190,26,6,2,75,0,75,16
8469472,2010,2.01,1.88,3,1,44,22,20,86,5,1,2,43,0,110,14
8469473,2010,9.14,8.91,4,11,111,31,36,178,24,9,8,102,346,51,17
8469474,2010,9.4,8.92,9,6,69,28,27,124,23,8,3,61,3,88,34
8469476,2010,2.83,2.74,6,8,84,53,91,228,16,2,10,82,0,215,16
8469480,2010,2.39,2.34,1,8,72,34,58,164,11,2,3,70,0,43,19
8469483,2010,7.54,7.35,6,0,79,22,29,130,12,6,0,73,511,104,24
8469485,2010,10.53,10.04,20,5,89,21,41,151,35,10,9,79,245,16,37
8469490,2010,13.25,12.8,10,3,131,44,50,225,23,10,10,121,6,133,23
8469492,2010,5.87,5.69,10,10,128,41,91,260,27,7,8,121,1,120,29
8469500,2010,19.95,19.25,14,14,193,72,78,343,47,19,13,174,33,17,23
8469501,2010,9.51,9.45,6,4,114,31,48,193,19,9,9,105,125,129,43
8469505,2010,0.01,0.01,0,0,1,0,1,2,0,0,0,1,0,10,0
8469506,2010,18.97,18.41,18,12,215,58,80,353,52,22,12,193,67,35,43
8469508,2010,14.09,13.68,10,3,127,55,34,216,20,7,11,120,595,75,37
8469521,2010,19.54,19.24,20,15,227,79,92,398,57,22,7,205,788,53,43
8469531,2010,1.92,1.88,6,1,49,40,49,138,10,3,4,46,0,111,16
8469544,2010,26.21,25.87,18,19,268,103,105,476,71,34,7,234,244,76,64
8469547,2010,6.7,6.62,7,3,85,29,37,151,18,8,2,77,2,95,25
8469555,2010,11.28,10.97,17,19,209,98,144,451,50,14,16,195,0,54,19
8469564,2010,0.01,0.01,0,0,1,0,1,2,0,0,0,1,0,3,2
8469581,2010,5.2,5.07,4,4,50,14,24,88,13,5,3,45,65,8,26
8469582,2010,0.58,0.56,0,0,5,3,3,11,0,0,0,5,1,3,2
8469584,2010,0.17,0.17,0,0,3,2,2,7,0,0,0,3,13,11,1
8469591,2010,7.58,7.4,8,4,104,28,53,185,20,8,11,96,132,108,20
8469598,2010,6.08,5.99,5,11,105,52,66,223,22,6,5,99,0,104,50
8469619,2010,5.66,5.52,14,11,166,59,96,321,32,7,6,159,0,161,12
8469622,2010,21.65,20.6,25,13,185,45,56,286,62,24,19,161,17,153,43
8469623,2010,6.21,5.89,7,10,53,37,51,141,24,7,4,46,0,66,14
8469626,2010,0.83,0.83,4,2,21,7,25,53,7,1,1,20,0,113,7
8469638,2010,15.98,15.25,20,13,136,40,46,222,52,19,8,117,169,45,39
8469639,2010,23.88,22.88,19,13,207,65,83,355,48,16,13,191,269,113,38
8469647,2010,0.47,0.48,1,0,4,4,1,9,2,1,1,3,0,27,0
8469664,2010,12.25,11.7,3,10,128,42,32,202,30,17,7,111,157,92,32
8469665,2010,3.16,3.03,4,11,90,45,76,211,17,2,6,88,0,64,45
8469670,2010,3.89,3.96,3,1,50,14,16,80,8,4,1,46,0,12,9
8469672,2010,0.57,0.49,0,0,8,1,1,10,0,0,2,8,2,12,1
8469681,2010,0,0,0,0,0,0,0,0,0,0,0,0,0,8,0
8469684,2010,4.11,3.95,8,5,76,24,39,139,17,4,5,72,0,125,25
8469685,2010,3.96,4.01,2,2,48,11,14,73,8,4,1,44,19,77,10
8469707,2010,18.59,17.13,18,15,162,43,59,264,53,20,10,142,11,118,45
8469755,2010,4.35,4.37,2,3,40,22,16,78,10,5,1,35,2,91,8
8469759,2010,8.56,8.46,11,5,97,30,36,163,22,6,10,91,660,85,27
8469760,2010,3.85,3.79,8,6,104,43,82,229,19,5,4,99,0,56,13
8469765,2010,1.73,1.64,3,3,37,22,29,88,8,2,3,35,0,6,5
8469770,2010,9.24,8.88,9,21,160,88,116,364,40,10,13,150,1,95,38
8469779,2010,0,0,0,0,0,0,0,0,0,0,0,0,1,1,0
8469812,2010,17.49,16.99,8,7,176,75,77,328,31,16,12,160,11,196,39
8469820,2010,5.41,5.06,3,4,56,13,7,76,9,2,3,54,620,110,18
8469992,2010,1.31,1.26,0,0,29,11,21,61,0,0,1,29,0,54,3
8470018,2010,1.61,1.59,0,0,20,12,7,39,0,0,1,20,28,8,4
8470039,2010,11.46,10.38,16,3,98,25,45,168,31,12,9,86,99,15,26
8470041,2010,27.55,26.91,19,15,305,118,124,547,66,32,15,273,7,91,47
8470047,2010,13.23,12.84,12,11,115,49,64,228,39,16,3,99,478,30,50
8470054,2010,2,1.98,0,5,53,24,59,136,7,2,3,51,0,99,9
8470063,2010,8.46,8.24,3,3,89,32,21,142,14,8,6,81,255,77,14
8470065,2010,0.86,0.85,0,0,7,1,1,9,0,0,0,7,3,6,0
8470072,2010,1.01,1.03,1,0,10,5,4,19,1,0,1,10,3,13,4
8470086,2010,0.89,0.85,1,0,21,12,13,46,1,0,0,21,0,46,1
8470104,2010,7.62,7.18,7,13,107,49,64,220,26,6,7,101,0,69,43
8470105,2010,17.14,16.95,6,6,191,82,74,347,34,22,8,169,8,108,33
8470110,2010,8.24,8.18,6,13,131,79,83,293,27,8,7,123,0,32,34
8470113,2010,0.16,0.17,0,0,1,2,2,5,0,0,0,1,5,4,0
8470120,2010,20.12,19.24,17,9,196,112,131,439,54,28,15,168,4,27,62
8470121,2010,1.35,1.34,6,3,50,31,33,114,11,2,6,48,0,243,8
8470123,2010,1.58,1.61,2,1,16,7,5,28,4,1,1,15,0,95,3
8470136,2010,0.7,0.62,0,2,11,2,8,21,3,1,0,10,0,6,0
8470137,2010,6.19,6.08,14,16,144,67,100,311,35,5,10,139,0,66,32
8470144,2010,14.73,14.42,20,11,156,46,53,255,44,13,11,143,446,23,66
8470151,2010,6.35,6.09,8,12,121,54,95,270,24,4,7,117,0,72,23
8470153,2010,8.38,8.24,10,16,98,35,39,172,38,12,4,86,17,15,26
8470156,2010,5.64,5.23,9,3,51,21,18,90,15,3,2,48,5,99,21
8470159,2010,6.04,6.01,4,2,77,24,28,129,9,3,2,74,417,34,14
8470162,2010,10.75,10.21,17,8,81,41,26,148,31,6,6,75,436,66,52
8470169,2010,11.84,11.75,5,11,98,27,47,172,29,13,4,85,430,119,11
8470171,2010,11.44,11.22,11,2,117,29,39,185,21,8,9,109,425,154,26
8470176,2010,18.91,18.27,8,7,182,64,60,306,29,14,12,168,25,109,45
8470180,2010,7.88,7.68,4,4,83,37,43,163,12,4,3,79,45,169,19
8470187,2010,5.65,5.55,6,7,154,60,88,302,16,3,12,151,0,117,14
8470189,2010,1.34,1.18,2,0,12,4,0,16,3,1,4,11,0,10,2
8470192,2010,1.89,1.82,0,4,23,17,20,60,6,2,0,21,0,143,18
8470201,2010,11.85,11.52,18,9,105,37,43,185,37,10,5,95,31,35,30
8470203,2010,5.12,5,5,0,46,21,7,74,10,5,5,41,2,56,20
8470207,2010,14.22,14.07,9,8,129,47,45,221,31,14,6,115,12,63,18
8470222,2010,9.43,8.77,21,20,158,68,121,347,51,10,14,148,0,108,35
8470230,2010,5.19,5.19,6,1,48,15,10,73,13,6,1,42,0,24,10
8470232,2010,0.68,0.66,1,0,6,4,4,14,1,0,1,6,34,19,0
8470257,2010,22.52,20.97,17,14,218,120,119,457,51,20,14,198,41,39,29
8470265,2010,6.41,6.26,8,16,132,74,103,309,35,11,9,121,0,19,19
8470273,2010,5.7,5.51,7,15,138,69,123,330,26,4,16,134,0,59,30
8470274,2010,15.72,15.27,10,5,160,47,50,257,28,13,10,147,41,80,40
8470280,2010,6.18,5.94,7,3,84,28,25,137,17,7,7,77,0,87,21
8470281,2010,8.78,8.67,16,22,173,101,177,451,45,7,10,166,0,45,56
8470283,2010,6.12,5.91,7,5,60,28,23,111,20,8,1,52,410,104,23
8470289,2010,5.95,5.73,4,3,53,16,10,79,12,5,8,48,185,59,16
8470294,2010,0.52,0.54,0,2,6,0,1,7,2,0,0,6,0,20,4
8470299,2010,8.2,8.15,14,2,86,41,39,166,27,11,6,75,316,34,28
8470302,2010,10.14,9.95,5,5,104,37,43,184,18,8,3,96,80,166,36
8470309,2010,3.23,3.19,11,14,43,17,31,91,27,2,2,41,0,29,20
8470310,2010,2.39,2.38,3,1,50,24,35,109,5,1,6,49,0,78,13
8470317,2010,0.18,0.16,0,0,2,0,1,3,0,0,0,2,0,11,1
8470318,2010,3.4,3.32,7,5,89,42,45,176,15,3,3,86,0,107,16
8470321,2010,1.43,1.37,1,0,14,7,3,24,1,0,1,14,2,17,2
8470324,2010,1.47,1.44,1,5,20,19,23,62,7,1,1,19,0,55,8
8470329,2010,3.82,3.72,6,11,84,30,70,184,21,4,9,80,0,99,19
8470358,2010,19.67,19.18,6,16,152,64,51,267,48,26,5,126,6,84,39
8470378,2010,0.6,0.57,1,0,17,4,6,27,1,0,1,17,0,5,3
8470543,2010,16.94,16.08,14,11,133,67,63,263,48,23,15,110,4,155,18
8470578,2010,0.77,0.72,1,0,11,8,10,29,2,1,2,10,0,29,2
8470580,2010,0.31,0.29,0,0,5,3,1,9,0,0,0,5,0,4,1
8470595,2010,34.35,32.96,26,17,296,133,111,540,76,33,17,263,840,81,64
8470596,2010,20.67,20.32,14,13,188,74,72,334,53,26,10,162,8,74,26
8470597,2010,11.86,11.65,4,2,135,29,48,212,22,16,9,119,2,39,19
8470598,2010,32.49,31.99,23,18,238,86,59,383,73,32,22,206,8,30,43
8470599,2010,19.11,18.57,8,7,167,56,47,270,33,18,13,149,4,49,40
8470600,2010,6.09,5.95,19,16,115,47,102,264,39,4,5,111,0,64,33
8470601,2010,4.3,4.25,9,5,114,53,74,241,16,2,9,112,0,177,32
8470602,2010,11.33,10.58,9,13,190,94,159,443,30,8,3,182,0,186,31
8470603,2010,18.21,17.67,17,8,196,78,89,363,45,20,10,176,0,140,23
8470604,2010,37.38,35.97,14,16,335,114,120,569,66,36,31,299,331,65,40
8470605,2010,0.45,0.42,0,0,2,1,1,4,0,0,0,2,0,4,0
8470606,2010,25.57,25.21,18,11,228,96,96,420,57,28,15,200,18,300,35
8470607,2010,7.62,7.53,17,22,135,67,87,289,48,9,9,126,0,227,27
8470609,2010,11.79,11.45,5,5,97,39,26,162,15,5,5,92,4,112,22
8470610,2010,3.88,3.73,2,1,49,9,7,65,6,3,6,46,4,13,6
8470611,2010,13.82,13.1,7,3,120,52,42,214,20,10,14,110,0,34,23
8470612,2010,14.44,13.88,27,30,117,65,54,236,76,19,8,98,542,189,35
8470613,2010,12.06,11.62,13,16,170,78,130,378,46,17,15,153,1,133,47
8470614,2010,2.02,1.96,3,1,41,31,37,109,6,2,2,39,1,107,12
8470615,2010,0.1,0.1,0,0,2,1,1,4,0,0,1,2,5,2,0
8470616,2010,33.84,31.69,22,10,260,115,121,496,73,41,23,219,859,124,65
8470617,2010,23.52,22.64,26,17,184,96,93,373,66,23,9,161,606,104,62
8470618,2010,17.42,16.59,15,10,141,50,44,235,39,14,16,127,7,98,34
8470619,2010,19.06,17.31,7,7,218,70,77,365,35,21,8,197,534,240,33
8470620,2010,13.41,12.87,5,3,114,45,40,199,17,9,6,105,19,113,11
8470621,2010,39.92,38.57,29,19,290,102,91,483,98,50,22,240,9,64,55
8470622,2010,12.03,11.7,6,1,108,48,45,201,20,13,6,95,3,106,20
8470623,2010,0.31,0.3,0,0,8,2,5,15,0,0,0,8,0,9,2
8470626,2010,21.2,20.75,27,19,179,65,41,285,73,27,9,152,1,26,72
8470630,2010,4.24,4.19,6,10,99,43,52,194,18,2,5,97,0,128,31
8470634,2010,0.27,0.27,0,0,9,4,10,23,0,0,0,9,0,45,0
8470638,2010,22.39,22.03,23,12,211,66,88,365,57,22,13,189,815,45,49
8470640,2010,5.71,5.52,20,19,117,54,91,262,40,1,10,116,0,51,33
8470642,2010,11.77,11.13,17,15,254,120,123,497,48,16,17,238,0,211,62
8470647,2010,7.5,7.41,1,6,113,46,51,210,14,7,6,106,19,93,16
8470648,2010,1.17,1.13,1,1,12,4,11,27,2,0,0,12,7,24,2
8470649,2010,4.41,4.35,5,1,50,24,14,88,8,2,4,48,20,15,15
8470651,2010,2.13,2.13,1,0,7,6,7,20,3,2,0,5,52,23,11
8470654,2010,11.7,11.4,5,1,129,34,34,197,12,6,10,123,173,194,20
8470655,2010,26.68,25.53,19,12,211,94,56,361,62,31,16,180,506,213,47
8470656,2010,0.11,0.11,0,0,2,2,1,5,1,1,1,1,0,3,1
8470661,2010,2.93,2.8,1,0,28,13,8,49,5,4,3,24,5,111,6
8470662,2010,5.06,4.92,2,0,57,12,22,91,5,3,5,54,246,79,27
8470666,2010,4.12,4.04,1,1,56,10,20,86,6,4,7,52,1,80,7
8470667,2010,18.48,17.67,30,11,154,56,82,292,62,21,5,133,9,115,24
8470672,2010,1.47,1.43,2,8,45,29,51,125,10,0,5,45,0,179,21
8470678,2010,2.76,2.72,4,1,49,23,44,116,8,3,6,46,0,55,9
8470680,2010,0.25,0.25,0,0,7,2,3,12,0,0,0,7,10,5,3
8470685,2010,1.63,1.65,3,1,37,19,29,85,5,1,1,36,1,38,8
8470687,2010,2.02,1.9,3,1,16,9,11,36,4,0,1,16,14,46,4
8470697,2010,8.14,7.94,7,4,101,32,22,155,17,6,11,95,153,128,44
8470699,2010,2.92,2.8,5,10,79,39,49,167,20,5,4,74,1,152,21
8470705,2010,0.77,0.76,1,0,6,3,2,11,1,0,0,6,7,1,0
8470708,2010,0.44,0.44,0,0,4,5,3,12,0,0,1,4,1,22,1
8470713,2010,1.72,1.67,0,0,18,6,14,38,1,1,1,17,2,122,2
8470714,2010,0.02,0.03,0,0,1,0,0,1,0,0,0,1,0,1,0
8470719,2010,1.51,1.56,2,0,21,5,3,29,4,2,0,19,44,29,4
8470724,2010,1.38,1.36,1,0,39,10,24,73,1,0,5,39,0,28,6
8470729,2010,0.87,0.87,1,0,28,14,18,60,1,0,0,28,0,23,3
8470737,2010,1.56,1.57,1,1,14,4,7,25,5,3,0,11,2,7,2
8470740,2010,19.64,19.26,4,15,199,61,94,354,38,19,9,180,18,124,46
8470741,2010,0.61,0.6,0,1,12,3,5,20,1,0,1,12,0,19,6
8470750,2010,2.98,2.92,0,1,28,8,17,53,3,2,1,26,83,31,8
8470755,2010,9.91,9.7,7,5,103,40,47,190,19,7,6,96,92,84,28
8470760,2010,2.05,1.98,7,8,58,31,43,132,15,0,3,58,0,176,21
8470774,2010,1.98,1.89,3,3,43,31,40,114,6,0,2,43,0,40,28
8470775,2010,14.38,14.13,10,5,123,43,38,204,25,10,7,113,360,115,35
8470777,2010,0,0,0,0,0,0,0,0,0,0,0,0,0,3,0
8470778,2010,9.67,9.45,4,4,85,37,32,154,18,10,4,75,4,84,12
8470787,2010,0.02,0.02,0,0,1,0,1,2,0,0,0,1,0,0,0
8470794,2010,27.53,26.38,27,19,282,82,89,453,66,20,28,262,554,61,51
8470798,2010,0.79,0.76,3,3,23,12,12,47,6,0,3,23,0,17,11
8470803,2010,16.2,15.66,15,6,126,61,43,230,37,16,8,110,532,52,48
8470804,2010,0.02,0.02,0,0,1,1,0,2,0,0,1,1,0,4,0
8470809,2010,0,0,0,0,0,0,1,1,0,0,0,0,0,0,0
8470816,2010,1.08,1.07,2,0,12,1,3,16,3,1,0,11,0,36,3
8470828,2010,6.93,6.78,21,20,113,45,89,247,51,10,11,103,0,30,26
8470834,2010,19.77,19.06,21,12,347,144,167,658,53,20,20,327,0,140,85
8470839,2010,2.64,2.59,4,3,50,19,36,105,9,2,2,48,0,164,30
8470852,2010,27.32,25.87,8,12,230,70,85,385,49,29,21,201,5,78,44
8470854,2010,4.25,4.14,7,0,45,24,19,88,10,3,3,42,25,130,9
8470867,2010,4.02,3.91,2,1,44,13,26,83,4,1,1,43,0,86,12
8470871,2010,4.81,4.84,3,1,55,17,16,88,7,3,3,52,12,91,10
8470877,2010,23.84,22.33,10,8,153,62,52,267,45,27,16,126,10,93,24
8470886,2010,1.13,1.1,2,5,40,22,34,96,9,2,1,38,0,110,23
8470896,2010,0.25,0.26,1,0,6,2,2,10,1,0,1,6,0,23,1
8470905,2010,1.68,1.61,6,6,52,32,45,129,13,1,5,51,0,42,20
8470920,2010,14.29,13.92,3,3,192,61,44,297,18,12,17,180,19,170,24
8470966,2010,8.46,8.03,16,19,165,96,129,390,43,8,12,157,0,140,25
8470986,2010,4.08,3.91,3,5,27,18,20,65,13,5,3,22,212,67,13
8470988,2010,0.18,0.18,0,0,3,0,0,3,0,0,1,3,0,0,0
8470996,2010,0.79,0.79,0,1,11,5,14,30,2,1,4,10,0,4,0
8471011,2010,0.09,0.08,0,0,2,1,0,3,0,0,0,2,0,4,0
8471185,2010,18.24,17.66,12,7,149,57,46,252,43,24,18,125,57,105,47
8471187,2010,2.38,2.29,0,3,34,27,46,107,4,1,1,33,0,33,3
8471208,2010,21.99,20.49,12,10,173,80,54,307,45,23,13,150,131,90,45
8471214,2010,37.46,36.07,30,23,367,159,248,774,85,32,25,335,6,241,48
8471215,2010,21.92,21.19,11,11,182,64,76,322,37,15,15,167,77,32,29
8471216,2010,2.13,2.07,1,3,44,30,35,109,5,1,2,43,0,68,6
8471217,2010,24.06,22.96,16,14,195,64,77,336,59,29,15,166,15,68,61
8471218,2010,17.49,16.97,16,10,179,60,53,292,44,18,10,161,52,74,40
8471220,2010,6.39,6.07,6,5,71,20,30,121,17,6,6,65,2,68,19
8471222,2010,1.98,1.96,3,7,48,23,50,121,10,0,4,48,0,145,19
8471226,2010,15.88,15.52,10,11,179,38,58,275,52,31,6,148,17,53,19
8471231,2010,2.03,2.02,2,0,23,7,4,34,2,0,0,23,132,30,8
8471232,2010,11.39,11.25,13,8,103,44,45,192,40,19,5,84,107,87,25
8471233,2010,14.81,14.29,16,15,173,46,71,290,44,13,10,160,707,55,60
8471234,2010,12.42,11.62,12,11,135,43,39,217,35,12,7,123,15,47,21
8471236,2010,8.22,8,14,10,144,60,110,314,32,8,13,136,0,189,34
8471238,2010,8.21,7.73,7,6,83,35,33,151,26,13,5,70,224,34,42
8471240,2010,0.96,0.96,2,7,34,21,40,95,10,1,2,33,0,53,17
8471241,2010,1.05,1.03,2,1,26,24,31,81,5,2,0,24,0,173,11
8471242,2010,6.71,6.37,11,5,115,48,89,252,24,8,8,107,0,100,25
8471245,2010,9.57,9.48,17,5,102,40,37,179,37,15,9,87,455,41,55
8471254,2010,10.42,10.47,10,10,130,45,44,219,37,17,5,113,3,178,34
8471260,2010,18.13,17.5,16,6,182,71,107,360,46,24,10,158,35,120,55
8471265,2010,0.13,0.1,0,0,1,0,0,1,0,0,0,1,0,2,0
8471266,2010,29.35,28,11,6,280,98,109,487,40,23,26,257,24,129,28
8471268,2010,1.22,1.23,2,1,19,3,2,24,3,0,1,19,1,28,3
8471269,2010,1.18,1.14,4,5,38,32,44,114,10,1,1,37,0,161,8
8471273,2010,23.48,22.98,19,11,202,70,71,343,54,24,16,178,459,141,48
8471274,2010,11.29,10.18,13,19,162,82,148,392,46,14,13,148,0,75,14
8471276,2010,15.26,15.03,32,17,157,51,58,266,62,13,11,144,560,56,33
8471279,2010,2.71,2.64,4,8,56,27,51,134,16,4,3,52,1,72,20
8471280,2010,1.56,1.55,1,1,10,3,1,14,3,1,0,9,0,4,1
8471283,2010,11.25,10.78,7,9,87,28,25,140,29,13,9,74,4,161,26
8471284,2010,4.28,4.24,10,16,88,48,92,228,29,3,7,85,0,61,38
8471299,2010,9.74,9.26,7,7,87,36,35,158,17,3,10,84,132,30,40
8471303,2010,8.17,7.93,13,12,121,70,84,275,33,8,4,113,0,83,25
8471309,2010,25.02,24.25,17,10,248,93,69,410,55,28,14,220,74,143,36
8471310,2010,2.07,2.02,0,0,8,5,6,19,1,1,0,7,23,12,0
8471311,2010,20.29,18.94,17,7,234,73,95,402,45,21,17,213,27,95,25
8471314,2010,1.75,1.74,4,7,55,38,66,159,12,1,3,54,0,25,17
8471321,2010,0.21,0.21,0,0,12,2,8,22,0,0,1,12,0,19,1
8471323,2010,14.12,13.88,3,4,126,41,62,229,25,18,8,108,10,152,38
8471324,2010,8.09,7.55,5,4,85,23,34,142,10,1,6,84,41,76,23
8471331,2010,10.64,10.21,5,6,102,48,52,202,25,14,9,88,19,126,22
8471338,2010,11.58,10.99,7,7,116,43,35,194,23,9,13,107,99,57,32
8471339,2010,23.73,21.93,15,10,179,70,50,299,48,23,17,156,2,224,42
8471346,2010,17.84,17.34,15,10,180,82,104,366,46,21,13,159,63,45,53
8471348,2010,1.31,1.31,5,3,46,26,37,109,9,1,2,45,0,40,4
8471352,2010,7.93,7.71,10,5,74,15,18,107,21,6,3,68,319,107,32
8471362,2010,24.65,23.91,19,10,239,105,84,428,58,29,4,210,642,44,49
8471368,2010,0.85,0.8,0,0,4,6,5,15,0,0,0,4,1,2,2
8471371,2010,5.69,5.75,3,2,59,24,14,97,8,3,0,56,4,105,11
8471385,2010,1.45,1.42,4,2,36,12,33,81,7,1,2,35,0,42,8
8471386,2010,0.91,0.91,1,2,6,4,2,12,4,1,0,5,0,2,2
8471388,2010,6.3,6,3,2,65,11,17,93,9,4,9,61,5,126,11
8471390,2010,22.44,21.36,12,9,193,66,61,320,41,20,16,173,518,60,32
8471392,2010,2.06,2.1,0,9,54,24,33,111,12,3,4,51,0,110,11
8471399,2010,0.58,0.56,0,0,6,2,2,10,0,0,0,6,0,8,0
8471409,2010,0.69,0.65,1,0,5,7,5,17,2,1,0,4,0,4,0
8471411,2010,0.61,0.58,1,0,4,2,1,7,1,0,1,4,0,3,1
8471413,2010,0.34,0.3,0,1,6,3,2,11,1,0,1,6,0,8,4
8471419,2010,2.68,2.63,3,4,43,14,7,64,8,1,2,42,3,16,9
8471426,2010,14.7,14.49,13,6,122,51,47,220,36,17,6,105,12,262,24
8471428,2010,0,0,0,0,0,0,0,0,0,0,0,0,0,3,0
8471429,2010,0.04,0.05,0,0,1,1,2,4,0,0,0,1,0,3,0
8471436,2010,4.03,3.88,4,8,100,33,56,189,13,1,7,99,0,65,26
8471450,2010,10.65,10.25,6,4,127,41,38,206,22,12,9,115,5,77,20
8471451,2010,1.47,0.9,0,2,9,10,7,26,2,0,0,9,30,12,4
8471474,2010,0.1,0.1,0,0,2,1,0,3,0,0,0,2,8,1,0
8471476,2010,13.6,13.36,10,5,167,52,54,273,26,11,16,156,25,54,49
8471482,2010,2.25,2.16,7,8,50,27,57,134,19,4,2,46,0,67,6
8471483,2010,4.01,3.9,4,3,38,10,15,63,11,4,2,34,63,21,10
8471490,2010,2.14,2.17,3,1,26,12,9,47,7,3,2,23,46,29,8
8471498,2010,10.23,10.23,17,3,113,35,37,185,29,9,8,104,8,149,42
8471504,2010,21.81,21.05,14,9,218,90,74,382,50,27,16,191,7,90,35
8471508,2010,0.28,0.27,0,0,8,6,6,20,0,0,0,8,0,29,4
8471514,2010,20.93,20.18,14,9,201,65,62,328,41,18,15,183,657,32,63
8471521,2010,2.73,2.51,3,2,29,12,10,51,9,4,1,25,0,133,6
8471628,2010,0.18,0.18,0,1,6,1,1,8,1,0,0,6,9,13,2
8471634,2010,9.34,9.06,8,8,118,36,33,187,27,11,5,107,87,34,41
8471636,2010,1.47,1.47,2,0,22,10,12,44,2,0,1,22,116,79,8
8471657,2010,8.81,8.34,1,2,73,22,23,118,8,5,10,68,3,147,7
8471663,2010,0.11,0.1,0,0,2,1,1,4,0,0,0,2,5,6,0
8471664,2010,17.52,17.31,12,12,197,63,69,329,39,15,12,182,26,38,35
8471668,2010,4.02,3.84,3,1,42,14,13,69,8,4,3,38,19,24,6
8471669,2010,21.9,20.92,22,13,181,51,47,279,57,22,17,159,810,74,52
8471670,2010,2.83,2.37,3,0,18,8,2,28,6,3,2,15,0,18,2
8471675,2010,19.57,19.06,20,14,161,58,59,278,66,32,7,129,546,31,15
8471676,2010,25.66,24.77,25,12,270,88,65,423,71,34,14,236,87,156,62
8471677,2010,8.44,8.09,18,19,153,105,129,387,42,5,11,148,0,84,16
8471678,2010,10.5,10.18,12,5,129,43,41,213,30,13,9,116,10,110,26
8471680,2010,5.58,5.45,2,0,72,15,25,112,9,7,5,65,106,95,9
8471681,2010,12.29,11.96,7,4,154,40,49,243,19,8,9,146,3,134,23
8471682,2010,21.78,20.53,7,12,199,69,78,346,41,22,24,177,5,138,29
8471683,2010,1.3,1.28,1,2,35,30,25,90,3,0,3,35,0,88,5
8471685,2010,27.32,26.58,30,18,233,82,95,410,73,25,11,208,579,92,62
8471686,2010,8.76,8.33,12,10,116,50,68,234,29,7,9,109,0,140,54
8471689,2010,0.61,0.55,4,0,13,3,3,19,5,1,1,12,75,41,8
8471691,2010,18.63,18.41,5,5,149,70,46,265,26,16,8,133,518,147,28
8471692,2010,0.08,0.08,0,0,3,2,3,8,0,0,0,3,0,4,0
8471693,2010,1.95,1.93,1,1,62,21,40,123,4,2,3,60,0,44,11
8471694,2010,0.27,0.27,0,0,6,3,3,12,0,0,1,6,1,36,1
8471696,2010,0.56,0.5,0,1,8,7,7,22,1,0,2,8,0,10,6
8471697,2010,10.54,10.32,12,12,152,47,47,246,36,12,9,140,4,12,48
8471698,2010,11.68,11.45,17,5,103,46,46,195,34,12,4,91,100,71,47
8471699,2010,14.32,14.05,20,4,129,44,61,234,35,11,10,118,461,89,32
8471702,2010,3.39,3.38,4,5,77,54,59,190,10,1,5,76,0,122,7
8471703,2010,7.43,7.29,14,8,83,31,26,140,32,10,8,73,43,94,30
8471705,2010,0.77,0.75,1,1,14,10,12,36,2,0,0,14,0,21,2
8471707,2010,19.92,19.38,16,7,212,82,87,381,45,22,9,190,8,159,59
8471708,2010,5.18,4.76,1,1,45,13,11,69,4,2,6,43,2,30,4
8471709,2010,7.05,6.98,8,6,116,71,96,283,18,4,12,112,0,50,30
8471710,2010,0.81,0.8,0,3,13,5,15,33,4,1,0,12,0,13,4
8471714,2010,3.52,3.46,6,6,54,36,35,125,15,3,3,51,0,78,25
8471716,2010,10.99,10.88,8,4,129,58,39,226,19,7,10,122,227,188,17
8471717,2010,1.82,1.81,6,6,46,16,61,123,15,3,5,43,0,102,5
8471719,2010,0.08,0.07,0,0,1,0,1,2,0,0,0,1,0,6,0
8471724,2010,14.2,12.32,19,23,236,101,151,488,50,8,15,228,1,167,39
8471728,2010,0.01,0.01,0,0,1,0,0,1,0,0,0,1,0,2,0
8471729,2010,5.87,5.78,10,8,88,46,63,197,23,5,6,83,0,63,25
8471730,2010,0.16,0.14,0,0,1,0,0,1,0,0,0,1,4,3,0
8471735,2010,12.56,12.31,23,25,199,104,127,430,59,11,13,188,0,30,31
8471741,2010,0,0,0,0,0,0,1,1,0,0,0,0,0,1,0
8471742,2010,5.13,5.03,13,8,156,64,84,304,29,8,9,148,0,81,29
8471743,2010,6.73,6.73,15,7,75,27,38,140,29,7,0,68,216,137,19
8471748,2010,0.42,0.42,2,0,15,10,10,35,2,0,1,15,0,57,3
8471752,2010,0.25,0.23,0,2,11,4,6,21,3,1,1,10,0,6,6
8471753,2010,1.44,1.32,2,0,12,6,4,22,3,1,1,11,11,1,2
8471756,2010,0.22,0.22,0,0,7,4,8,19,0,0,1,7,0,8,3
8471760,2010,0,0,0,0,0,0,0,0,0,0,0,0,0,3,0
8471761,2010,2.35,2.36,2,5,52,20,47,119,9,2,3,50,0,38,18
8471762,2010,1.32,1.29,0,2,16,10,8,34,2,0,0,16,84,19,6
8471766,2010,5.11,4.87,4,1,66,23,19,108,12,7,3,59,0,144,14
8471767,2010,1.59,1.6,2,0,20,3,9,32,3,1,0,19,46,12,5
8471768,2010,5.5,5.48,1,4,65,25,29,119,7,2,3,63,55,39,17
8471769,2010,1.72,1.69,2,5,64,35,48,147,10,3,2,61,0,46,32
8471786,2010,0.28,0.27,0,0,0,3,1,4,0,0,0,0,0,1,1
8471794,2010,17.21,17.2,12,8,177,58,54,289,32,12,14,165,493,128,46
8471804,2010,13.68,13.55,8,7,171,46,46,263,31,16,12,155,4,53,24
8471807,2010,6.69,6.63,1,1,94,50,53,197,9,7,11,87,190,65,40
8471810,2010,1.06,1.05,2,5,34,10,33,77,9,2,2,32,0,40,7
8471811,2010,5.26,5.21,7,5,44,16,17,77,18,6,2,38,231,5,29
8471816,2010,2.03,2.02,5,5,78,28,43,149,14,4,7,74,0,52,13
8471817,2010,1.92,1.86,2,0,16,2,5,23,4,2,1,14,0,86,2
8471832,2010,0.64,0.61,0,0,2,3,0,5,0,0,0,2,6,7,0
8471840,2010,0.6,0.56,1,0,4,3,1,8,1,0,0,4,22,3,0
8471842,2010,0.19,0.18,0,1,2,1,0,3,1,0,1,2,12,16,4
8471848,2010,0.07,0.06,1,0,2,0,2,4,1,0,0,2,0,15,2
8471851,2010,15.96,15.63,16,9,163,60,63,286,46,21,8,142,21,70,24
8471856,2010,1.47,1.47,0,1,13,2,9,24,2,1,0,12,36,18,5
8471859,2010,13.86,13.64,9,18,93,39,53,185,50,23,4,70,1,41,28
8471862,2010,5.55,5.41,3,4,57,18,16,91,13,6,5,51,11,56,11
8471863,2010,0.42,0.42,0,0,1,1,1,3,1,1,0,0,7,2,2
8471873,2010,4.31,4.07,7,10,80,39,56,175,18,1,3,79,0,39,15
8471879,2010,1.23,1.21,0,7,21,10,8,39,8,1,4,20,0,9,14
8471887,2010,22.66,22.38,17,10,265,65,61,391,48,21,12,244,22,86,40
8471941,2010,0,0,0,0,0,0,0,0,0,0,0,0,0,6,0
8471956,2010,1.01,0.97,1,1,12,3,8,23,3,1,1,11,31,34,6
8471958,2010,4.58,4.37,12,15,110,47,83,240,31,4,6,106,0,195,30
8471976,2010,7.42,6.53,6,8,55,10,17,82,22,8,4,47,221,16,10
8471978,2010,0.01,0.01,0,0,0,1,0,1,0,0,0,0,0,2,0
8472262,2010,1.19,1.13,1,1,22,11,12,45,5,3,2,19,0,16,2
8472355,2010,8.01,7.44,3,4,88,33,28,149,10,3,5,85,169,113,20
8472361,2010,2.76,2.66,1,2,33,12,1,46,7,4,1,29,13,19,8
8472368,2010,7.63,7.72,4,5,91,31,36,158,16,7,8,84,1,50,15
8472370,2010,1.11,1.12,0,0,35,15,14,64,1,1,0,34,0,47,7
8472379,2010,5.45,5.13,0,2,44,20,13,77,7,5,4,39,109,18,15
8472382,2010,4.9,4.8,8,11,91,41,78,210,23,4,4,87,0,49,34
8472394,2010,0.84,0.82,2,1,12,9,9,30,4,1,0,11,0,5,5
8472410,2010,1.15,1.1,0,0,13,7,5,25,0,0,0,13,0,16,5
8473412,2010,19.45,18.51,16,14,158,53,72,283,48,18,11,140,616,41,80
8473419,2010,15.79,15.01,12,8,149,36,42,227,41,21,3,128,8,89,36
8473422,2010,15.72,15.03,11,9,149,32,38,219,34,14,11,135,65,119,31
8473426,2010,3.12,3.05,3,10,53,28,41,122,17,4,4,49,0,158,14
8473432,2010,8.84,8.57,8,5,112,39,44,195,17,4,11,108,19,195,25
8473444,2010,1.14,1.1,0,0,11,3,7,21,2,2,2,9,30,13,4
8473446,2010,8.27,7.57,9,12,161,52,102,315,29,8,12,153,0,99,28
8473449,2010,8.32,8.02,7,8,72,36,55,163,20,5,5,67,36,31,26
8473453,2010,8.67,8.64,4,6,105,50,27,182,13,3,6,102,151,102,27
8473456,2010,0.13,0.12,0,0,2,1,0,3,0,0,1,2,0,0,2
8473459,2010,0.04,0.04,0,0,3,0,1,4,0,0,0,3,0,4,0
8473465,2010,5.79,5.74,4,1,63,33,25,121,6,1,4,62,8,101,18
8473466,2010,1.95,1.98,2,1,30,3,11,44,5,2,0,28,13,70,8
8473473,2010,24.86,24.59,15,17,173,76,91,340,62,30,6,143,21,167,27
8473482,2010,4.63,4.55,4,2,53,17,32,102,12,6,2,47,2,36,21
8473485,2010,17.48,16.84,19,6,162,44,39,245,53,28,17,134,13,56,14
8473488,2010,0.45,0.48,0,0,6,1,2,9,1,1,0,5,0,1,0
8473492,2010,4.17,3.94,4,3,58,16,20,94,10,3,3,55,3,64,7
8473493,2010,1.39,1.38,0,1,13,6,1,20,2,1,0,12,16,1,5
8473501,2010,1.89,1.84,1,3,23,12,18,53,5,1,1,22,0,26,9
8473504,2010,16.25,15.94,11,4,191,78,64,333,34,19,5,172,3,336,24
8473507,2010,1.52,1.47,0,4,41,31,46,118,5,1,1,40,0,48,16
8473512,2010,23.02,22.02,34,17,169,64,70,303,76,25,13,144,548,117,48
8473514,2010,4.04,3.78,1,2,41,13,20,74,9,6,4,35,5,59,11
8473525,2010,2.33,2.19,4,6,41,23,47,111,13,3,1,38,0,196,30
8473533,2010,11.44,10.69,12,7,91,27,48,166,30,11,6,80,376,70,20
8473534,2010,18.58,17.73,19,11,175,72,67,314,52,22,14,153,450,116,28
8473537,2010,12.68,12.57,9,3,135,55,32,222,24,12,7,123,5,102,36
8473542,2010,2.28,2.21,2,0,7,8,3,18,4,2,1,5,1,31,1
8473544,2010,16.48,15.89,18,12,183,44,77,304,47,17,9,166,414,121,26
8473546,2010,26.67,25.86,12,6,228,55,51,334,52,34,14,194,2,22,69
8473548,2010,34.19,32.87,23,9,325,109,138,572,64,32,22,293,24,11,45
8473558,2010,0.07,0.06,0,0,3,0,0,3,1,1,0,2,0,0,0
8473560,2010,0.01,0.01,0,0,1,0,2,3,0,0,0,1,0,1,1
8473562,2010,4.28,4,1,1,41,15,15,71,4,2,5,39,13,28,7
8473563,2010,21.24,20.33,28,19,202,78,70,350,65,18,20,184,690,69,73
8473564,2010,19.53,18.67,14,13,251,67,91,409,38,11,15,240,48,52,49
8473565,2010,0.02,0.02,0,0,0,1,2,3,0,0,0,0,0,2,1
8473568,2010,12.24,11.76,7,4,100,26,25,151,22,11,10,89,11,111,21
8473569,2010,1.84,1.8,0,0,20,7,7,34,1,1,0,19,3,14,5
8473571,2010,4,3.89,9,14,95,35,93,223,30,7,9,88,0,41,22
8473573,2010,22.15,21.69,14,12,190,65,80,335,44,18,10,172,306,74,46
8473574,2010,9.64,9.49,7,3,90,14,31,135,16,6,4,84,188,60,22
8473579,2010,20.06,19.47,9,18,173,67,74,314,57,30,13,143,60,101,37
8473580,2010,0.42,0.43,3,3,21,3,16,40,6,0,0,21,0,30,0
8473584,2010,4.17,4.06,9,14,72,43,81,196,27,4,5,68,0,38,49
8473588,2010,4.15,4.07,5,0,48,15,19,82,11,6,2,42,2,4,9
8473589,2010,0.02,0.02,0,0,0,1,1,2,0,0,0,0,0,4,0
8473592,2010,3.45,3.42,0,2,40,14,5,59,4,2,2,38,2,14,19
8473600,2010,5.43,5.34,3,1,56,25,30,111,9,5,6,51,2,46,11
8473604,2010,26.53,25.73,28,16,233,57,54,344,76,32,15,201,937,74,93
8473605,2010,1.29,1.25,4,0,18,5,9,32,5,1,2,17,0,6,5
8473608,2010,2.34,2.37,0,2,24,2,9,35,8,6,0,18,46,8,11
8473611,2010,0,0,0,0,0,0,1,1,0,0,0,0,0,1,1
8473618,2010,4.6,4.5,4,3,41,16,21,78,14,7,3,34,139,13,21
8473646,2010,5.38,5.29,3,3,63,27,23,113,9,3,4,60,242,133,23
8473673,2010,2.87,2.82,2,8,47,22,23,92,14,4,0,43,0,56,3
8473682,2010,2.78,2.71,1,2,23,9,13,45,5,2,2,21,104,13,8
8473700,2010,2.8,2.71,7,6,62,29,45,136,16,3,7,59,0,135,28
8473712,2010,0.06,0.06,0,0,1,0,1,2,0,0,0,1,0,6,0
8473722,2010,1.2,1.19,0,1,15,8,10,33,1,0,1,15,0,60,3
8473734,2010,0.05,0.05,0,0,1,1,2,4,0,0,0,1,3,21,1
8473908,2010,1.66,1.65,1,2,20,11,3,34,3,0,3,20,2,59,5
8473913,2010,0.17,0.18,0,0,4,2,1,7,1,1,0,3,0,2,0
8473914,2010,11.02,10.98,7,6,128,47,57,232,27,14,6,114,407,51,26
8473927,2010,0.4,0.39,0,0,6,0,0,6,1,1,0,5,7,7,0
8473931,2010,0.22,0.23,1,0,4,2,2,8,2,1,0,3,0,4,0
8473932,2010,8.12,7.9,8,2,87,35,39,161,17,7,4,80,66,196,20
8473933,2010,2.01,1.99,7,7,60,35,43,138,17,3,3,57,0,44,7
8473953,2010,0.29,0.28,1,0,13,2,7,22,1,0,0,13,0,5,3
8473962,2010,14.16,13.57,17,17,196,50,70,316,51,17,12,179,12,21,35
8473970,2010,0.01,0.01,0,0,1,1,1,3,0,0,0,1,0,3,0
8473991,2010,1.71,1.67,2,8,64,25,53,142,12,2,1,62,0,98,24
8473992,2010,0.23,0.19,2,1,7,3,11,21,3,0,1,7,0,22,3
8473994,2010,20.82,19.86,18,16,177,70,79,326,56,22,11,155,84,124,66
8473997,2010,0.8,0.77,0,0,8,5,2,15,0,0,0,8,2,7,1
8473999,2010,9.14,8.91,5,3,66,31,29,126,17,9,3,57,2,36,16
8474000,2010,3.22,3.06,2,3,57,23,50,130,10,5,3,52,0,41,5
8474001,2010,6.41,6.05,4,4,62,24,24,110,15,7,5,55,62,41,26
8474002,2010,0.18,0.17,0,0,2,1,2,5,0,0,0,2,0,4,2
8474009,2010,2.04,1.99,0,0,23,13,5,41,0,0,0,23,78,18,10
8474013,2010,1.31,1.25,0,3,22,16,20,58,4,1,2,21,0,36,5
8474024,2010,0.43,0.4,0,0,11,2,2,15,0,0,0,11,8,5,2
8474025,2010,1.82,1.73,2,0,18,4,3,25,3,1,3,17,1,25,2
8474027,2010,2.25,2.17,3,6,44,33,35,112,11,2,5,42,0,27,14
8474030,2010,0.3,0.29,0,0,3,1,2,6,0,0,0,3,0,3,0
8474031,2010,6.06,5.81,20,14,108,45,91,244,43,9,12,99,0,66,41
8474037,2010,17.98,17.61,11,8,173,63,67,303,40,21,8,152,0,107,27
8474038,2010,0.69,0.7,0,1,5,2,0,7,2,1,0,4,29,18,8
8474040,2010,14.25,13.82,17,10,138,53,51,242,42,15,10,123,410,24,33
8474042,2010,0.09,0.09,0,0,3,1,1,5,0,0,0,3,13,11,1
8474045,2010,0.1,0.09,0,1,1,1,2,4,1,0,0,1,5,0,1
8474046,2010,0.07,0.07,0,0,5,0,1,6,0,0,0,5,0,4,0
8474048,2010,1.1,1.09,0,0,32,17,27,76,2,2,1,30,0,98,5
8474050,2010,1.56,1.53,0,1,16,6,8,30,3,2,0,14,1,8,1
8474053,2010,30.03,28.95,16,8,253,94,84,431,56,32,24,221,474,60,49
8474056,2010,10.55,10.18,9,15,197,78,115,390,38,14,8,183,0,110,37
8474059,2010,7.6,7.43,14,8,76,27,38,141,27,5,6,71,3,13,33
8474063,2010,0.17,0.17,0,1,8,2,4,14,1,0,0,8,0,8,13
8474068,2010,10.13,9.97,8,6,116,34,36,186,25,11,8,105,270,30,14
8474074,2010,0.03,0.03,0,0,1,0,0,1,0,0,0,1,0,1,0
8474077,2010,0.57,0.55,0,1,5,0,4,9,2,1,0,4,9,6,0
8474085,2010,0.97,0.96,2,0,14,4,4,22,3,1,2,13,2,9,0
8474091,2010,15.86,15.5,13,2,144,53,44,241,29,14,8,130,589,69,48
8474094,2010,4.34,4.21,3,5,29,14,12,55,12,4,4,25,0,6,16
8474095,2010,7.11,7.13,4,5,73,25,20,118,15,6,4,67,5,47,21
8474096,2010,8.12,7.8,3,3,75,29,40,144,14,8,6,67,253,37,44
8474098,2010,0,0,0,0,0,0,1,1,0,0,0,0,0,0,0
8474100,2010,0.28,0.27,0,0,3,1,0,4,0,0,0,3,0,7,1
8474102,2010,3.49,3.48,2,0,29,5,3,37,7,5,0,24,0,6,9
8474114,2010,2.41,2.33,2,1,27,9,18,54,4,1,3,26,4,10,3
8474121,2010,0.4,0.41,0,0,3,4,1,8,1,1,0,2,1,16,0
8474125,2010,3.63,3.57,4,12,69,26,62,157,20,4,2,65,0,63,24
8474134,2010,2.76,2.75,3,7,63,42,57,162,11,1,6,62,0,44,8
8474137,2010,2.05,2,1,0,28,15,20,63,1,0,2,28,0,24,8
8474138,2010,3.58,3.46,5,0,39,12,19,70,12,7,0,32,109,14,9
8474141,2010,21.24,20.89,24,22,216,71,91,378,73,27,8,189,2,17,55
8474146,2010,1.03,1,0,0,7,1,3,11,0,0,0,7,0,22,0
8474149,2010,6.42,6.23,3,6,60,22,19,101,17,8,5,52,1,45,10
8474150,2010,11.4,11.26,9,6,144,55,41,240,25,10,5,134,319,35,37
8474151,2010,1.29,1.24,5,3,27,13,30,70,9,1,4,26,0,56,18
8474153,2010,6.21,5.8,4,2,54,28,12,94,8,2,9,52,3,47,3
8474154,2010,0.17,0.16,0,0,2,2,2,6,0,0,0,2,0,8,3
8474157,2010,15.08,13.99,6,4,112,46,30,188,24,14,7,98,0,67,20
8474161,2010,17.41,16.91,20,12,183,68,48,299,46,14,15,169,24,55,38
8474162,2010,0.33,0.32,1,0,8,2,10,20,1,0,0,8,0,22,2
8474164,2010,1.03,0.99,4,1,18,10,12,40,8,3,3,15,0,20,14
8474166,2010,3.96,3.88,4,7,74,38,78,190,16,5,2,69,0,69,4
8474184,2010,2.13,2.05,3,7,56,24,57,137,12,2,7,54,0,74,14
8474189,2010,7.7,7.6,7,3,79,48,44,171,17,7,6,72,183,85,24
8474190,2010,12.12,12.02,6,10,117,48,61,226,30,14,11,103,7,125,30
8474192,2010,0.53,0.47,0,0,5,2,1,8,0,0,0,5,0,1,1
8474195,2010,0.26,0.25,0,0,3,2,3,8,1,1,0,2,0,4,0
8474207,2010,0.22,0.21,0,0,6,5,4,15,0,0,0,6,0,4,0
8474218,2010,5.58,5.33,10,12,105,59,81,245,24,2,9,103,0,87,30
8474220,2010,2.04,2.06,0,2,28,14,19,61,2,0,2,28,2,13,9
8474222,2010,0.6,0.59,0,0,8,5,2,15,0,0,0,8,0,2,3
8474230,2010,1.62,1.59,1,0,13,5,6,24,3,2,0,11,7,55,7
8474250,2010,6.65,6.24,2,3,78,24,32,134,9,4,6,74,209,129,21
8474291,2010,2.59,2.57,0,1,27,8,18,53,3,2,2,25,58,45,10
8474498,2010,11.15,10.54,7,2,118,40,34,192,13,4,6,114,303,101,24
8474518,2010,0.95,0.94,3,2,27,10,33,70,5,0,1,27,0,23,6
8474519,2010,4.81,4.5,12,6,81,37,60,178,22,4,9,77,0,54,39
8474520,2010,4.88,4.65,8,5,116,63,85,264,18,5,8,111,0,136,19
8474531,2010,0.1,0.1,0,0,5,0,3,8,1,1,1,4,0,4,0
8474535,2010,0.59,0.61,2,1,7,3,2,12,3,0,0,7,43,19,6
8474551,2010,14.58,14.13,18,16,117,36,43,196,53,19,12,98,78,35,39
8474557,2010,2.02,1.98,2,4,57,20,21,98,7,1,4,56,0,48,14
8474563,2010,9.43,9.19,15,14,139,75,140,354,40,11,12,128,0,137,22
8474564,2010,35.22,34.4,22,24,272,133,115,520,91,45,12,227,431,84,40
8474565,2010,8.05,7.38,13,19,161,74,117,352,43,11,13,150,0,57,40
8474566,2010,2.43,2.36,4,3,31,9,21,61,7,0,1,31,0,10,4
8474567,2010,5.26,5.11,5,7,155,69,84,308,17,5,6,150,0,111,33
8474568,2010,4.62,4.5,11,6,128,56,130,314,22,5,7,123,0,251,38
8474569,2010,11.23,11.21,15,3,101,35,50,186,34,16,11,85,108,38,24
8474570,2010,0.55,0.52,0,1,9,3,5,17,2,1,1,8,16,4,2
8474571,2010,4.01,3.91,6,4,39,16,21,76,14,4,2,35,3,42,7
8474573,2010,14.22,13.56,11,6,102,24,36,162,28,11,5,91,273,47,72
8474574,2010,7.81,7.52,13,14,122,59,89,270,37,10,10,112,0,107,41
8474576,2010,4.37,4.28,1,2,44,7,12,63,7,4,4,40,1,50,5
8474577,2010,0.18,0.16,1,0,1,1,0,2,1,0,0,1,3,0,1
8474578,2010,9.59,9.27,18,14,182,66,138,386,45,13,12,169,0,32,56
8474579,2010,3.02,2.93,5,4,76,27,45,148,11,2,4,74,0,170,15
8474582,2010,8.57,8.21,10,4,87,19,30,136,22,8,3,79,0,24,13
8474584,2010,4.49,4.46,5,4,58,42,52,152,11,2,1,56,0,92,16
8474586,2010,16.36,15.83,17,8,158,51,77,286,43,18,12,140,11,32,56
8474587,2010,0.25,0.26,1,0,5,1,3,9,1,0,1,5,1,1,1
8474589,2010,21.35,20.75,19,10,210,67,63,340,49,20,19,190,2,42,45
8474590,2010,7.38,6.39,14,16,144,62,103,309,37,7,9,137,0,70,60
8474592,2010,1.48,1.43,1,1,13,4,8,25,3,1,1,12,34,8,0
8474601,2010,0.12,0.12,0,0,6,0,3,9,0,0,1,6,0,9,0
8474605,2010,0.19,0.19,0,2,3,7,5,15,2,0,1,3,0,4,0
8474609,2010,3.44,3.34,0,1,31,11,8,50,4,3,2,28,41,17,2
8474610,2010,1.2,1.19,0,1,16,6,6,28,4,3,1,13,7,10,5
8474611,2010,0.37,0.36,0,0,4,3,5,12,1,1,0,3,0,10,1
8474612,2010,4.7,4.57,12,9,118,50,93,261,26,5,12,113,0,118,45
8474613,2010,17.35,16.87,16,8,166,64,79,309,45,21,13,145,277,83,39
8474616,2010,2.51,2.34,1,0,27,10,1,38,2,1,2,26,39,31,6
8474618,2010,0.67,0.67,2,0,13,5,9,27,2,0,1,13,0,20,5
8474634,2010,0.29,0.27,0,0,3,1,2,6,0,0,1,3,0,8,4
8474641,2010,0.32,0.29,0,0,3,0,0,3,0,0,1,3,0,0,0
8474642,2010,0.89,0.87,1,0,9,4,4,17,1,0,0,9,0,15,2
8474646,2010,8.74,8.3,6,4,77,31,25,133,21,11,8,66,114,53,11
8474657,2010,0.34,0.34,0,0,3,0,0,3,0,0,0,3,0,0,0
8474668,2010,0.47,0.46,0,0,9,2,1,12,0,0,0,9,0,20,2
8474673,2010,0.08,0.08,0,0,1,0,3,4,0,0,0,1,0,2,1
8474674,2010,0,0,0,0,0,0,0,0,0,0,0,0,0,1,0
8474681,2010,3.48,3.3,3,0,26,16,12,54,7,4,0,22,23,6,10
8474685,2010,5.96,5.82,5,4,50,17,17,84,20,11,3,39,3,51,7
8474693,2010,0.13,0.12,1,1,5,0,1,6,2,0,1,5,1,14,2
8474705,2010,1.74,1.72,4,3,25,6,10,41,9,2,1,23,12,27,9
8474707,2010,0.7,0.68,0,2,11,6,1,18,2,0,1,11,0,1,1
8474709,2010,7.77,7.4,4,7,67,37,45,149,18,7,8,60,10,305,27
8474716,2010,2.59,2.5,5,3,38,17,25,80,12,4,3,34,0,37,11
8474719,2010,2.9,2.75,1,1,21,9,7,37,5,3,3,18,6,19,4
8474727,2010,0.66,0.66,0,0,6,0,1,7,1,1,0,5,6,7,3
8474730,2010,1.41,1.38,1,5,36,26,23,85,6,0,1,36,0,19,9
8474731,2010,0.19,0.19,0,1,6,1,3,10,1,0,0,6,0,13,0
8474739,2010,0.14,0.16,0,0,1,1,0,2,0,0,0,1,1,6,0
8474749,2010,0.05,0.05,0,0,2,2,4,8,0,0,0,2,0,4,0
8474762,2010,0.36,0.36,0,0,4,3,1,8,0,0,1,4,3,10,0
8474850,2010,0.58,0.58,0,0,5,7,2,14,0,0,1,5,0,16,2
8474892,2010,1.4,1.4,1,0,8,2,3,13,1,0,1,8,0,4,4
8475060,2010,1.53,1.46,2,0,38,16,18,72,5,3,2,35,0,12,7
8475087,2010,0.35,0.34,0,0,2,6,3,11,0,0,0,2,7,11,2
8475098,2010,17.18,16.15,9,8,120,45,37,202,32,15,8,105,787,85,46
8475104,2010,0.02,0.02,0,0,1,1,2,4,0,0,0,1,0,2,0
8475105,2010,5.16,5.09,6,3,78,30,10,118,13,4,3,74,1,29,8
8475118,2010,4.15,3.8,4,4,75,21,42,138,11,3,6,72,0,39,15
8475149,2010,10.78,10.52,12,2,102,29,46,177,27,13,8,89,271,47,47
8475150,2010,3.04,3.09,1,3,27,11,11,49,7,3,1,24,1,19,3
8475151,2010,0.65,0.64,0,0,10,3,1,14,1,1,0,9,0,5,0
8475158,2010,11.48,11,9,4,119,29,33,181,26,13,5,106,531,53,72
8475159,2010,0,0,0,0,0,0,1,1,0,0,0,0,0,1,0
8475160,2010,5.7,5.61,5,2,69,28,33,130,14,7,4,62,8,138,10
8475166,2010,33.89,32.11,20,18,243,81,83,407,67,29,26,214,693,22,75
8475167,2010,4.42,4.35,9,14,101,54,88,243,26,3,6,98,0,54,48
8475168,2010,21.04,19.58,23,17,202,85,69,356,67,27,18,175,628,57,65
8475169,2010,20.78,20.31,18,6,234,68,76,378,43,19,14,215,26,154,53
8475170,2010,1.02,1,2,0,11,2,0,13,2,0,0,11,17,12,0
8475171,2010,2.3,2.2,4,6,50,25,42,117,11,1,8,49,0,41,3
8475172,2010,5.3,5.15,5,4,51,21,22,94,12,3,6,48,49,16,15
8475175,2010,14.63,14.13,10,9,180,58,79,317,34,15,14,165,1,22,25
8475179,2010,3.92,3.79,9,11,83,44,86,213,26,6,7,77,0,107,18
8475181,2010,1.57,1.56,1,2,37,15,16,68,7,4,1,33,0,26,10
8475185,2010,2.79,2.68,5,2,31,13,12,56,10,3,2,28,95,8,8
8475186,2010,0,0,0,0,0,0,1,1,0,0,0,0,0,1,0
8475193,2010,1.03,1.02,0,0,6,5,6,17,1,1,1,5,0,7,2
8475204,2010,0.04,0.04,0,0,1,0,0,1,0,0,0,1,2,0,0
8475214,2010,1.16,1.13,1,0,13,6,4,23,3,2,1,11,0,12,3
8475248,2010,0.28,0.28,0,0,5,7,4,16,1,1,0,4,0,5,1
8475266,2010,1.79,1.76,0,1,26,13,13,52,2,1,2,25,3,36,4
8475304,2010,1.82,1.71,0,0,13,9,9,31,1,1,2,12,61,18,7
8475323,2010,0.58,0.57,0,0,7,3,3,13,0,0,0,7,14,4,3
8475372,2010,0.03,0.02,0,0,1,1,2,4,0,0,0,1,7,2,1
8475602,2010,1.18,1.18,0,1,20,5,9,34,2,1,0,19,8,5,3
8475603,2010,0,0,0,0,0,0,1,1,0,0,0,0,5,8,1
8475613,2010,0.09,0.08,0,0,1,1,1,3,0,0,0,1,0,0,0
8475619,2010,0.47,0.46,1,0,6,2,4,12,2,1,0,5,0,36,0
8475637,2010,7.19,6.95,6,5,73,25,18,116,21,10,8,63,0,28,9
8475640,2010,0.03,0.03,0,0,2,0,3,5,0,0,0,2,0,0,1
8475641,2010,0.03,0.03,0,0,2,0,2,4,0,0,0,2,0,1,0
8475677,2010,0.33,0.35,0,0,4,2,0,6,0,0,0,4,0,1,0
8475690,2010,1.04,1.01,0,1,15,4,19,38,1,0,0,15,0,10,10
8475692,2010,7.11,6.96,8,9,74,29,18,121,23,6,8,68,8,56,16
8475764,2010,5.09,4.91,15,15,123,50,82,255,40,10,8,113,0,45,23
8475784,2010,29.16,28.27,15,17,215,89,100,404,63,31,22,184,58,70,63
8475788,2010,6.95,6.85,5,9,92,34,41,167,20,6,2,86,289,62,48
8475791,2010,22.83,22.19,9,11,186,76,101,363,42,22,11,164,42,48,45
8475794,2010,11.47,11.41,9,2,131,41,35,207,22,11,4,120,150,20,22
8475799,2010,0.7,0.71,1,0,12,3,4,19,2,1,3,11,0,16,5
8475950,2010,0.42,0.41,0,0,5,2,0,7,0,0,0,5,0,7,0
8475990,2010,0.01,0.01,0,0,1,0,1,2,0,0,0,1,0,1,2
8476205,2010,0.72,0.7,0,0,9,1,1,11,0,0,0,9,6,3,7
8476208,2010,0,0,0,0,0,0,0,0,0,0,0,0,0,0,0
8445550,2009,9.5,8.8,6,17,176,61,98,335,30,7,16,169,0,68,19
8445735,2009,11.42,11.01,5,5,95,37,32,164,19,9,5,86,490,82,27
8446053,2009,0.13,0.12,0,0,5,3,4,12,0,0,1,5,0,8,2
8446485,2009,7.79,7.82,9,6,98,28,29,155,22,7,7,91,166,100,12
8449645,2009,9.17,8.67,11,5,115,37,41,193,30,14,3,101,418,22,37
8449895,2009,14.91,14.27,9,8,151,55,45,251,33,16,9,135,184,51,29
8450725,2009,18.69,17.93,14,11,152,39,45,236,43,18,10,134,54,84,26
8451224,2009,1.49,1.45,5,2,37,30,31,98,9,2,0,35,0,27,8
8455919,2009,4.96,4.91,9,3,52,21,27,100,15,3,3,49,453,43,26
8456283,2009,1.11,1.1,5,4,26,21,33,80,9,0,3,26,0,111,11
8456464,2009,24.53,23.56,12,12,224,83,66,373,45,21,16,203,14,77,9
8456887,2009,10.75,10.25,9,9,113,35,41,189,26,8,12,105,6,17,31
8456966,2009,9.25,8.87,13,7,84,44,36,164,29,9,7,75,375,30,9
8457063,2009,8.85,8.43,19,21,194,91,119,404,49,9,8,185,0,56,36
8457261,2009,2.4,2.26,1,0,26,8,9,43,1,0,1,26,0,58,3
8457981,2009,20.02,19.44,18,3,172,58,37,267,48,27,11,145,62,14,17
8458172,2009,1.12,1.1,3,5,26,13,29,68,8,0,0,26,0,18,5
8458229,2009,15.63,14.81,15,4,120,44,30,194,32,13,8,107,389,98,11
8458361,2009,5.32,5.1,9,7,58,23,20,101,17,1,6,57,69,15,18
8458517,2009,9.09,8.6,13,25,168,50,86,304,48,10,11,158,0,58,46
8458519,2009,1.38,1.35,1,11,39,21,52,112,13,1,3,38,0,172,12
8458525,2009,17.44,16.81,10,7,232,69,100,401,37,20,17,212,32,91,34
8458529,2009,19.77,18.29,20,11,165,71,93,329,49,18,15,147,1,34,34
8458536,2009,10.76,10.71,6,3,87,30,24,141,17,8,2,79,253,14,32
8458537,2009,19.17,18.22,26,11,167,88,76,331,56,19,8,148,3,24,63
8458541,2009,2.94,2.86,6,3,61,29,39,129,10,1,3,60,0,54,12
8458590,2009,21.01,20.39,14,10,151,61,47,259,53,29,8,122,0,72,33
8458637,2009,1.61,1.56,5,7,44,30,37,111,15,3,4,41,0,88,19
8458938,2009,5.53,5.37,14,6,100,48,77,225,26,6,9,94,0,59,28
8458943,2009,12,11.84,16,6,126,74,49,249,37,15,10,111,18,66,25
8458951,2009,8.05,7.02,17,22,135,65,95,295,50,11,7,124,0,64,19
8459001,2009,4.66,4.6,1,1,43,20,18,81,6,4,0,39,7,83,17
8459004,2009,3.83,3.66,8,6,63,27,61,151,15,1,5,62,0,61,17
8459024,2009,8.24,7.95,6,6,86,32,31,149,16,4,3,82,1,43,37
8459053,2009,7.53,7.33,5,15,144,78,92,314,28,8,4,136,1,132,17
8459064,2009,0.76,0.7,0,0,6,2,1,9,0,0,0,6,7,4,0
8459094,2009,5.14,5.04,9,8,53,27,26,106,20,3,5,50,28,171,21
8459122,2009,3.09,2.94,1,3,38,15,15,68,8,4,2,34,177,90,16
8459246,2009,1.17,1.19,0,1,18,5,7,30,1,0,1,18,0,43,6
8459424,2009,8.17,7.83,16,29,175,48,120,343,55,10,9,165,0,104,40
8459426,2009,19.08,18.82,13,12,221,73,80,374,43,18,9,203,4,36,24
8459427,2009,10.06,9.79,10,2,93,27,21,141,22,10,2,83,478,83,22
8459429,2009,20.22,18.79,14,13,216,64,53,333,46,19,12,197,526,24,30
8459433,2009,0.57,0.55,2,1,25,8,22,55,5,2,1,23,0,79,10
8459442,2009,16.04,15.39,18,15,124,38,35,197,52,19,7,105,571,59,31
8459443,2009,0.38,0.4,1,4,6,8,10,24,5,0,1,6,0,19,3
8459444,2009,22.33,22.05,17,9,216,76,74,366,44,18,8,198,11,105,32
8459450,2009,2.06,1.93,1,2,24,5,7,36,5,2,0,22,0,21,4
8459454,2009,5.88,5.89,3,2,71,19,25,115,9,4,4,67,5,32,18
8459457,2009,20,19.45,19,23,228,75,86,389,61,19,10,209,29,108,37
8459461,2009,11.6,11.29,19,11,105,41,49,195,42,12,8,93,501,33,45
8459462,2009,8.64,8.46,15,20,169,67,122,358,43,8,14,161,0,113,18
8459492,2009,19.83,18.89,26,12,180,53,65,298,58,20,12,160,327,95,44
8459514,2009,6.01,5.84,7,4,75,29,17,121,14,3,4,72,214,69,21
8459534,2009,4.68,4.65,2,3,59,28,27,114,14,9,3,50,15,9,12
8459547,2009,6.14,6.03,1,2,61,23,14,98,8,5,6,56,0,80,12
8459574,2009,7.78,7.45,9,5,73,19,17,109,24,10,8,63,29,87,9
8459587,2009,9.08,8.97,4,9,83,31,20,134,22,9,2,74,284,127,29
8459596,2009,21.04,19.93,22,14,129,41,22,192,61,25,8,104,5,33,15
8459628,2009,1.69,1.67,3,6,41,17,50,108,11,2,0,39,0,82,17
8459640,2009,9.71,9.36,5,7,123,41,36,200,22,10,9,113,20,97,22
8459648,2009,5.04,4.98,6,7,53,18,20,91,16,3,1,50,46,18,5
8459670,2009,5.57,5.24,12,21,121,51,58,230,39,6,8,115,0,75,37
8459687,2009,6.48,6.21,11,4,92,35,39,166,19,4,9,88,497,226,30
8460465,2009,1.05,0.99,0,1,13,6,7,26,3,2,1,11,2,2,2
8460492,2009,6.91,6.33,14,10,117,46,70,233,34,10,5,107,0,106,14
8460496,2009,24.62,23.39,15,16,206,56,32,294,53,22,19,184,31,41,23
8460500,2009,0.75,0.75,0,1,12,4,1,17,2,1,0,11,0,10,1
8460502,2009,1.14,1.11,2,0,8,4,3,15,2,0,3,8,0,30,3
8460503,2009,4.23,3.92,6,7,71,32,37,140,13,0,6,71,0,112,21
8460504,2009,9.94,9.62,5,4,143,55,43,241,18,9,7,134,7,98,14
8460507,2009,5.16,4.86,3,2,47,13,16,76,8,3,3,44,283,58,13
8460527,2009,1.93,1.96,2,2,19,15,11,45,5,1,0,18,283,31,9
8460533,2009,2.79,2.84,1,1,25,5,6,36,5,3,1,22,42,18,7
8460541,2009,12.06,11.79,10,12,143,44,42,229,31,9,14,134,531,38,61
8460542,2009,14.7,13.69,20,9,145,42,50,237,48,19,8,126,205,30,23
8460555,2009,0.79,0.77,3,3,19,16,24,59,6,0,1,19,0,58,17
8460556,2009,8.19,7.79,4,2,67,32,31,130,11,5,5,62,18,28,17
8460561,2009,5.07,4.79,6,3,113,51,72,236,13,4,11,109,0,50,28
8460562,2009,18.3,17.04,12,6,148,67,52,267,32,14,7,134,638,67,58
8460567,2009,9.72,9.47,7,6,104,28,34,166,20,7,8,97,7,86,13
8460577,2009,15.58,14.94,12,9,153,35,45,233,44,23,11,130,4,30,32
8460580,2009,0.15,0.14,0,1,1,3,5,9,2,1,0,0,0,12,2
8460621,2009,18.82,17.72,25,26,169,67,81,317,71,20,9,149,14,42,76
8460626,2009,1.3,1.26,2,8,47,21,38,106,14,4,1,43,0,95,17
8460661,2009,2.32,2.26,8,4,49,37,53,139,14,2,5,47,0,36,11
8460719,2009,17.1,16.72,19,15,152,47,51,250,51,17,11,135,1,26,34
8460720,2009,3.51,3.33,4,2,39,8,13,60,8,2,3,37,2,96,11
8460743,2009,20.14,19.1,10,10,131,58,25,214,45,25,8,106,0,69,25
8460770,2009,7.19,6.63,5,5,94,47,69,210,17,7,4,87,0,43,22
8462033,2009,2.27,2.2,5,7,66,35,51,152,14,2,5,64,1,88,26
8462036,2009,14.55,14.33,10,13,126,57,46,229,37,14,6,112,492,80,63
8462038,2009,24.2,22.05,24,13,235,91,91,417,55,18,18,217,70,154,49
8462041,2009,13.9,13.61,8,10,140,44,44,228,32,14,9,126,3,50,36
8462042,2009,26.6,26.04,21,16,258,103,139,500,69,32,12,226,152,86,45
8462045,2009,1.37,1.34,4,5,42,16,30,88,10,1,1,41,0,59,4
8462060,2009,0.51,0.47,0,2,2,3,3,8,3,1,0,1,0,21,1
8462077,2009,20.25,19.62,10,11,224,59,57,340,42,21,11,203,146,46,43
8462118,2009,8.59,8.33,16,7,90,37,28,155,33,10,4,80,316,13,18
8462129,2009,15.41,14.97,13,9,117,43,20,180,42,20,9,97,694,76,38
8462176,2009,1.73,1.7,3,4,45,26,26,97,8,1,1,44,0,50,16
8462196,2009,10.82,10.16,18,13,195,77,114,386,41,10,10,185,0,264,22
8462225,2009,4.22,3.2,18,7,90,31,53,174,28,3,8,87,0,27,23
8462535,2009,4.18,4.2,6,1,48,18,8,74,9,2,5,46,2,95,4
8462823,2009,14.14,13.13,7,6,115,31,30,176,29,16,8,99,327,32,18
8464956,2009,3.72,3.63,7,9,82,32,58,172,24,8,2,74,0,97,30
8464957,2009,12.54,12.23,20,8,112,39,45,196,45,17,5,95,0,20,33
8464962,2009,1.11,1.06,1,4,22,6,10,38,6,1,3,21,0,21,1
8464966,2009,4.35,4.12,9,16,120,59,80,259,29,4,4,116,0,65,12
8464967,2009,7.8,7.53,9,4,86,31,45,162,17,4,5,82,512,33,51
8464975,2009,27.06,25.73,16,11,193,56,69,318,53,26,21,167,53,53,31
8464977,2009,10.26,9.87,11,6,86,18,27,131,27,10,5,76,194,61,18
8464979,2009,20.89,20.42,7,8,203,63,48,314,37,22,18,181,2,69,31
8464981,2009,2.33,2.09,3,2,46,24,28,98,6,1,3,45,0,116,6
8464989,2009,25.22,24.1,15,17,195,77,96,368,48,16,20,179,568,70,53
8464994,2009,9.86,9.75,6,3,110,28,32,170,14,5,3,105,371,184,25
8465005,2009,1.24,1.19,3,7,47,27,44,118,12,2,4,45,0,143,20
8465009,2009,11.2,10.55,24,13,242,71,147,460,44,7,13,235,1,151,27
8465012,2009,4.67,4.56,13,7,69,19,48,136,24,4,3,65,0,19,35
8465024,2009,13.37,13.03,3,6,128,32,29,189,22,13,14,115,9,118,27
8465025,2009,10.2,9.78,10,4,91,30,34,155,24,10,7,81,2,92,22
8465026,2009,1.05,1.01,1,1,10,9,6,25,2,0,0,10,4,11,1
8465028,2009,0.25,0.26,0,0,2,1,0,3,0,0,0,2,0,3,0
8465042,2009,3.2,3.19,4,12,77,23,46,146,20,4,9,73,0,126,10
8465050,2009,13.07,12.85,18,8,151,46,53,250,41,15,14,136,521,47,40
8465056,2009,1.06,1,1,0,15,1,7,23,1,0,1,15,103,14,3
8465058,2009,3.21,3.15,6,14,80,46,53,179,23,3,3,77,1,136,34
8465059,2009,8.77,8.59,9,5,98,35,60,193,24,10,8,88,11,113,27
8465113,2009,0.06,0.06,0,0,2,1,2,5,0,0,0,2,10,2,1
8465122,2009,4.69,4.64,7,10,75,32,54,161,20,3,7,72,0,55,20
8465166,2009,5.91,5.75,5,5,81,33,30,144,10,0,6,81,243,193,22
8465170,2009,5.14,4.75,3,1,54,16,23,93,8,4,3,50,3,58,13
8465185,2009,1.75,1.69,4,4,47,17,40,104,12,4,2,43,0,32,23
8465192,2009,6.88,6.75,6,7,93,34,32,159,16,3,5,90,663,150,28
8465200,2009,9.62,8.11,22,20,158,61,87,306,49,7,3,151,0,44,16
8465202,2009,5.7,5.5,7,12,119,53,78,250,28,9,5,110,0,43,16
8465210,2009,8.13,7.52,11,21,159,46,87,292,38,6,8,153,0,94,55
8465914,2009,4.72,4.31,6,2,86,42,76,204,11,3,5,83,0,162,25
8465951,2009,15.15,14.88,9,6,105,44,43,192,30,15,4,90,13,180,28
8465978,2009,6.33,6.16,8,1,119,33,24,176,10,1,7,118,11,110,12
8466035,2009,13.65,13.38,9,6,101,38,42,181,29,14,6,87,0,34,33
8466138,2009,18,17.18,43,26,140,44,48,232,89,20,12,120,655,111,71
8466139,2009,34.78,33.07,22,17,270,109,87,466,83,44,26,226,313,74,53
8466140,2009,21.05,20.65,17,18,236,95,98,429,50,15,25,221,480,110,39
8466142,2009,3.93,3.85,3,4,84,41,59,184,15,8,7,76,0,76,18
8466144,2009,2.28,2.19,5,3,30,26,31,87,8,0,3,30,0,50,5
8466145,2009,1.34,1.33,3,4,50,23,39,112,8,1,7,49,0,64,14
8466148,2009,18.67,18.55,17,10,199,59,56,314,51,24,7,175,0,41,44
8466149,2009,16.37,15.55,12,7,140,39,46,225,34,15,5,125,59,119,20
8466158,2009,2.67,2.57,5,9,53,25,45,123,16,2,4,51,2,67,29
8466160,2009,24.2,22.92,13,13,153,60,52,265,45,19,17,134,9,226,33
8466181,2009,16.1,15.38,25,14,159,59,67,285,62,23,14,136,4,15,43
8466182,2009,2.81,2.79,8,8,53,31,48,132,20,4,4,49,0,63,22
8466202,2009,18.85,18.68,20,17,181,69,71,321,61,24,10,157,1,32,65
8466215,2009,6.53,6.25,3,8,98,46,88,232,17,6,1,92,0,34,23
8466216,2009,5.63,5.57,4,4,67,19,18,104,14,6,5,61,93,95,11
8466232,2009,2.83,2.79,2,0,38,13,22,73,4,2,3,36,4,52,5
8466251,2009,11.21,10.94,8,11,160,43,32,235,34,15,11,145,22,80,16
8466260,2009,1.97,1.95,2,0,20,8,2,30,2,0,1,20,1,17,2
8466285,2009,6.04,6.01,11,20,131,45,91,267,38,7,6,124,0,37,23
8466292,2009,3.17,3.06,3,0,22,11,7,40,6,3,0,19,2,58,3
8466300,2009,0.44,0.41,0,0,5,3,1,9,0,0,1,5,15,14,1
8466309,2009,3.56,3.5,8,8,74,25,51,150,18,2,2,72,0,75,22
8466333,2009,2.32,2.27,3,5,60,35,51,146,8,0,3,60,0,58,4
8466371,2009,11.18,11.12,7,6,127,36,40,203,23,10,6,117,613,59,43
8466378,2009,28.45,27.55,34,31,242,101,65,408,94,29,13,213,71,20,62
8466392,2009,9.06,8.7,9,10,92,27,38,157,26,7,8,85,401,31,52
8466393,2009,15.14,14.79,11,8,157,53,55,265,37,18,15,139,13,85,26
8466398,2009,10.98,10.55,7,6,103,37,44,184,21,8,8,95,10,154,21
8467096,2009,13.64,13.07,24,19,179,84,142,405,58,15,18,164,0,51,42
8467304,2009,3.54,3.47,3,5,77,34,43,154,13,5,1,72,0,196,24
8467329,2009,29.91,28.73,23,23,295,97,99,491,70,24,28,271,771,80,33
8467330,2009,16.81,16.13,15,12,151,49,46,246,38,11,11,140,538,38,46
8467331,2009,7.86,7.67,7,9,153,83,87,323,20,4,5,149,1,206,30
8467332,2009,3.21,3.09,6,3,78,34,53,165,13,4,8,74,0,120,13
8467334,2009,10.64,10.36,9,10,111,47,43,201,33,14,12,97,415,66,30
8467336,2009,7.14,7.01,3,3,86,27,30,143,18,12,6,74,62,195,7
8467338,2009,13.75,12.97,14,13,91,44,40,175,37,10,3,81,11,42,34
8467343,2009,1.87,1.88,2,6,34,18,22,74,11,3,1,31,0,43,12
8467344,2009,2.48,2.42,6,9,78,48,78,204,17,2,3,76,0,125,18
8467346,2009,21.78,20.2,14,9,183,59,68,310,40,17,19,166,1,38,34
8467351,2009,17.87,17.14,30,17,180,51,66,297,59,12,21,168,698,30,52
8467353,2009,15.3,14.52,23,20,126,40,39,205,67,24,9,102,481,82,30
8467355,2009,0.85,0.83,0,0,15,3,4,22,0,0,0,15,2,29,0
8467357,2009,9.12,8.81,3,6,117,31,46,194,14,5,13,112,4,79,16
8467361,2009,6.99,6.94,5,5,63,22,32,117,18,8,1,55,435,95,20
8467365,2009,1.85,1.84,3,2,50,18,40,108,6,1,2,49,0,109,11
8467370,2009,21.69,20.56,15,13,212,83,81,376,53,25,11,187,679,209,47
8467371,2009,18.06,17.56,23,11,155,48,41,244,53,19,8,136,494,93,47
8467389,2009,25.67,24.85,42,24,283,140,145,568,89,23,22,260,580,16,54
8467393,2009,9.77,9.51,11,3,106,30,33,169,26,12,11,94,5,134,59
8467396,2009,11.44,10.72,4,1,81,37,29,147,16,11,13,70,4,94,17
8467400,2009,7.99,7.42,6,15,170,84,123,377,26,5,5,165,3,88,44
8467407,2009,32.74,31.39,7,11,237,88,84,409,46,28,19,209,7,36,36
8467408,2009,1.75,1.69,2,1,54,25,55,134,5,2,7,52,0,82,10
8467412,2009,23.14,22.16,19,10,184,86,53,323,50,21,5,163,12,146,18
8467422,2009,0,0,0,0,0,0,0,0,0,0,0,0,0,0,0
8467423,2009,14.78,14.15,11,12,123,51,56,230,36,13,12,110,621,35,50
8467428,2009,1.92,1.87,3,3,29,13,10,52,6,0,0,29,0,112,11
8467436,2009,1.39,1.35,1,0,27,5,16,48,2,1,3,26,0,19,7
8467439,2009,5.35,5.07,6,12,99,60,98,257,21,3,10,96,0,54,37
8467452,2009,1.05,1.02,6,5,38,20,19,77,11,0,5,38,0,69,23
8467463,2009,17.76,17.18,15,8,219,77,89,385,53,30,13,189,11,50,34
8467466,2009,13.28,12.82,8,8,159,61,78,298,27,11,8,148,2,124,40
8467478,2009,2.36,2.33,7,12,45,41,47,133,22,3,6,42,0,31,15
8467491,2009,6.75,6.5,2,5,72,21,25,118,9,2,4,70,225,35,31
8467493,2009,11.57,11.02,10,2,101,43,27,171,22,10,13,91,2,245,34
8467496,2009,7.02,6.78,15,13,85,46,55,186,34,6,8,79,0,47,34
8467502,2009,12.83,12.58,3,13,172,71,69,312,27,11,14,161,5,117,22
8467514,2009,20.17,19.5,26,17,203,71,95,369,70,27,9,176,590,89,132
8467519,2009,2.58,2.47,6,5,51,29,54,134,13,2,5,49,0,50,17
8467543,2009,8.36,8.06,3,3,105,33,20,158,14,8,2,97,76,93,17
8467545,2009,19.41,18.54,10,5,191,57,78,326,33,18,10,173,2,109,30
8467579,2009,0.17,0.16,0,1,6,1,1,8,1,0,0,6,0,14,1
8467580,2009,2.69,2.65,3,10,63,35,50,148,16,3,1,60,0,27,3
8467583,2009,0.05,0.05,0,0,4,0,7,11,0,0,1,4,0,18,0
8467831,2009,7.99,7.62,6,4,71,27,15,113,19,9,3,62,294,43,27
8467844,2009,23.1,22.49,15,10,239,68,80,387,41,16,22,223,31,70,62
8467856,2009,9.12,8.8,17,17,134,69,106,309,42,8,10,126,0,39,24
8467875,2009,24.03,23.3,35,21,225,99,72,396,85,29,14,196,11,8,25
8467876,2009,23.53,22.35,46,37,166,42,54,262,112,29,13,137,756,13,44
8467878,2009,17.65,17.13,26,22,206,59,70,335,65,17,9,189,358,23,22
8467881,2009,12.11,11.92,6,5,121,51,34,206,23,12,8,109,0,115,21
8467882,2009,5.87,5.49,5,2,52,16,13,81,12,5,6,47,45,15,18
8467890,2009,1.89,1.87,7,8,73,31,59,163,17,2,3,71,0,70,32
8467899,2009,13.27,12.99,20,16,169,55,71,295,54,18,12,151,6,21,30
8467915,2009,1.7,1.7,4,5,54,23,42,119,11,2,3,52,0,128,8
8467917,2009,6.3,5.9,7,8,95,42,69,206,26,11,5,84,0,68,16
8467928,2009,0.3,0.29,1,1,5,4,4,13,2,0,0,5,0,4,4
8467931,2009,2.85,2.81,4,5,87,28,47,162,11,2,4,85,0,127,19
8467943,2009,23.99,21.3,9,10,216,78,70,364,44,25,16,191,12,35,28
8467964,2009,10.63,10.34,5,3,97,21,28,146,21,13,9,84,25,20,15
8467967,2009,13.21,12.87,10,7,112,36,46,194,32,15,9,97,408,65,40
8467977,2009,1.11,1.12,1,2,19,5,7,31,4,1,4,18,0,16,2
8467988,2009,24.51,23.12,9,17,172,46,31,249,47,21,11,151,38,178,35
8468001,2009,1.04,1,2,1,14,7,3,24,4,1,0,13,57,17,6
8468064,2009,14.63,14.17,18,10,168,47,61,276,49,21,15,147,24,48,54
8468083,2009,28.44,27.22,26,21,309,115,106,530,70,23,8,286,544,45,53
8468085,2009,20.6,20.1,13,6,266,58,73,397,43,24,15,242,2,17,29
8468086,2009,2.06,2.06,0,2,17,5,5,27,3,1,1,16,0,14,4
8468090,2009,0.54,0.51,1,2,14,14,23,51,4,1,1,13,0,87,5
8468095,2009,2.62,2.63,0,0,25,7,2,34,4,4,2,21,1,71,3
8468101,2009,0.77,0.77,0,1,24,8,8,40,3,2,0,22,0,19,19
8468113,2009,1.41,1.35,4,4,29,18,21,68,10,2,1,27,0,77,8
8468114,2009,2.8,2.67,5,8,85,45,72,202,17,4,2,81,0,233,24
8468121,2009,0.02,0.01,0,0,2,0,0,2,0,0,0,2,0,0,0
8468162,2009,7.33,6.93,3,1,54,30,25,109,13,9,3,45,301,84,30
8468172,2009,15.99,15.61,10,9,156,61,61,278,30,11,11,145,10,129,19
8468208,2009,13.93,13.56,16,5,134,67,48,249,34,13,10,121,31,42,62
8468213,2009,2.52,2.5,5,3,64,26,55,145,12,4,2,60,0,158,14
8468224,2009,11.84,11.41,12,8,139,44,51,234,31,11,12,128,4,145,17
8468252,2009,1.61,1.5,1,1,17,7,6,30,3,1,2,16,1,30,1
8468309,2009,10.95,10.41,23,15,186,90,137,413,49,11,10,175,0,77,76
8468427,2009,4.56,4.5,3,7,81,27,66,174,15,5,4,76,0,86,20
8468432,2009,16.86,16.38,15,7,124,46,36,206,38,16,10,108,472,32,38
8468434,2009,19.63,18.99,18,15,191,64,60,315,57,24,15,167,241,46,30
8468463,2009,4.61,4.63,3,2,43,10,9,62,10,5,2,38,3,39,10
8468478,2009,1.07,1.05,1,8,33,25,31,89,10,1,3,32,1,48,30
8468482,2009,37.74,35.92,26,17,280,116,120,516,82,39,33,241,14,79,38
8468483,2009,34.38,32.81,31,13,272,111,95,478,86,42,25,230,2,59,25
8468484,2009,0.83,0.83,0,6,24,9,22,55,8,2,0,22,0,39,5
8468485,2009,11.23,11.1,12,4,120,35,39,194,35,19,7,101,18,83,21
8468486,2009,17.79,17.39,18,12,171,66,51,288,44,14,12,157,1,138,27
8468493,2009,4.14,4,8,13,121,41,76,238,26,5,8,116,0,42,47
8468498,2009,2.45,2.37,12,11,61,27,36,124,25,2,4,59,0,254,11
8468500,2009,20.79,19.94,20,12,182,63,57,302,51,19,10,163,7,58,27
8468501,2009,3.91,3.84,3,7,69,34,59,162,14,4,4,65,0,153,17
8468502,2009,0.73,0.71,4,0,25,7,13,45,4,0,1,25,0,56,9
8468503,2009,0.09,0.1,0,0,4,2,3,9,0,0,0,4,26,5,1
8468504,2009,21.37,20.86,14,14,197,93,84,374,42,14,15,183,138,76,46
8468505,2009,18.5,17.95,9,5,145,49,43,237,36,22,13,123,193,250,25
8468506,2009,3.23,3.13,3,1,49,5,17,71,9,5,2,44,18,86,9
8468508,2009,13.66,13.4,10,9,140,53,42,235,29,10,7,130,4,34,18
8468509,2009,5.56,5.23,8,7,68,31,52,151,22,7,2,61,0,86,20
8468510,2009,1.62,1.64,1,0,18,2,7,27,2,1,2,17,33,27,6
8468513,2009,5.19,4.87,4,15,83,36,55,174,20,1,7,82,0,84,15
8468515,2009,6.41,6.33,4,1,69,20,20,109,8,3,3,66,3,143,7
8468517,2009,0.18,0.18,0,0,6,1,1,8,0,0,0,6,0,4,0
8468518,2009,8.44,8.46,8,3,95,30,36,161,21,10,5,85,52,72,27
8468520,2009,8.12,7.59,20,14,165,49,123,337,42,8,8,157,0,60,14
8468523,2009,1,0.93,2,0,8,5,1,14,3,1,0,7,3,14,1
8468526,2009,17.29,16.67,20,11,164,67,55,286,47,16,8,148,619,191,17
8468534,2009,0.77,0.77,1,0,19,8,4,31,2,1,1,18,0,38,1
8468535,2009,19.03,18.16,21,16,154,48,48,250,63,26,9,128,844,91,33
8468542,2009,1.53,1.51,5,4,21,11,19,51,11,2,2,19,0,23,10
8468568,2009,0.13,0.15,0,0,2,0,0,2,0,0,0,2,0,0,0
8468575,2009,9.64,9.6,9,9,119,53,42,214,28,10,10,109,365,57,36
8468577,2009,2.06,2.02,5,2,66,22,48,136,7,0,3,66,0,172,21
8468598,2009,9.32,8.76,10,20,131,64,102,297,45,15,7,116,0,37,40
8468611,2009,7.45,7.25,5,2,63,17,15,95,16,9,5,54,33,92,15
8468626,2009,0.34,0.35,0,0,6,2,1,9,1,1,0,5,0,33,0
8468635,2009,12.59,12.18,7,4,107,35,34,176,19,8,13,99,3,161,27
8468636,2009,1.89,1.87,5,8,59,29,58,146,15,2,6,57,0,183,25
8468639,2009,5.32,4.86,15,10,96,24,63,183,31,6,9,90,0,40,23
8468660,2009,1.22,1.23,0,1,21,5,9,35,2,1,0,20,0,108,7
8468674,2009,0.1,0.11,1,1,4,4,6,14,2,0,0,4,0,25,0
8468695,2009,16.3,15.53,22,12,174,58,50,282,53,19,20,155,452,62,20
8468700,2009,11.3,10.29,8,2,111,31,40,182,22,12,6,99,599,112,17
8468704,2009,15.74,15.09,20,2,175,74,93,342,42,20,10,155,35,87,19
8468707,2009,0.03,0.03,0,0,0,1,0,1,0,0,0,0,0,2,0
8468778,2009,5.58,5.29,1,1,43,27,9,79,6,4,2,39,1,119,9
8468786,2009,0.62,0.62,0,0,7,0,0,7,0,0,1,7,0,13,3
8468789,2009,7.35,6.98,8,1,96,33,38,167,15,6,4,90,30,33,9
8468846,2009,1.77,1.7,2,2,34,8,17,59,6,2,3,32,2,56,6
8468881,2009,0.23,0.24,0,0,4,1,0,5,0,0,0,4,5,4,0
8468887,2009,0.47,0.47,0,0,8,5,4,17,1,1,0,7,39,27,4
8468927,2009,5.52,5.32,4,14,134,38,69,241,23,5,5,129,0,54,20
8469120,2009,2.35,2.3,0,0,18,9,7,34,0,0,2,18,0,77,0
8469454,2009,27.47,25.73,28,16,290,117,155,562,85,41,19,249,7,30,34
8469455,2009,21.19,19.36,22,12,165,67,77,309,57,23,10,142,514,23,39
8469457,2009,22.15,21.31,18,14,180,73,66,319,60,28,13,152,813,43,63
8469459,2009,24.02,22.76,22,27,246,100,67,413,71,22,14,224,864,50,55
8469460,2009,1.33,1.29,2,2,35,24,45,104,4,0,1,35,0,85,7
8469462,2009,16.47,14.97,9,10,119,47,53,219,33,14,7,105,19,152,23
8469464,2009,5.63,5.52,7,1,64,20,26,110,11,3,3,61,0,75,15
8469465,2009,4.3,4.24,4,15,115,56,83,254,24,5,6,110,0,148,48
8469466,2009,6.87,6.73,10,5,57,18,22,97,22,7,6,50,1,5,8
8469467,2009,8.71,8.59,3,3,71,33,18,122,15,9,6,62,2,58,10
8469469,2009,24.09,23.23,20,12,221,64,45,330,55,23,19,198,366,106,35
8469470,2009,5.3,5.09,13,12,74,44,54,172,32,7,7,67,1,52,12
8469472,2009,1.6,1.54,2,9,32,18,28,78,12,1,1,31,0,163,12
8469473,2009,10.56,10.37,7,11,118,41,48,207,30,12,9,106,475,51,50
8469474,2009,11.29,11.05,9,5,101,36,38,175,29,15,2,86,10,74,61
8469476,2009,2.74,2.65,5,8,74,33,59,166,18,5,8,69,0,142,22
8469477,2009,1.56,1.54,1,1,42,11,24,77,3,1,3,41,0,33,9
8469480,2009,1.68,1.62,0,2,43,17,27,87,2,0,2,43,0,27,6
8469483,2009,8.67,8.6,6,5,90,32,40,162,16,5,3,85,637,115,30
8469485,2009,24.72,23.91,29,14,215,89,91,395,69,26,16,189,617,27,51
8469488,2009,1.16,1.17,2,0,24,22,22,68,4,2,1,22,0,60,18
8469490,2009,5.7,5.55,5,0,51,29,16,96,9,4,6,47,3,114,15
8469492,2009,7.72,7.42,11,15,147,57,95,299,32,6,7,141,1,82,18
8469500,2009,22.32,21.31,16,8,218,60,98,376,50,26,10,192,26,18,34
8469501,2009,5.54,5.25,7,2,63,17,18,98,13,4,4,59,16,103,32
8469506,2009,22.42,21.56,20,18,252,81,102,435,62,24,8,228,42,45,49
8469508,2009,9.63,9.63,13,5,109,33,38,180,29,11,10,98,701,66,39
8469509,2009,1.2,1.2,0,1,17,6,10,33,2,1,2,16,0,7,0
8469521,2009,21.19,20.45,26,19,216,67,96,379,70,25,19,191,791,51,46
8469531,2009,1.44,1.37,1,4,30,14,24,68,6,1,3,29,0,66,6
8469534,2009,2.47,2.44,3,3,36,23,26,85,10,4,2,32,0,70,16
8469542,2009,8.14,7.76,2,4,94,27,38,159,9,3,3,91,10,88,27
8469543,2009,4.04,4.08,3,4,42,25,15,82,16,9,0,33,1,127,8
8469544,2009,26.14,25.32,28,13,266,86,86,438,66,25,13,241,241,45,51
8469547,2009,6.45,6.54,7,3,101,51,29,181,16,6,4,95,2,72,13
8469555,2009,9.96,9.79,16,14,181,95,117,393,44,14,21,167,0,54,30
8469575,2009,2.57,2.51,1,4,73,27,39,139,7,2,4,71,0,150,25
8469581,2009,12.1,11.34,6,5,98,30,21,149,25,14,3,84,390,30,30
8469584,2009,0.58,0.56,0,0,7,0,1,8,1,1,1,6,10,4,0
8469598,2009,5.92,5.79,7,12,95,64,69,228,22,3,8,92,0,70,30
8469619,2009,5.8,5.36,12,16,153,51,91,295,32,4,16,149,0,166,24
8469622,2009,21.56,20.41,15,23,182,55,84,321,57,19,18,163,33,154,39
8469623,2009,6.62,6.33,15,22,116,50,84,250,43,6,11,110,0,80,32
8469626,2009,2.01,1.95,5,4,48,28,53,129,12,3,5,45,0,216,19
8469638,2009,21.58,20.53,22,13,158,64,61,283,65,30,7,128,136,55,40
8469639,2009,30.3,29.07,19,15,222,75,56,353,59,25,18,197,152,93,44
8469647,2009,3.2,3.08,1,3,26,10,8,44,4,0,0,26,0,83,6
8469664,2009,11.27,11.07,8,1,133,52,54,239,17,8,6,125,15,79,21
8469665,2009,3.14,3.01,5,5,68,36,48,152,13,3,4,65,0,62,25
8469666,2009,5.49,5.37,5,4,43,18,11,72,13,4,5,39,2,18,12
8469670,2009,8.46,8.25,4,0,84,30,30,144,11,7,7,77,0,22,20
8469672,2009,1.74,1.74,4,0,22,6,9,37,7,3,0,19,3,56,2
8469684,2009,1.84,1.73,4,2,48,24,30,102,7,1,3,47,0,88,6
8469685,2009,5.71,5.6,2,0,73,18,10,101,7,5,6,68,49,71,3
8469707,2009,3.48,3.37,3,2,38,7,13,58,8,3,2,35,4,15,9
8469755,2009,4.13,4.11,2,4,55,23,19,97,12,6,2,49,0,94,6
8469759,2009,12.15,11.67,13,9,119,46,34,199,30,8,6,111,588,95,16
8469760,2009,3.69,3.64,5,9,104,38,55,197,17,3,5,101,0,80,16
8469765,2009,9.52,9.11,6,15,123,65,84,272,34,13,7,110,0,57,18
8469770,2009,5.97,5.89,6,18,146,75,119,340,30,6,7,140,0,100,11
8469779,2009,0.3,0.3,1,3,4,1,3,8,5,1,0,3,31,2,5
8469798,2009,0.13,0.12,0,0,5,4,4,13,0,0,0,5,0,4,1
8469812,2009,12.9,12.52,9,8,136,44,37,217,28,11,13,125,2,115,27
8469820,2009,5.66,5.37,2,1,41,17,8,66,5,2,2,39,288,109,7
8469992,2009,1.83,1.82,8,1,60,23,37,120,9,0,4,60,0,89,10
8470004,2009,0.21,0.2,0,0,5,2,2,9,0,0,0,5,0,2,1
8470018,2009,7.62,7.54,4,6,112,35,30,177,13,3,8,109,141,34,18
8470039,2009,14.6,14.18,19,9,121,63,56,240,51,23,7,98,160,36,32
8470041,2009,21.48,20.97,24,10,251,66,92,409,66,32,16,219,11,119,41
8470047,2009,10.42,10.26,16,8,114,32,43,189,35,11,12,103,296,34,24
8470054,2009,4.87,4.76,10,10,90,44,55,189,28,8,6,82,0,156,18
8470058,2009,0.4,0.4,1,1,6,2,3,11,3,1,0,5,0,12,0
8470061,2009,2.94,2.87,3,1,57,22,31,110,6,2,1,55,0,36,5
8470063,2009,1.06,1.09,2,1,9,7,3,19,4,1,0,8,7,9,2
8470064,2009,0.02,0.02,0,0,1,2,0,3,0,0,0,1,0,11,3
8470065,2009,0.42,0.43,0,0,5,1,1,7,0,0,0,5,0,3,0
8470072,2009,16.35,15.8,4,5,128,44,35,207,22,13,10,115,68,73,26
8470085,2009,0.38,0.36,0,1,11,3,7,21,2,1,1,10,0,5,4
8470086,2009,0,0,1,0,0,0,0,0,1,0,0,0,0,1,0
8470101,2009,0.79,0.78,0,0,5,3,1,9,0,0,0,5,0,9,2
8470104,2009,5.83,5.53,14,12,98,42,67,207,31,5,8,93,0,55,33
8470105,2009,12.03,11.62,5,9,119,41,43,203,32,18,10,101,7,80,7
8470110,2009,6.24,6,8,7,107,46,55,208,21,6,5,101,0,36,23
8470120,2009,26.89,26.39,26,18,278,108,153,539,84,40,21,238,6,30,61
8470121,2009,1.79,1.73,3,4,57,44,51,152,9,2,3,55,0,238,4
8470123,2009,1,0.98,0,0,11,12,6,29,0,0,1,11,0,73,2
8470131,2009,0.14,0.15,0,0,1,1,2,4,1,1,0,0,1,4,0
8470136,2009,0.03,0.03,0,0,1,2,1,4,0,0,0,1,0,5,0
8470137,2009,8.06,7.71,24,16,161,81,117,359,46,6,13,155,0,66,57
8470144,2009,13.99,13.45,18,8,133,57,54,244,37,11,13,122,579,39,60
8470151,2009,8.46,8.35,16,10,130,74,91,295,29,3,4,127,0,73,24
8470153,2009,0,0,0,0,0,0,0,0,0,0,0,0,1,0,0
8470159,2009,3.13,3.05,3,3,40,9,13,62,10,4,4,36,125,18,11
8470162,2009,22.55,20.04,21,17,132,41,46,219,57,19,8,113,690,77,40
8470169,2009,8.28,7.86,6,9,84,32,24,140,17,2,6,82,158,158,11
8470170,2009,0.65,0.62,1,1,12,7,8,27,2,0,1,12,0,17,1
8470171,2009,3.65,3.49,4,1,49,16,22,87,7,2,3,47,68,77,7
8470176,2009,13,12.51,9,4,133,57,65,255,23,10,9,123,5,127,57
8470180,2009,8.96,8.87,2,6,91,45,47,183,19,11,5,80,127,117,35
8470187,2009,3.47,3.15,3,7,96,48,58,202,15,5,4,91,0,92,3
8470192,2009,2.42,2.33,5,7,45,33,35,113,16,4,1,41,0,102,10
8470203,2009,0.07,0.07,0,0,2,1,0,3,0,0,0,2,8,1,0
8470207,2009,5.27,5.04,4,0,66,18,23,107,14,10,5,56,1,31,8
8470222,2009,6.5,6.34,9,18,146,62,80,288,30,3,15,143,0,129,27
8470223,2009,0.29,0.28,0,0,7,1,0,8,1,1,0,6,9,9,0
8470225,2009,1.7,1.69,3,0,26,3,14,43,4,1,1,25,1,50,4
8470230,2009,11.82,11.72,3,7,120,31,31,182,20,10,6,110,4,80,25
8470232,2009,0.24,0.24,0,0,3,0,0,3,1,1,0,2,7,10,3
8470257,2009,14.08,13.69,12,11,189,60,87,336,47,24,15,165,30,45,24
8470268,2009,3.6,3.42,10,4,47,25,39,111,21,7,3,40,1,46,15
8470273,2009,8.35,7.63,13,12,173,76,133,382,38,13,6,160,0,54,35
8470274,2009,15.23,15.03,5,4,165,55,57,277,17,8,12,157,28,130,44
8470280,2009,7.3,7.1,4,5,68,21,24,113,16,7,5,61,0,51,12
8470281,2009,10.12,9.49,23,32,213,89,145,447,69,14,20,199,0,46,45
8470283,2009,0.05,0.06,0,0,3,0,0,3,0,0,0,3,4,4,0
8470289,2009,11.29,10.94,5,2,107,33,32,172,18,11,10,96,254,105,35
8470294,2009,0.25,0.26,0,0,5,0,1,6,0,0,0,5,0,18,1
8470299,2009,9.1,8.72,8,10,86,41,45,172,26,8,3,78,329,52,22
8470301,2009,0.05,0.04,0,0,1,0,0,1,0,0,0,1,1,1,0
8470302,2009,7.53,7.35,3,2,80,31,31,142,12,7,2,73,78,108,30
8470309,2009,8.5,8.16,14,18,151,69,78,298,39,7,9,144,0,89,19
8470310,2009,1.82,1.73,1,3,49,21,48,118,4,0,2,49,0,58,6
8470317,2009,0.08,0.08,0,0,1,2,2,5,0,0,0,1,0,10,0
8470318,2009,2.95,2.82,1,8,55,36,51,142,13,4,0,51,0,93,13
8470324,2009,2.75,2.63,5,2,52,42,47,141,10,3,4,49,0,85,20
8470329,2009,4.42,4.34,5,9,71,28,49,148,18,4,5,67,0,101,18
8470358,2009,25.09,24.06,20,12,209,62,54,325,67,35,13,174,14,97,68
8470366,2009,0,0,0,0,0,0,2,2,0,0,0,0,9,2,0
8470370,2009,0.58,0.57,0,0,7,2,1,10,0,0,1,7,0,3,1
8470383,2009,0.57,0.56,1,0,4,4,0,8,1,0,1,4,0,3,0
8470543,2009,12.79,11.54,13,5,128,43,38,209,31,13,7,115,6,106,13
8470575,2009,0.16,0.15,1,0,6,3,2,11,1,0,1,6,0,3,1
8470578,2009,3.08,3,5,6,56,23,39,118,15,4,3,52,0,178,42
8470580,2009,11.59,11.32,6,5,126,39,31,196,19,8,8,118,5,117,22
8470595,2009,36.73,35.46,25,16,274,108,119,501,70,29,28,245,479,74,45
8470596,2009,17.3,16.96,23,14,159,57,87,303,57,20,7,139,48,34,30
8470598,2009,28.47,26.76,15,10,182,85,49,316,53,28,19,154,2,46,34
8470599,2009,21.44,20.53,7,5,163,61,44,268,34,22,19,141,4,77,36
8470600,2009,6.59,6.27,15,18,125,54,103,282,37,4,9,121,0,55,38
8470601,2009,5.69,5.44,9,5,122,68,100,290,19,5,12,117,0,118,22
8470602,2009,11.52,11.13,13,7,225,123,197,545,32,12,11,213,0,194,27
8470603,2009,12.81,12.38,12,5,135,64,53,252,32,15,16,120,1,97,23
8470604,2009,36.69,35.22,12,16,319,141,125,585,61,33,25,286,688,60,43
8470606,2009,30.02,28.89,24,8,248,111,84,443,56,24,22,224,17,287,39
8470607,2009,5.98,5.76,13,13,132,56,105,293,30,4,11,128,0,208,24
8470608,2009,9.82,9.52,14,2,104,28,51,183,27,11,8,93,1,30,32
8470609,2009,10.96,10.58,8,3,95,31,29,155,22,11,5,84,7,105,16
8470610,2009,39.03,37.51,27,17,347,98,69,514,82,38,27,309,18,108,49
8470611,2009,14.67,14.01,10,8,145,53,54,252,39,21,9,124,1,40,39
8470612,2009,14.97,14.13,34,16,149,68,67,284,69,19,13,130,533,178,39
8470613,2009,6.43,6.17,7,10,104,47,61,212,20,3,6,101,0,97,17
8470614,2009,1.67,1.64,2,3,53,19,50,122,7,2,1,51,0,103,4
8470615,2009,5.78,5.59,3,4,60,16,22,98,14,7,5,53,104,34,18
8470616,2009,29.19,28.02,29,21,214,100,73,387,75,25,18,189,772,95,83
8470617,2009,29.64,28.7,21,10,237,97,125,459,62,31,22,206,696,145,42
8470619,2009,7.17,6.98,2,0,73,33,20,126,6,4,1,69,125,143,20
8470620,2009,8.36,7.83,5,2,55,15,19,89,14,7,5,48,0,47,7
8470621,2009,34.66,33.38,28,21,270,106,74,450,76,27,15,243,6,93,38
8470622,2009,8.67,8.65,5,5,120,48,42,210,22,12,4,108,4,128,20
8470623,2009,0.03,0.03,0,0,1,1,0,2,0,0,0,1,0,2,0
8470625,2009,3.48,3.32,5,1,25,15,16,56,6,0,6,25,7,54,14
8470626,2009,25.04,24.04,16,25,210,83,55,348,69,28,15,182,4,30,46
8470630,2009,2.74,2.67,5,5,67,41,52,160,11,1,3,66,0,101,31
8470631,2009,7.01,6.67,5,4,83,26,38,147,14,5,4,78,382,80,32
8470634,2009,0.44,0.43,1,1,17,8,12,37,2,0,2,17,0,69,2
8470636,2009,0.19,0.19,0,0,2,0,2,4,0,0,0,2,8,6,0
8470638,2009,19.05,18.61,23,10,184,80,62,326,52,19,6,165,778,51,55
8470640,2009,7.79,7.66,16,13,137,51,89,277,35,6,9,131,0,35,34
8470642,2009,14.08,13.55,14,13,222,140,125,487,43,16,7,206,0,165,34
8470644,2009,0.08,0.08,0,0,3,1,0,4,1,1,0,2,0,1,0
8470647,2009,8.59,8.43,5,3,120,42,37,199,15,7,8,113,18,82,31
8470649,2009,16.67,16.03,17,6,191,78,86,355,34,11,12,180,71,32,29
8470654,2009,9.29,9.19,5,2,101,40,37,178,14,7,6,94,208,164,25
8470655,2009,20.35,19.58,18,13,163,78,47,288,48,17,13,146,504,266,40
8470661,2009,4.29,4.14,2,5,49,16,15,80,11,4,3,45,2,158,9
8470662,2009,6.67,6.72,6,6,92,19,22,133,19,7,3,85,217,62,14
8470666,2009,10.35,10.28,6,4,105,30,30,165,22,12,7,93,1,194,24
8470667,2009,14.3,13.24,12,7,129,32,51,212,35,16,8,113,67,62,37
8470671,2009,0.1,0.1,0,0,0,1,0,1,0,0,0,0,0,2,0
8470672,2009,1.19,1.23,2,1,27,16,31,74,4,1,0,26,0,119,7
8470678,2009,3.1,2.97,3,8,71,32,42,145,15,4,4,67,0,70,17
8470680,2009,14.06,13.56,10,7,152,43,46,241,32,15,8,137,389,41,31
8470685,2009,0.39,0.38,2,0,15,7,15,37,2,0,1,15,0,11,4
8470687,2009,6.78,6.62,5,4,46,30,27,103,13,4,2,42,87,144,10
8470697,2009,0.4,0.4,0,1,4,2,0,6,1,0,0,4,9,4,2
8470699,2009,1.58,1.56,3,6,63,23,35,121,12,3,1,60,1,110,11
8470700,2009,5.23,5.03,5,1,58,22,13,93,11,5,7,53,7,83,3
8470705,2009,0.09,0.1,0,0,2,0,1,3,0,0,0,2,1,0,1
8470708,2009,0,0,0,0,0,0,0,0,0,0,0,0,0,1,0
8470713,2009,2.02,2,1,1,25,12,9,46,5,3,0,22,0,78,4
8470714,2009,0.02,0.02,0,0,2,1,1,4,0,0,0,2,0,2,1
8470719,2009,0.85,0.85,0,0,14,5,0,19,0,0,0,14,47,20,7
8470724,2009,7.48,7.25,8,15,139,66,106,311,29,6,9,133,0,115,47
8470729,2009,0.26,0.28,1,1,7,3,5,15,2,0,0,7,0,8,1
8470735,2009,0.11,0.1,0,0,2,0,1,3,0,0,0,2,4,2,0
8470740,2009,25.3,24.28,13,7,212,81,93,386,48,28,10,184,17,87,49
8470741,2009,11.05,10.7,13,5,96,50,49,195,32,14,10,82,0,66,14
8470750,2009,8.1,7.62,6,11,90,43,44,177,23,6,3,84,244,87,20
8470755,2009,13.02,12.69,9,7,148,52,50,250,27,11,11,137,188,125,31
8470760,2009,1.51,1.46,2,4,42,27,23,92,8,2,2,40,0,146,14
8470774,2009,4.26,4.06,7,7,83,43,68,194,17,3,7,80,0,63,41
8470775,2009,9.43,8.95,6,2,90,38,24,152,10,2,7,88,323,116,31
8470777,2009,0.19,0.21,0,0,4,1,1,6,0,0,0,4,1,2,0
8470778,2009,11.72,11.18,2,7,103,28,28,159,19,10,4,93,14,104,23
8470780,2009,0.11,0.11,0,1,5,1,5,11,1,0,0,5,0,6,3
8470794,2009,23.59,22.72,19,7,227,79,78,384,51,25,23,202,469,57,41
8470798,2009,0.83,0.79,1,1,16,4,10,30,4,2,1,14,0,7,10
8470803,2009,14.25,13.69,18,5,140,55,49,244,32,9,12,131,484,69,48
8470804,2009,0.65,0.63,1,9,31,17,25,73,10,0,3,31,1,54,5
8470816,2009,0.92,0.81,0,1,6,0,2,8,2,1,1,5,1,31,1
8470828,2009,6.58,6.3,22,22,109,38,92,239,50,6,11,103,0,20,36
8470834,2009,20.16,19.85,7,10,211,79,60,350,34,17,11,194,1,215,48
8470839,2009,1.91,1.89,0,6,37,21,42,100,8,2,4,35,0,112,10
8470852,2009,24.01,23.31,12,5,206,60,80,346,47,30,15,176,3,108,54
8470854,2009,4.46,4.4,5,2,52,18,17,87,11,4,2,48,3,165,10
8470867,2009,5.19,5.2,1,1,58,29,16,103,7,5,3,53,0,62,8
8470876,2009,1.78,1.74,2,0,19,7,7,33,3,1,2,18,0,77,4
8470877,2009,4.89,4.89,5,1,39,11,9,59,16,10,2,29,2,29,12
8470886,2009,0.17,0.15,1,1,5,2,2,9,2,0,1,5,0,5,3
8470896,2009,0.48,0.49,1,0,3,3,1,7,1,0,0,3,0,12,1
8470899,2009,0.04,0.03,0,0,2,0,1,3,0,0,0,2,0,5,0
8470905,2009,3.51,3.4,7,9,54,27,42,123,21,5,4,49,0,42,10
8470920,2009,11.65,11.45,7,6,106,41,32,179,24,11,3,95,6,99,11
8470966,2009,5.77,5.59,10,9,111,55,91,257,30,11,8,100,0,153,33
8470970,2009,0.46,0.43,0,0,5,2,2,9,0,0,0,5,1,3,0
8470988,2009,1.45,1.43,4,6,24,8,24,56,11,1,3,23,0,24,7
8470996,2009,0.61,0.6,0,2,14,6,13,33,4,2,0,12,0,6,4
8471185,2009,11.84,11.83,10,8,117,48,45,210,33,15,7,102,9,78,50
8471187,2009,3,2.99,5,2,61,35,41,137,8,1,1,60,0,39,5
8471188,2009,0.01,0.01,0,0,1,0,4,5,0,0,0,1,0,0,0
8471208,2009,30.19,29.15,17,14,203,83,67,353,63,32,17,171,201,55,51
8471214,2009,37.86,37.15,37,22,368,172,282,822,109,50,33,318,10,185,66
8471215,2009,27.88,26.34,31,17,265,97,95,457,75,27,22,238,199,58,56
8471216,2009,4.68,4.58,7,9,105,39,76,220,21,5,4,100,0,75,3
8471217,2009,14.83,14.52,9,12,148,54,50,252,38,17,9,131,5,104,35
8471218,2009,17.55,17.24,14,6,159,63,64,286,38,18,9,141,13,70,19
8471220,2009,17.69,17.09,11,4,178,58,39,275,29,14,10,164,2,81,48
8471221,2009,1.43,1.28,0,0,12,1,1,14,0,0,6,12,0,18,2
8471222,2009,1,0.99,2,6,36,9,19,64,9,1,3,35,0,80,16
8471223,2009,0.62,0.6,0,2,22,5,17,44,2,0,2,22,0,15,5
8471226,2009,16.03,15.44,15,5,181,51,47,279,34,14,16,167,41,59,21
8471229,2009,7.46,7.36,6,2,88,18,28,134,13,5,6,83,200,80,15
8471231,2009,6.1,5.87,4,2,54,18,19,91,12,6,3,48,378,63,23
8471232,2009,8.7,8.64,1,5,68,36,38,142,11,5,2,63,14,92,18
8471233,2009,20.9,20.33,22,20,210,61,57,328,67,25,13,185,726,64,51
8471234,2009,22.9,21.43,24,18,196,65,64,325,65,23,23,173,16,33,39
8471236,2009,7.14,6.42,8,3,145,55,79,279,17,6,9,139,0,112,26
8471238,2009,8.7,8.34,9,9,74,24,35,133,25,7,9,67,183,18,37
8471240,2009,1.46,1.42,5,15,43,17,44,104,23,3,2,40,0,66,13
8471241,2009,1.35,1.31,1,7,45,21,29,95,9,1,1,44,0,170,8
8471242,2009,14.45,13.92,30,27,205,103,150,458,76,19,13,186,0,133,44
8471245,2009,5.64,5.4,6,4,53,12,21,86,16,6,1,47,274,33,27
8471246,2009,1.42,1.32,2,1,20,8,8,36,3,0,1,20,0,25,4
8471254,2009,1.52,1.53,1,0,20,7,5,32,4,3,1,17,0,22,4
8471260,2009,12.03,11.74,13,5,134,30,50,214,35,17,7,117,10,108,39
8471261,2009,0.55,0.52,0,0,3,1,0,4,1,1,1,2,0,4,0
8471263,2009,7.28,7.11,3,5,91,43,42,176,14,6,9,85,2,56,25
8471265,2009,0.07,0.07,0,0,2,1,1,4,0,0,0,2,0,6,1
8471266,2009,8.95,8.67,2,6,95,38,29,162,16,8,6,87,2,50,11
8471268,2009,3.85,3.69,3,1,55,11,14,80,6,2,4,53,1,99,7
8471269,2009,1.55,1.49,3,4,58,23,27,108,7,0,3,58,0,150,12
8471273,2009,16.67,15.87,18,6,165,55,71,291,44,20,12,145,347,129,37
8471274,2009,6.01,5.67,13,15,96,44,91,231,36,8,9,88,0,48,12
8471276,2009,17.67,17.16,22,13,156,44,55,255,52,17,12,139,560,82,31
8471279,2009,3.02,2.99,6,4,68,20,48,136,11,1,4,67,1,62,21
8471280,2009,0.94,0.87,1,0,7,1,2,10,2,1,0,6,1,5,1
8471282,2009,0,0,0,0,0,0,1,1,0,0,0,0,0,4,0
8471283,2009,4.88,4.68,6,3,44,18,14,76,14,5,2,39,13,71,11
8471284,2009,2.36,2.31,3,4,59,15,43,117,11,4,3,55,0,43,12
8471290,2009,0,0,0,0,0,0,1,1,0,0,0,0,0,0,1
8471299,2009,15.79,15.22,9,7,135,46,40,221,29,13,5,122,240,68,50
8471303,2009,7.86,7.73,19,18,161,83,115,359,42,5,7,156,0,84,14
8471309,2009,9.61,9.29,4,7,91,28,30,149,21,10,4,81,15,46,13
8471310,2009,11.68,11.48,8,5,112,32,27,171,24,11,6,101,244,81,37
8471311,2009,13.14,12.99,11,1,171,61,70,302,25,13,15,158,27,66,14
8471312,2009,0.01,0.01,0,0,0,1,0,1,0,0,0,0,0,2,0
8471314,2009,2.02,1.93,3,7,42,19,27,88,13,3,3,39,0,20,17
8471321,2009,1.21,1.17,3,7,42,24,42,108,12,2,4,40,0,77,6
8471323,2009,7.87,7.47,3,1,62,21,24,107,12,8,7,54,0,71,16
8471324,2009,0.88,0.92,2,0,11,1,2,14,2,0,2,11,0,24,2
8471327,2009,0.06,0.06,0,0,1,1,0,2,0,0,1,1,0,1,0
8471331,2009,1.74,1.71,1,0,21,9,10,40,3,2,1,19,18,14,9
8471336,2009,0.86,0.86,1,0,8,7,4,19,3,2,0,6,1,13,1
8471338,2009,4.46,4.41,5,4,58,19,23,100,11,2,3,56,88,58,21
8471339,2009,23.41,22.38,11,7,204,90,74,368,37,19,13,185,17,285,52
8471346,2009,20.94,20.44,15,9,184,41,69,294,44,20,6,164,77,35,61
8471352,2009,0.29,0.31,1,0,4,0,0,4,2,1,0,3,2,5,1
8471362,2009,14.39,13.92,16,9,126,47,66,239,35,10,7,116,366,26,30
8471365,2009,0.24,0.23,0,0,3,1,0,4,0,0,0,3,2,1,2
8471371,2009,7.24,7.22,1,0,82,34,17,133,7,6,5,76,0,124,9
8471372,2009,0,0,0,0,0,0,1,1,0,0,0,0,2,0,0
8471385,2009,1.02,0.98,4,3,40,21,38,99,9,2,1,38,0,54,16
8471386,2009,5.87,5.81,9,4,78,18,26,122,24,11,4,67,6,53,13
8471388,2009,6.33,6.31,4,1,64,24,22,110,15,10,4,54,0,148,10
8471390,2009,3.13,3.08,0,1,36,11,12,59,3,2,2,34,48,9,9
8471392,2009,3.37,3.26,8,9,73,37,41,151,21,4,7,69,0,138,20
8471396,2009,0.02,0.02,0,0,1,0,2,3,0,0,0,1,0,1,0
8471399,2009,3.08,2.98,0,0,29,20,12,61,6,6,4,23,0,56,6
8471409,2009,0,0,0,0,0,0,0,0,0,0,0,0,0,0,0
8471411,2009,0.17,0.18,0,0,2,1,0,3,0,0,0,2,0,2,1
8471419,2009,1.44,1.2,1,0,19,6,6,31,2,1,0,18,0,8,0
8471426,2009,14.74,14.23,10,8,116,46,39,201,40,22,6,94,5,189,37
8471428,2009,0.74,0.71,1,1,9,7,6,22,2,0,0,9,1,46,0
8471429,2009,0.28,0.27,0,1,1,0,0,1,1,0,0,1,0,1,0
8471436,2009,3.64,3.58,2,6,60,26,61,147,14,6,1,54,0,65,8
8471450,2009,8.21,8.08,7,1,65,24,22,111,19,11,5,54,0,43,11
8471451,2009,0.27,0.25,0,0,2,2,0,4,0,0,0,2,8,4,2
8471457,2009,0.52,0.51,0,0,4,0,1,5,0,0,0,4,0,4,0
8471476,2009,6.69,6.56,7,8,83,28,26,137,19,4,1,79,50,104,30
8471482,2009,0.24,0.23,1,1,7,4,11,22,3,1,0,6,0,30,0
8471483,2009,0.12,0.13,1,1,1,2,3,6,2,0,0,1,4,1,0
8471498,2009,5.63,5.6,1,5,67,23,21,111,15,9,4,58,6,48,20
8471504,2009,21.6,21.25,20,11,215,89,84,388,58,27,12,188,8,91,47
8471514,2009,18.6,17.8,20,13,166,51,48,265,55,22,9,144,647,23,62
8471521,2009,2.67,2.7,1,2,24,9,9,42,6,3,2,21,0,65,3
8471628,2009,3.95,3.85,4,0,61,19,16,96,8,4,2,57,66,92,11
8471634,2009,8.8,8.45,7,4,109,33,47,189,16,5,15,104,19,36,37
8471636,2009,0.48,0.47,0,1,7,2,3,12,1,0,0,7,34,15,3
8471657,2009,10.84,10.49,8,3,117,33,30,180,18,7,10,110,4,197,18
8471663,2009,4.13,4.02,1,1,40,5,9,54,4,2,4,38,29,83,3
8471664,2009,22.21,21.72,18,10,217,72,58,347,53,25,6,192,8,64,44
8471668,2009,0.27,0.27,0,0,9,0,3,12,0,0,0,9,0,7,2
8471669,2009,24.97,24.06,39,20,199,60,60,319,79,20,26,179,851,42,59
8471670,2009,18.79,18.35,13,0,160,75,68,303,40,27,14,133,1,157,33
8471671,2009,0.17,0.17,2,2,7,3,10,20,4,0,0,7,0,23,7
8471675,2009,31.2,30.58,36,22,291,102,97,490,109,51,19,240,993,62,43
8471676,2009,30.17,28.98,18,11,258,106,101,465,64,35,21,223,41,127,41
8471677,2009,6.57,6.41,12,16,130,82,111,323,36,8,9,122,0,144,12
8471678,2009,12.3,12.09,8,3,111,39,30,180,28,17,10,94,5,61,21
8471680,2009,14.02,13.5,10,10,121,37,37,195,37,17,11,104,144,115,25
8471681,2009,0.79,0.73,0,1,9,2,2,13,2,1,0,8,0,12,2
8471682,2009,17.77,16.97,8,8,164,72,76,312,36,20,10,144,3,124,18
8471683,2009,0.6,0.58,0,1,22,12,25,59,3,2,0,20,0,33,2
8471685,2009,26.77,25.72,22,25,259,110,84,453,81,34,18,225,602,80,36
8471686,2009,4.62,4.62,5,14,78,34,63,175,27,8,5,70,0,178,45
8471689,2009,0.1,0.1,1,0,2,1,2,5,1,0,0,2,7,5,1
8471691,2009,14.33,14.13,10,12,148,60,54,262,33,11,6,137,559,175,29
8471692,2009,1.42,1.31,1,1,27,15,27,69,3,1,2,26,0,46,10
8471693,2009,0.07,0.06,0,0,1,2,0,3,0,0,0,1,0,0,1
8471694,2009,0.99,0.85,2,0,10,5,3,18,3,1,1,9,0,40,3
8471696,2009,0.04,0.03,0,0,2,0,0,2,0,0,0,2,0,3,0
8471697,2009,17.61,17.33,13,10,217,41,42,300,44,21,12,196,9,18,35
8471698,2009,16.44,16.23,18,12,158,91,71,320,48,18,17,140,64,149,61
8471699,2009,15,14.4,10,8,139,47,53,239,28,10,11,129,163,80,32
8471702,2009,4.66,4.52,4,8,110,56,93,259,15,3,6,107,0,111,21
8471703,2009,15.2,14.42,13,11,116,43,26,185,46,22,10,94,17,140,31
8471704,2009,0.03,0.03,0,0,1,1,1,3,0,0,0,1,0,3,0
8471705,2009,0.66,0.64,1,1,21,11,15,47,2,0,0,21,0,28,2
8471707,2009,22.42,21.3,18,10,198,74,71,343,55,27,7,171,19,173,57
8471708,2009,2.63,2.55,0,1,26,4,5,35,3,2,3,24,0,13,4
8471709,2009,3.77,3.75,5,8,74,56,55,185,16,3,6,71,0,52,13
8471710,2009,1.34,1.3,2,1,35,14,24,73,3,0,1,35,0,36,10
8471711,2009,0,0,0,0,0,0,0,0,0,0,0,0,0,1,1
8471713,2009,0,0,0,0,0,0,0,0,0,0,0,0,0,4,0
8471716,2009,6.91,6.65,3,0,79,37,25,141,6,3,4,76,148,152,7
8471717,2009,0.29,0.28,0,0,10,9,7,26,1,1,0,9,0,29,2
8471718,2009,0,0,0,0,0,0,0,0,0,0,0,0,4,1,0
8471724,2009,8.51,8.4,11,13,172,95,103,370,27,3,11,169,0,116,28
8471729,2009,4.82,4.76,6,9,107,39,59,205,22,7,8,100,0,97,20
8471733,2009,0.34,0.33,1,1,7,1,1,9,2,0,0,7,2,23,1
8471735,2009,9.03,8.78,14,15,145,88,107,340,41,12,7,133,0,36,23
8471736,2009,0.15,0.15,0,0,1,0,0,1,0,0,0,1,0,1,0
8471738,2009,0,0,0,0,0,0,0,0,0,0,0,0,2,0,0
8471741,2009,0.11,0.1,0,0,5,2,2,9,0,0,0,5,0,6,1
8471742,2009,3.6,3.54,9,6,90,58,72,220,21,6,9,84,0,55,19
8471743,2009,5.62,5.55,5,1,67,23,21,111,10,4,0,63,196,136,9
8471747,2009,0.01,0.01,0,0,1,0,1,2,0,0,0,1,0,0,0
8471748,2009,1.21,1.11,2,1,24,22,22,68,6,3,3,21,0,118,2
8471753,2009,0.9,0.87,2,0,13,2,3,18,3,1,1,12,6,2,2
8471756,2009,1.77,1.72,4,4,26,21,30,77,9,1,5,25,0,44,5
8471761,2009,2.63,2.56,8,12,61,36,64,161,21,1,3,60,0,50,10
8471764,2009,0.45,0.45,0,0,8,1,4,13,1,1,1,7,4,21,1
8471766,2009,3.19,3.12,1,2,52,18,12,82,7,4,2,48,0,121,10
8471767,2009,1.74,1.72,0,0,26,9,2,37,0,0,3,26,15,22,9
8471768,2009,5.17,4.9,1,2,48,11,12,71,5,2,3,46,21,27,11
8471769,2009,1.89,1.87,8,7,62,41,67,170,17,2,9,60,0,59,29
8471794,2009,15.04,14.72,6,7,165,58,61,284,24,11,10,154,447,188,39
8471804,2009,2.25,2.31,2,1,29,7,9,45,5,2,2,27,1,5,2
8471807,2009,6.74,6.55,7,3,83,31,45,159,15,5,9,78,212,43,29
8471810,2009,0.75,0.74,0,3,19,9,18,46,3,0,2,19,0,9,4
8471811,2009,3.26,3.2,3,6,23,7,8,38,11,2,1,21,133,2,17
8471829,2009,0.67,0.61,0,1,5,0,2,7,2,1,1,4,1,15,4
8471840,2009,0.52,0.53,0,0,9,2,3,14,0,0,0,9,1,9,1
8471842,2009,10.98,10.73,11,5,98,32,30,160,26,10,5,88,133,87,30
8471851,2009,3.23,3.19,0,2,54,15,28,97,4,2,5,52,7,33,19
8471859,2009,5.71,5.79,9,3,60,23,31,114,19,7,6,53,1,31,22
8471863,2009,0.01,0.01,0,0,1,0,0,1,0,0,0,1,9,0,0
8471873,2009,6.6,6.3,7,21,121,36,74,231,34,6,4,115,0,63,16
8471879,2009,3.96,3.93,7,6,74,34,43,151,20,7,7,67,0,47,51
8471887,2009,28.14,26.96,10,11,275,73,64,412,51,30,17,245,5,69,33
8471895,2009,0.17,0.17,2,0,3,1,3,7,2,0,0,3,0,6,1
8471941,2009,0.92,0.93,0,0,6,3,2,11,0,0,0,6,0,22,0
8471958,2009,3.28,3.17,8,10,108,38,81,227,24,6,8,102,0,178,37
8471972,2009,0.35,0.35,0,0,5,1,2,8,0,0,0,5,0,3,2
8471976,2009,0.48,0.47,1,0,2,3,3,8,1,0,0,2,16,2,1
8471978,2009,0.87,0.85,0,3,25,18,17,60,3,0,2,25,0,127,5
8472215,2009,1.98,1.93,1,1,20,4,6,30,5,3,3,17,25,13,1
8472248,2009,0.47,0.46,0,0,4,1,2,7,0,0,0,4,6,4,4
8472262,2009,0.04,0.04,0,0,0,1,0,1,0,0,0,0,0,4,0
8472263,2009,2.54,2.53,2,2,27,7,12,46,8,4,1,23,21,56,9
8472338,2009,0.32,0.31,0,0,9,3,5,17,0,0,0,9,0,19,5
8472355,2009,4.08,4.1,6,2,74,13,12,99,10,2,7,72,98,95,7
8472368,2009,0.74,0.75,1,0,11,3,6,20,3,2,0,9,0,6,2
8472370,2009,1.7,1.69,1,5,42,20,28,90,8,2,0,40,0,44,11
8472379,2009,1.39,1.44,0,0,6,4,4,14,2,2,1,4,22,1,3
8472382,2009,4.83,4.75,14,17,86,55,67,208,37,6,5,80,0,55,34
8472394,2009,1.7,1.76,0,2,23,13,10,46,3,1,1,22,2,22,6
8473385,2009,0.66,0.62,0,3,12,3,7,22,4,1,1,11,0,8,0
8473412,2009,18.97,18.39,17,4,165,49,59,273,34,13,12,152,68,45,51
8473419,2009,2.49,2.42,1,0,32,10,7,49,1,0,0,32,3,20,8
8473422,2009,9.85,9.69,12,5,83,39,26,148,26,9,4,74,17,78,36
8473432,2009,4.35,4.06,5,5,57,15,18,90,14,4,4,53,9,97,5
8473438,2009,0.1,0.09,0,0,2,1,1,4,0,0,0,2,0,3,0
8473446,2009,8.73,8.48,12,17,186,67,130,383,39,10,14,176,0,70,44
8473449,2009,25.39,24.01,15,18,246,98,113,457,51,18,22,228,33,62,78
8473453,2009,0.13,0.12,0,0,4,1,1,6,0,0,0,4,0,8,0
8473459,2009,0.09,0.09,1,1,5,1,1,7,2,0,0,5,0,9,0
8473465,2009,7.39,7.28,1,2,76,32,22,130,13,10,4,66,7,89,18
8473466,2009,0.84,0.78,1,1,5,8,9,22,2,0,1,5,7,47,4
8473473,2009,7.43,7.38,5,6,72,30,17,119,20,9,1,63,3,141,12
8473482,2009,2.59,2.52,1,4,17,15,14,46,6,1,1,16,2,10,5
8473484,2009,0.06,0.06,0,0,2,0,0,2,0,0,0,2,0,2,1
8473485,2009,22.16,21.19,23,13,221,64,58,343,64,28,24,193,3,100,26
8473488,2009,0.48,0.47,0,0,4,2,5,11,0,0,0,4,1,1,3
8473491,2009,0.19,0.19,1,1,4,1,2,7,2,0,0,4,0,11,0
8473492,2009,8.36,8.2,5,2,123,40,35,198,18,11,4,112,8,94,10
8473493,2009,0.54,0.52,0,0,6,5,2,13,0,0,1,6,8,4,1
8473496,2009,0.14,0.14,0,0,1,1,1,3,0,0,0,1,0,1,0
8473504,2009,11.47,11.17,5,3,136,59,51,246,21,13,12,123,3,318,14
8473510,2009,0.41,0.39,1,1,7,2,1,10,2,0,1,7,0,2,0
8473512,2009,18.08,17.59,22,9,145,64,51,260,47,16,12,129,297,76,49
8473514,2009,2.05,1.79,0,0,13,5,4,22,1,1,2,12,0,10,6
8473525,2009,0.38,0.38,1,0,9,4,4,17,1,0,0,9,0,48,1
8473526,2009,11.5,10.78,14,10,124,44,61,229,37,13,10,111,18,39,28
8473533,2009,24.23,23.3,19,9,194,62,70,326,49,21,20,173,633,117,41
8473534,2009,14.18,13.81,6,7,129,51,49,229,26,13,8,116,220,70,26
8473536,2009,5.82,5.85,2,2,64,32,22,118,6,2,5,62,155,87,21
8473537,2009,13.93,12,2,3,117,52,28,197,14,9,9,108,3,64,23
8473542,2009,0,0,0,0,0,0,0,0,0,0,0,0,0,3,0
8473544,2009,12.44,12,20,6,125,30,72,227,35,9,12,116,205,96,21
8473546,2009,7.5,7.29,3,3,63,22,14,99,11,5,4,58,1,9,13
8473548,2009,28.84,27.1,19,6,297,102,149,548,55,30,16,267,59,13,30
8473550,2009,0.04,0.04,0,0,0,2,3,5,0,0,0,0,0,2,1
8473562,2009,0.12,0.12,0,0,3,1,1,5,0,0,0,3,0,4,0
8473563,2009,24.27,23.29,42,26,222,77,65,364,101,33,14,189,667,90,54
8473564,2009,17.44,17.09,7,15,219,63,87,369,43,21,8,198,13,72,41
8473568,2009,0.25,0.23,0,1,2,1,8,11,1,0,0,2,0,8,3
8473571,2009,1.15,1.05,3,4,29,9,22,60,10,3,1,26,0,6,8
8473573,2009,11.95,11.71,7,9,124,49,67,240,28,12,5,112,310,45,28
8473574,2009,7.15,6.68,3,6,67,30,18,115,16,7,5,60,119,57,18
8473579,2009,18.33,17.34,13,7,145,61,60,266,36,16,6,129,27,136,52
8473580,2009,0.21,0.21,0,0,6,3,7,16,0,0,0,6,0,11,2
8473582,2009,0.05,0.05,0,0,4,1,1,6,0,0,0,4,0,0,1
8473584,2009,2.16,1.82,3,3,43,27,29,99,7,1,2,42,0,36,39
8473592,2009,3.6,3.53,5,5,54,32,14,100,10,0,2,54,1,22,9
8473600,2009,3.42,3.06,1,2,42,13,11,66,5,2,3,40,3,17,11
8473604,2009,29.66,28.78,30,13,202,55,40,297,68,25,13,177,801,56,69
8473610,2009,0.23,0.24,0,0,5,5,3,13,0,0,0,5,0,3,1
8473618,2009,2.81,2.73,4,1,27,7,4,38,9,4,0,23,95,7,15
8473646,2009,2.8,2.82,4,1,38,15,9,62,9,4,3,34,116,51,3
8473673,2009,1.09,1.06,4,0,19,10,14,43,5,1,1,18,0,10,2
8473682,2009,6.92,6.83,4,2,72,33,28,133,15,9,4,63,274,43,17
8473687,2009,0.24,0.25,0,0,1,2,0,3,0,0,0,1,4,3,0
8473700,2009,2.39,2.27,4,14,46,18,31,95,21,3,6,43,0,86,20
8473712,2009,1.61,1.61,4,1,13,5,1,19,6,1,1,12,0,27,2
8473722,2009,1.73,1.55,1,0,22,9,22,53,2,1,3,21,0,62,1
8473734,2009,0,0,0,0,0,0,0,0,0,0,0,0,0,3,0
8473898,2009,8.78,8.55,1,1,83,26,19,128,7,5,3,78,186,45,24
8473914,2009,1.27,1.24,0,0,9,8,7,24,1,1,2,8,41,12,1
8473924,2009,0.46,0.45,1,0,9,3,7,19,3,2,1,7,0,3,0
8473932,2009,10.53,10.26,5,1,103,39,33,175,15,9,5,94,95,183,28
8473933,2009,0.29,0.3,1,2,14,5,9,28,3,0,2,14,0,14,2
8473953,2009,0.13,0.13,0,0,4,1,2,7,0,0,0,4,0,2,0
8473962,2009,9.97,9.58,4,5,101,38,63,202,15,6,5,95,2,39,28
8473991,2009,0.52,0.52,3,2,16,9,13,38,5,0,0,16,0,15,6
8473992,2009,0.01,0.01,0,0,1,0,1,2,0,0,0,1,0,4,0
8473994,2009,19.29,18.25,7,11,180,65,66,311,40,22,13,158,109,184,69
8473997,2009,4.66,3.87,3,3,36,12,15,63,8,2,4,34,10,29,8
8473999,2009,1,0.96,0,1,10,1,7,18,1,0,0,10,1,8,2
8474001,2009,14.27,13.82,13,11,120,64,42,226,39,15,9,105,165,87,59
8474009,2009,1.69,1.62,1,0,14,4,3,21,2,1,2,13,34,4,4
8474025,2009,0.35,0.37,0,0,3,0,3,6,0,0,0,3,0,3,0
8474037,2009,18.97,18.45,11,9,173,55,54,282,35,15,13,158,0,37,29
8474040,2009,17,16.12,13,13,170,63,48,281,41,15,7,155,336,30,14
8474042,2009,0.62,0.61,0,0,6,0,2,8,1,1,0,5,18,7,0
8474045,2009,0.06,0.05,0,1,1,1,0,2,1,0,0,1,1,0,0
8474046,2009,0.15,0.15,0,1,4,3,1,8,1,0,0,4,0,7,1
8474053,2009,4.09,4.02,3,1,42,15,12,69,9,5,4,37,75,14,15
8474056,2009,0.18,0.18,0,2,4,3,2,9,2,0,1,4,0,1,2
8474091,2009,19.29,18.4,18,1,168,51,42,261,40,21,15,147,489,55,61
8474094,2009,1.68,1.65,1,0,22,5,6,33,2,1,1,21,1,10,4
8474096,2009,1.73,1.67,3,0,26,15,8,49,3,0,1,26,39,13,11
8474102,2009,20.69,20.11,20,7,166,53,56,275,47,20,9,146,8,78,35
8474114,2009,3.69,3.72,2,1,42,15,14,71,7,4,3,38,32,37,1
8474125,2009,1.98,1.91,3,9,45,19,44,108,15,3,3,42,0,46,8
8474134,2009,0.09,0.09,0,0,2,3,10,15,0,0,0,2,0,1,4
8474137,2009,2.32,2.19,0,0,17,7,10,34,2,2,0,15,0,13,0
8474138,2009,0,0,0,0,0,0,0,0,0,0,0,0,0,1,0
8474141,2009,27.6,27.17,33,25,261,106,107,474,88,30,17,231,9,17,51
8474149,2009,0.23,0.21,0,0,4,1,2,7,0,0,1,4,0,3,3
8474150,2009,4.11,3.91,4,5,47,25,19,91,10,1,2,46,102,12,11
8474153,2009,2.16,2.11,1,1,23,5,7,35,5,3,2,20,1,28,10
8474154,2009,1.65,1.6,0,2,30,12,7,49,3,1,2,29,3,42,6
8474157,2009,6.65,6.45,1,10,74,39,40,153,14,3,3,71,1,68,20
8474161,2009,12.13,11.93,21,13,151,50,67,268,49,15,7,136,2,62,21
8474166,2009,0.34,0.31,0,0,6,2,1,9,0,0,0,6,0,6,1
8474177,2009,0.5,0.48,2,0,9,2,5,16,2,0,0,9,11,11,2
8474184,2009,0.11,0.12,0,0,5,5,8,18,0,0,0,5,0,12,2
8474189,2009,0.66,0.64,0,0,8,5,1,14,2,2,0,6,9,8,1
8474190,2009,13.16,12.69,13,11,127,55,57,239,40,16,10,111,3,126,33
8474195,2009,0.62,0.64,0,0,4,1,0,5,0,0,0,4,0,10,1
8474218,2009,3.11,3.01,9,8,52,27,36,115,21,4,5,48,0,42,14
8474220,2009,0.97,0.94,2,0,17,3,0,20,2,0,4,17,0,2,3
8474222,2009,0,0,0,0,0,0,0,0,0,0,0,0,0,0,0
8474230,2009,0,0,0,0,0,0,3,3,0,0,0,0,1,2,0
8474250,2009,0.88,0.9,1,0,11,8,4,23,3,2,1,9,29,31,0
8474291,2009,1.47,1.51,1,0,10,2,3,15,2,1,0,9,17,11,1
8474383,2009,0.09,0.09,0,0,1,0,0,1,0,0,0,1,0,3,0
8474436,2009,0.48,0.48,0,0,6,2,0,8,0,0,0,6,0,0,0
8474498,2009,5.45,5.45,7,4,77,21,23,121,13,2,0,75,209,90,18
8474511,2009,0.13,0.11,0,0,1,0,0,1,0,0,0,1,0,4,0
8474518,2009,1.6,1.6,4,3,32,16,25,73,8,1,3,31,0,30,7
8474519,2009,4.33,4.22,9,9,77,31,57,165,21,3,8,74,1,37,54
8474520,2009,1.43,1.37,4,2,24,13,17,54,8,2,2,22,0,37,4
8474551,2009,10.11,9.58,3,2,77,49,32,158,11,6,3,71,6,19,13
8474552,2009,3.88,3.67,6,3,38,13,14,65,11,2,5,36,1,44,20
8474557,2009,1.62,1.59,2,4,41,16,19,76,8,2,3,39,0,48,9
8474563,2009,11.09,10.05,23,20,142,76,98,316,59,16,15,126,0,157,20
8474564,2009,37.59,35.89,27,17,297,123,114,534,95,51,11,246,481,68,47
8474565,2009,0.28,0.27,0,1,7,3,15,25,2,1,1,6,0,4,3
8474566,2009,1.22,1.2,0,0,11,6,7,24,2,2,0,9,2,5,0
8474567,2009,8.28,7.96,3,10,155,82,102,339,23,10,11,145,0,196,41
8474568,2009,3,2.86,5,7,101,51,94,246,17,5,5,96,0,173,22
8474569,2009,6.65,6.42,5,2,58,20,16,94,15,8,1,50,62,21,11
8474571,2009,0.64,0.66,0,2,7,5,6,18,3,1,0,6,0,17,3
8474573,2009,11.35,10.87,7,11,110,44,47,201,33,15,8,95,171,67,44
8474574,2009,8,7.85,18,19,104,76,79,259,48,11,14,93,0,91,30
8474576,2009,3.47,3.36,4,2,37,17,20,74,9,3,3,34,5,23,10
8474578,2009,5.41,5.25,8,13,112,46,92,250,26,5,7,107,0,44,31
8474579,2009,0.17,0.17,0,0,3,3,7,13,0,0,0,3,0,6,1
8474584,2009,5.32,5.12,14,14,81,45,82,208,37,9,3,72,0,162,24
8474589,2009,3.08,3.06,3,3,23,6,7,36,9,3,1,20,13,2,5
8474590,2009,1.47,1.45,0,5,21,18,21,60,6,1,1,20,0,29,10
8474662,2009,0,0,0,0,0,0,0,0,0,0,0,0,0,2,0
8474674,2009,4.48,4.39,3,0,25,13,9,47,5,2,1,23,77,51,11
8474681,2009,0.02,0.02,0,0,1,0,1,2,0,0,0,1,1,0,1
8474707,2009,0.03,0.02,1,0,1,1,0,2,1,0,1,1,0,1,0
8474709,2009,1.65,1.49,2,0,10,3,1,14,2,0,0,10,0,15,1
8475085,2009,0.54,0.53,0,0,6,2,1,9,0,0,1,6,15,2,0
8475086,2009,0.3,0.29,0,0,5,0,1,6,1,1,1,4,6,2,1
8475087,2009,5.03,4.85,4,1,45,23,22,90,7,2,1,43,98,46,11
8475098,2009,6.45,6.31,7,12,51,14,28,93,27,8,0,43,358,52,26
8475104,2009,0,0,0,0,0,0,1,1,0,0,0,0,0,0,0
8475105,2009,7.51,7.38,4,6,93,26,22,141,19,9,5,84,0,32,15
8475118,2009,3.64,3.6,5,6,82,21,49,152,15,4,5,78,1,57,10
8475128,2009,0.1,0.1,0,0,4,2,3,9,0,0,2,4,0,9,1
8475158,2009,9.89,9.6,10,8,135,30,46,211,26,8,6,127,485,37,69
8475166,2009,29.98,28.61,19,11,184,72,84,340,54,24,23,160,527,42,55
8475167,2009,5.01,4.63,8,8,90,44,83,217,20,4,4,86,0,59,15
8475168,2009,22.52,21.43,16,15,180,65,64,309,55,24,13,156,479,51,64
8475169,2009,13.05,12.95,8,4,128,44,44,216,26,14,6,114,14,97,28
8475170,2009,0,0,0,0,0,0,1,1,0,0,0,0,4,4,1
8475172,2009,0.01,0.01,0,0,0,1,0,1,0,0,0,0,2,1,0
8475174,2009,0,0,0,0,0,0,0,0,0,0,0,0,0,0,0
8475179,2009,3.52,3.39,9,4,87,42,53,182,16,3,5,84,0,79,10
8475270,2009,0,0,0,0,0,0,0,0,0,0,0,0,0,1,0
8475381,2009,3.74,3.4,1,1,41,17,16,74,4,2,4,39,95,12,17
8475602,2009,1.32,1.29,3,0,18,6,8,32,4,1,0,17,17,5,3
8475613,2009,0.2,0.2,0,1,4,3,1,8,1,0,0,4,0,2,0
8475637,2009,0.07,0.06,0,0,2,1,1,4,0,0,0,2,0,1,1
8475638,2009,0.13,0.13,0,0,3,1,1,5,0,0,0,3,3,1,3
